AAACGAAAGAACAGGA-1	G
AAACGAAAGACTAGCG-1	A
AAACGAAAGACTCGGA-1	G
AAACGAAAGAGTAAGG-1	G
AAACGAAAGCGTCAAG-1	G
AAACGAAAGGGAGATA-1	A
AAACGAAAGGGCTCTC-1	G
AAACGAAAGGTCTTGT-1	A
AAACGAAAGGTCTTTG-1	G
AAACGAACAGTAACCT-1	G
AAACGAACAGTGCTCG-1	A
AAACGAAGTAACGGCA-1	G
AAACGAAGTATCAGCT-1	A
AAACGAAGTCACCCGA-1	A
AAACGAAGTTAGGCTT-1	A
AAACGAATCCATAGGT-1	G
AAACGAATCGCCTTAC-1	A
AAACTCGAGAGGAACA-1	G
AAACTCGAGGATTAAC-1	A
AAACTCGAGGCACTAG-1	A
AAACTCGAGGTGTTGG-1	A
AAACTCGAGGTTCGAG-1	A
AAACTCGAGTTCAGGG-1	G
AAACTCGCACACTAGT-1	G
AAACTCGCACGTTAGT-1	A
AAACTCGCACTCAGCG-1	G
AAACTCGCAGTGCTCG-1	A
AAACTCGCATAAAGTG-1	A
AAACTCGCATCATAGC-1	A
AAACTCGGTATCCCTC-1	G
AAACTCGGTTTGTGAC-1	G
AAACTCGTCAGAATGA-1	G
AAACTCGTCAGTGTAC-1	A
AAACTCGTCGACCCGA-1	G
AAACTCGTCGCACAAT-1	A
AAACTCGTCGCACCTT-1	G
AAACTGCAGAATATCG-1	G
AAACTGCAGAGCTGTG-1	A
AAACTGCAGCTGCTCG-1	G
AAACTGCAGGCCAGTA-1	G
AAACTGCAGGCGTCCT-1	A
AAACTGCCACCGTCTT-1	A
AAACTGCCAGCAATGG-1	G
AAACTGCCAGGAGCAT-1	A
AAACTGCCATAGACGG-1	G
AAACTGCGTACATGGG-1	G
AAACTGCGTCTCGGGT-1	A
AAACTGCGTCTGTTGA-1	A
AAACTGCTCGGATAGG-1	A
AAACTGCTCGTTCTAT-1	A
AAACTGCTCTATCTTG-1	A
AAACTGCTCTATTTCG-1	G
AAACTGCTCTCATATC-1	A
AAACTGCTCTTAAGCG-1	A
AAAGATGAGGTAAGTT-1	A
AAAGATGAGTATACGA-1	G
AAAGATGCACCCTTTG-1	A
AAAGATGCATTAGCCA-1	A
AAAGATGGTACTTCGA-1	G
AAAGATGGTATGTTCG-1	A
AAAGATGGTATTCACG-1	A
AAAGATGGTGAATCGG-1	A
AAAGATGGTGATAGAT-1	G
AAAGATGGTGTCCAGC-1	G
AAAGATGGTTATGCAC-1	G
AAAGATGTCGTGAGTT-1	G
AAAGATGTCTTGGCCT-1	A
AAAGGATAGACGCCCT-1	G
AAAGGATAGAGGCAGG-1	G
AAAGGATAGATGGGAA-1	A
AAAGGATAGTAGGAAG-1	G
AAAGGATCAAACTACC-1	A
AAAGGATCAACAAACA-1	G
AAAGGATCAACCTCCT-1	A
AAAGGATCACTGTCAA-1	G
AAAGGATCATAGGCGA-1	A
AAAGGATCATGTATCG-1	A
AAAGGATGTCGCGCTA-1	A
AAAGGATGTCTGGATT-1	G
AAAGGATGTTGGCTAT-1	A
AAAGGATTCAAGTTGC-1	A
AAAGGATTCCACGGCA-1	A
AAAGGATTCGCAGATT-1	G
AAAGGATTCGCTGATA-1	A
AAAGGATTCTCTGCAC-1	A
AAAGGGCAGCATTGGG-1	G
AAAGGGCAGTATAGTG-1	A
AAAGGGCCAAACCGAG-1	A
AAAGGGCCAAGTTGCT-1	A
AAAGGGCCACGTTGTA-1	A
AAAGGGCCATAGCCAT-1	G
AAAGGGCCATCACAGT-1	A
AAAGGGCGTAGCATGG-1	G
AAAGGGCGTCTCTAAG-1	G
AAAGGGCGTGGAAAGA-1	A
AAAGGGCTCACATTCT-1	A
AAAGGGCTCACGTCAA-1	A
AAAGGGCTCCCAGCGA-1	G
AAAGGGCTCGGATGTT-1	G
AAATGAGAGGAACCGT-1	A
AAATGAGAGGCAAGGG-1	A
AAATGAGAGTGTCGCC-1	A
AAATGAGCATAGATAG-1	A
AAATGAGCATCATCGA-1	G
AAATGAGGTAAAGCTA-1	G
AAATGAGGTCACTCTC-1	A
AAATGAGGTGGAAAGA-1	A
AAATGAGTCAGCCGAC-1	G
AAATGAGTCCATGTTT-1	A
AAATGAGTCCCTACCA-1	A
AAATGAGTCCGTACGG-1	A
AAATGAGTCCTCAAGA-1	G
AAATGAGTCGCACAAT-1	A
AAATGAGTCGGAGTTT-1	A
AAATGAGTCTATGAGC-1	G
AAATGAGTCTTAATCC-1	A
AAATGCCAGAATATCG-1	A
AAATGCCAGCAACGGT-1	A
AAATGCCAGCGTAGCA-1	A
AAATGCCCAAATTGAG-1	A
AAATGCCCACAACGGA-1	A
AAATGCCCACAGGTAG-1	A
AAATGCCCAGCTATAC-1	A
AAATGCCCAGGCTACC-1	A
AAATGCCGTATTGTGC-1	A
AAATGCCGTCAGAAAT-1	A
AAATGCCGTTAACCGT-1	A
AAATGCCTCAGGCGCT-1	A
AAATGCCTCAGTGGTT-1	G
AAATGCCTCTAGCTGA-1	A
AAATGCCTCTATCTCA-1	A
AACAAAGAGAACAGGA-1	A
AACAAAGAGATAGGTT-1	G
AACAAAGAGCCATGGA-1	G
AACAAAGAGCGAGAAA-1	G
AACAAAGAGGCGTCCT-1	A
AACAAAGAGGTTGTGG-1	A
AACAAAGAGTTGCTTG-1	A
AACAAAGCACAGATGG-1	A
AACAAAGCATCTGCAA-1	A
AACAAAGCATGATTGC-1	A
AACAAAGGTCAACAGG-1	A
AACAAAGGTCAGAAGC-1	A
AACAAAGGTCAGACGA-1	A
AACAAAGGTGCACCCA-1	A
AACAAAGGTGGATTTC-1	G
AACAAAGGTTCGGGAA-1	A
AACAAAGTCGCGTTCT-1	G
AACAGTCAGCTACGCC-1	G
AACAGTCAGGTGTTGG-1	A
AACAGTCCACATCATG-1	G
AACAGTCCATCGGCCA-1	A
AACAGTCCATGCGTTA-1	A
AACAGTCGTAGTACAA-1	A
AACAGTCGTCCTATTT-1	A
AACAGTCGTGCCAAGA-1	G
AACAGTCTCAAATGGA-1	A
AACAGTCTCCCAATAG-1	A
AACAGTCTCCCATAGA-1	G
AACAGTCTCCCGTAGG-1	A
AACAGTCTCCGTTTCG-1	G
AACAGTCTCGCTCTAC-1	A
AACATCGAGAACGTCG-1	A
AACATCGAGACTAGCG-1	A
AACATCGAGCACCATT-1	A
AACATCGAGCTGAGGT-1	A
AACATCGAGGTGTTGG-1	A
AACATCGAGTGTCGCC-1	G
AACATCGGTACCCATA-1	G
AACATCGGTATTGTCG-1	A
AACATCGGTCAATCCA-1	A
AACATCGGTGTCCAGC-1	A
AACATCGTCACCCGGA-1	G
AACATCGTCTGAAAGA-1	G
AACCAACAGATACCAA-1	G
AACCAACAGGCCAATG-1	A
AACCAACCATGCGTTA-1	G
AACCAACCATTTGTTC-1	A
AACCAACGTACCTATG-1	A
AACCAACTCACCACAA-1	G
AACCAACTCAGCCGAC-1	G
AACCAACTCCTGACCT-1	G
AACCAACTCGGGCTCA-1	G
AACCGATAGACACTTC-1	A
AACCGATAGATGGGAA-1	A
AACCGATAGGCCTAAG-1	A
AACCGATAGTGTGTAA-1	A
AACCGATCAACTCAAC-1	A
AACCGATCACTACACA-1	A
AACCGATCAGCTATAC-1	A
AACCGATCATAGTCCA-1	A
AACCGATGTATCTCAG-1	A
AACCGATGTTGAATAG-1	G
AACCGATTCCCGCAAG-1	G
AACCGATTCGAACACT-1	G
AACCGATTCGTTCTAT-1	G
AACCGATTCTCTGTTA-1	A
AACCTGAAGACCTATC-1	A
AACCTGAAGCTATCGT-1	G
AACCTGAAGGATTTGA-1	A
AACCTGACAAGACTAA-1	G
AACCTGACAAGCGGTA-1	G
AACCTGACAATGTGCT-1	A
AACCTGACACATCATG-1	A
AACCTGACACTTGCGG-1	A
AACCTGAGTACGTATC-1	G
AACCTGAGTGGACAGT-1	G
AACCTGAGTGTTAGAA-1	G
AACCTGATCTATAGGC-1	A
AACCTGATCTGACATG-1	A
AACCTTTAGATGCGCA-1	A
AACCTTTCACATCATG-1	G
AACCTTTCACCGTTGG-1	G
AACCTTTCACGACGAA-1	A
AACCTTTCACGCGTTG-1	A
AACCTTTCAGTATACC-1	A
AACCTTTGTAGCTGTT-1	A
AACCTTTGTCTGGTTA-1	A
AACCTTTGTGCTTGAT-1	A
AACCTTTGTGGAGTGT-1	A
AACCTTTTCATCGCTC-1	A
AACCTTTTCCATACGA-1	A
AACCTTTTCGGGAAAC-1	G
AACCTTTTCGGGCTCA-1	G
AACGAGGAGGGATCCA-1	G
AACGAGGCAACGCAAG-1	G
AACGAGGCAAGCTTTG-1	A
AACGAGGCAATGGCAG-1	G
AACGAGGCAGGACCTC-1	G
AACGAGGGTATCCCTC-1	G
AACGAGGGTCTGGGCT-1	A
AACGAGGTCAGTCACA-1	A
AACGAGGTCCCTATTA-1	G
AACGAGGTCGGGCTCA-1	A
AACGAGGTCTTCCAGC-1	A
AACGGGAAGACTTCCA-1	G
AACGGGAAGGTGATGC-1	A
AACGGGAAGTGGGACT-1	A
AACGGGAGTACTTCGA-1	G
AACGGGAGTAGGTCTT-1	G
AACGGGAGTGCTGAAG-1	A
AACGGGAGTTAGAGAT-1	A
AACGGGATCCATAACG-1	G
AACGGGATCCTTTGCG-1	A
AACGGGATCGCTACCT-1	G
AACGTACAGACTAGGC-1	A
AACGTACAGATTCCGT-1	A
AACGTACAGGCCTAAG-1	A
AACGTACAGTCGTACT-1	A
AACGTACAGTTCGTTG-1	G
AACGTACCACGTTACA-1	A
AACGTACCATGCTATG-1	G
AACGTACGTATGGTTC-1	G
AACGTACGTCACAGGA-1	A
AACGTACGTCCCGAGT-1	A
AACGTACGTGACAAGC-1	A
AACGTACGTTACTTTC-1	A
AACGTACGTTCCCGGA-1	A
AACGTACGTTCGGGAA-1	A
AACGTACTCAAGTTGC-1	A
AACGTACTCAATCGTG-1	G
AACGTACTCCTGAAAC-1	A
AACGTACTCTATAGGC-1	A
AACGTACTCTGACTTT-1	G
AACGTACTCTGTCGGG-1	A
AACGTACTCTTCATAC-1	A
AACTGGTAGAGTCCGA-1	A
AACTGGTAGGATTGCG-1	G
AACTGGTAGGTGAACC-1	A
AACTGGTAGTCTAGAA-1	A
AACTGGTAGTGAGTGC-1	A
AACTGGTCAACGCACC-1	A
AACTGGTCAATCAGGG-1	A
AACTGGTCACTGATAC-1	A
AACTGGTCACTGTCAA-1	G
AACTGGTCATGGAGGT-1	G
AACTGGTGTAAGTGCG-1	A
AACTGGTGTCAATCCA-1	A
AACTGGTGTGGGTAGT-1	G
AACTGGTGTTTGCCCT-1	G
AACTGGTTCTATGAGC-1	A
AACTGGTTCTGTGTCC-1	A
AACTGTGAGATCTCAC-1	A
AACTGTGAGCCTTTGA-1	A
AACTGTGAGGATATCA-1	A
AACTGTGAGTCTTAGC-1	A
AACTGTGCACGACGAA-1	A
AACTGTGCATCCGTAA-1	A
AACTGTGCATCCGTGG-1	A
AACTGTGGTAAACCCT-1	A
AACTGTGGTAGTGATA-1	G
AACTGTGGTATTGTCG-1	A
AACTGTGGTGGCGCTT-1	G
AACTGTGGTGGGTAGT-1	G
AACTGTGGTTTAGAAG-1	A
AACTGTGTCCCGGGTA-1	A
AACTGTGTCTCGGCGA-1	G
AACTGTGTCTGGAAGG-1	A
AACTTGGAGAAGACTT-1	A
AACTTGGAGAAGCCTG-1	G
AACTTGGAGACGCCCT-1	A
AACTTGGAGTGAGTGC-1	A
AACTTGGCACCAAGGA-1	A
AACTTGGCACCGAAAG-1	A
AACTTGGCAGAGATGC-1	A
AACTTGGCAGGTCTGC-1	G
AACTTGGGTACCGGCT-1	A
AACTTGGGTACTAGAA-1	A
AACTTGGGTAGTACAA-1	A
AACTTGGGTTGTGAGG-1	A
AACTTGGTCCAGTTAG-1	A
AACTTGGTCCTCATTA-1	A
AACTTGGTCGGTGATT-1	A
AAGATAGAGGAGTAGA-1	A
AAGATAGAGTTGCTTG-1	A
AAGATAGCAACGGACA-1	G
AAGATAGCAGGTCCTG-1	A
AAGATAGGTGATAAGT-1	A
AAGATAGGTGTCCTTC-1	G
AAGATAGTCAGTCTTT-1	A
AAGATAGTCCACACCT-1	A
AAGATAGTCCTCCAGT-1	A
AAGATAGTCGCTATAG-1	A
AAGATAGTCTCCTTAA-1	G
AAGATAGTCTCTGAGA-1	A
AAGGAGCAGAGAAGCA-1	G
AAGGAGCAGCCATGGA-1	A
AAGGAGCAGGCAAGGG-1	A
AAGGAGCAGTAGTCGG-1	A
AAGGAGCAGTGTCCCG-1	A
AAGGAGCCAACGTCCG-1	G
AAGGAGCCACCGTCTT-1	A
AAGGAGCCAGCAACGA-1	A
AAGGAGCGTACAAGCG-1	G
AAGGAGCGTTGGCGAA-1	A
AAGGAGCTCCATCTAT-1	G
AAGGAGCTCGATGTGT-1	A
AAGGTTCAGAGGTACC-1	A
AAGGTTCAGCCATGGA-1	A
AAGGTTCAGGCAGTGT-1	G
AAGGTTCAGGGCGAAG-1	G
AAGGTTCAGTGAGTGC-1	A
AAGGTTCCAGCCGAAA-1	G
AAGGTTCCATGGTATC-1	G
AAGGTTCGTAGGTCTT-1	A
AAGGTTCGTCCACCAG-1	G
AAGGTTCGTCTGTCCT-1	A
AAGGTTCGTGAGTAAT-1	A
AAGGTTCTCCAACGCG-1	A
AAGGTTCTCCACCTAC-1	G
AAGGTTCTCCCAATAG-1	A
AAGGTTCTCTGAGTCA-1	G
AATACGCAGCGCACAA-1	A
AATACGCAGGTTAACA-1	A
AATACGCAGTCTGCTA-1	A
AATACGCAGTGTTCCA-1	A
AATACGCCAAGGAAGA-1	A
AATACGCCAATTGCCA-1	G
AATACGCCACATATCG-1	G
AATACGCCACTAGCCG-1	G
AATACGCCAGAGAGAA-1	A
AATACGCCAGTGCTCG-1	A
AATACGCGTGTCTCGG-1	A
AATACGCTCGTTTGAG-1	A
AATACGCTCTGGACAT-1	A
AATGCCAAGAAAGCAG-1	G
AATGCCAAGAAGCCTG-1	A
AATGCCAAGCGTCAAG-1	A
AATGCCAAGCTTACCA-1	A
AATGCCAAGGTAGGAA-1	G
AATGCCAAGGTTCGTT-1	A
AATGCCAAGTCGTACT-1	G
AATGCCACAGGTAGCA-1	G
AATGCCACATCCCGGA-1	A
AATGCCACATGCCTTC-1	A
AATGCCACATTACCTT-1	G
AATGCCAGTAAACGGC-1	A
AATGCCAGTGCACATT-1	G
AATGCCATCCGGCGAT-1	G
AATGCCATCTATAGGC-1	A
AATGCCATCTCGGCGA-1	A
AATGGAAAGCCGCAAA-1	A
AATGGAAAGCTCCATA-1	G
AATGGAAAGGCGTAGT-1	A
AATGGAAAGTCTTAGC-1	G
AATGGAAAGTGCACAG-1	A
AATGGAACAAACGTTC-1	A
AATGGAACAAGGCGTA-1	G
AATGGAACAATCACTG-1	G
AATGGAACAGATTAAG-1	G
AATGGAAGTAAACCCT-1	G
AATGGAAGTAAACGTA-1	A
AATGGAAGTAACACTC-1	A
AATGGAAGTGTCCCAG-1	A
AATGGAAGTTACCACA-1	G
AATGGAATCCATAGGT-1	A
AATGGAATCCTAAAGC-1	A
AATGGAATCGATGCAT-1	A
AATGGAATCGGTACTA-1	A
AATGGAATCTGGTACA-1	G
AATGGAATCTTATCAC-1	A
AATGGAATCTTTGCAT-1	G
AATGGCTAGGAGTACC-1	G
AATGGCTAGTGAGTTA-1	A
AATGGCTCAAGACTAA-1	A
AATGGCTCAAGCCTTA-1	G
AATGGCTCAATCACTG-1	G
AATGGCTCAGTAAGAT-1	A
AATGGCTCAGTGCTCG-1	A
AATGGCTCATTTAGGC-1	A
AATGGCTGTCACATTG-1	A
AATGGCTGTGACAAGC-1	G
AATGGCTGTGCATTGT-1	A
AATGGCTTCCAGGTAT-1	A
AATGGCTTCCCGAAGC-1	G
AATGGCTTCCTCCATG-1	A
AATGGCTTCGTGCTTC-1	A
AATGTCGAGAGTGGTC-1	A
AATGTCGAGATGCGAC-1	G
AATGTCGAGATTGACA-1	G
AATGTCGAGCATGATA-1	G
AATGTCGAGTACGCGA-1	G
AATGTCGCAAATGCTC-1	A
AATGTCGCAATGGTCT-1	A
AATGTCGCACCGTTGG-1	G
AATGTCGGTACCCATA-1	A
AATGTCGGTGCAACAG-1	G
AATGTCGTCAGTCTTT-1	A
AATGTCGTCCATCTAT-1	G
AATGTCGTCCGATGCG-1	G
AATGTCGTCGTGCTGG-1	G
ACAAACCAGCGAGAAA-1	A
ACAAACCAGGCAAGGG-1	A
ACAAACCCACCACCAG-1	A
ACAAACCCATTGCGAT-1	A
ACAAACCGTCTCTGCT-1	A
ACAAACCGTTCCGCGA-1	G
ACAAACCTCCACACCT-1	G
ACAAACCTCCAGTTAG-1	A
ACAAACCTCCATCATT-1	G
ACAAACCTCGAGTTAC-1	A
ACAAACCTCGTCCCTA-1	A
ACAAACCTCTTCAGAG-1	G
ACAAAGAAGAACGTTA-1	A
ACAAAGAAGCAGAGCT-1	G
ACAAAGAAGTGCCCTG-1	G
ACAAAGAAGTTCGTTG-1	G
ACAAAGACAACACGGA-1	A
ACAAAGACAAGAAACT-1	A
ACAAAGACACATTGCA-1	G
ACAAAGACATTGCCTC-1	A
ACAAAGAGTATTCGAC-1	G
ACAAAGAGTGCCCAGT-1	A
ACAAAGAGTGTTGTTG-1	G
ACAAAGATCAAGAGAT-1	G
ACAAAGATCTAGCAGT-1	A
ACAAGCTAGCAACTGG-1	A
ACAAGCTAGGTGATGC-1	A
ACAAGCTAGTCGCCTG-1	A
ACAAGCTAGTTGACAA-1	G
ACAAGCTAGTTGGAAT-1	G
ACAAGCTCACGTTGTA-1	A
ACAAGCTCACTTTGGA-1	A
ACAAGCTCATTAGCCA-1	G
ACAAGCTGTGTCCCAG-1	G
ACAAGCTTCGCAACTA-1	A
ACAAGCTTCGCTCTAC-1	G
ACAAGCTTCGGATAAA-1	A
ACAAGCTTCTTCCACG-1	A
ACAATCGAGGAGTAGA-1	A
ACAATCGAGGATGTAT-1	G
ACAATCGAGGTTGACG-1	G
ACAATCGCAGGATGTG-1	A
ACAATCGCAGTAAGCG-1	A
ACAATCGGTACGCAAG-1	A
ACAATCGGTAGACGCA-1	A
ACAATCGGTGTCCAGC-1	G
ACAATCGGTTACCACA-1	A
ACAATCGGTTCCCAAA-1	G
ACAATCGGTTGGAGGT-1	A
ACAATCGTCCACCTAC-1	A
ACAATCGTCTCAGATG-1	A
ACAATCGTCTCTGACC-1	G
ACAGAAAAGAACGTTA-1	A
ACAGAAAAGTCCCTCT-1	G
ACAGAAAAGTTCCCGG-1	A
ACAGAAACAACGGGTA-1	A
ACAGAAACAAGGATGC-1	G
ACAGAAACACCATTCC-1	A
ACAGAAACACCTGAAT-1	G
ACAGAAACAGGTAACG-1	A
ACAGAAACATAGCCAT-1	A
ACAGAAACATTAGCAC-1	G
ACAGAAAGTCCATTGA-1	A
ACAGAAAGTGTGACCC-1	A
ACAGAAATCATCGCTC-1	A
ACAGAAATCGCCGAAC-1	A
ACAGAAATCGTGGAAG-1	G
ACAGAAATCGTTGTTT-1	G
ACAGAAATCTATCTTG-1	A
ACAGACTAGTAATCAG-1	A
ACAGACTCAAACTACC-1	A
ACAGACTCAACTCGAT-1	G
ACAGACTCACGCTGTG-1	A
ACAGACTCAGAGAGAA-1	A
ACAGACTCATGTCCCT-1	G
ACAGACTGTAAAGCTA-1	G
ACAGACTGTATATGGA-1	A
ACAGACTGTCAGGTGA-1	G
ACAGACTGTGAATCGG-1	A
ACAGACTGTGCCAAGA-1	G
ACAGACTGTGGACCAA-1	A
ACAGACTGTTGGTAAA-1	G
ACAGACTGTTTGTACG-1	G
ACAGACTTCAGAACGG-1	G
ACAGACTTCAGTCTTT-1	A
ACAGACTTCGTGGAAG-1	A
ACAGCGCAGATCGAGC-1	G
ACAGCGCAGCGTCAAG-1	A
ACAGCGCAGGCCAGTA-1	A
ACAGCGCCAGCTATAC-1	G
ACAGCGCCAGTTGCAT-1	A
ACAGCGCCATAGACGG-1	A
ACAGCGCCATTTGTTC-1	A
ACAGCGCGTTCATTTC-1	A
ACAGCGCGTTGGCTTA-1	A
ACAGCGCGTTTCTTAC-1	A
ACAGCGCTCAGGAATA-1	A
ACAGCGCTCGACGGAA-1	A
ACAGCGCTCGGTTAGT-1	A
ACAGGCCAGATGCGCA-1	A
ACAGGCCAGCAGAGCT-1	A
ACAGGCCAGGATGCCA-1	A
ACAGGCCAGTACCACT-1	G
ACAGGCCCAACTCGTA-1	G
ACAGGCCCAAGAAACT-1	G
ACAGGCCCACGCGTTG-1	A
ACAGGCCGTAGTACAA-1	A
ACAGGCCGTGATAACA-1	G
ACAGGCCGTTAGCTCA-1	A
ACAGGCCGTTCCGGCA-1	A
ACAGGCCTCGATGCAT-1	G
ACAGGCCTCGCCACTT-1	G
ACATGCAAGCAGAAAG-1	A
ACATGCAAGGGAAGCG-1	G
ACATGCACAATGACTC-1	G
ACATGCACAGTCAGAG-1	A
ACATGCACATGGTAAA-1	A
ACATGCACATGTATCG-1	A
ACATGCACATTGCGAT-1	A
ACATGCAGTACCCATA-1	G
ACATGCATCATGTTCT-1	A
ACATGCATCGTGATAC-1	G
ACATGGTAGTCTCTAG-1	A
ACATGGTCAAGCAACG-1	A
ACATGGTCACTGATAC-1	A
ACATGGTGTAAGCCGA-1	G
ACATGGTGTACATGGG-1	A
ACATGGTGTAGGTGAC-1	A
ACATGGTGTCAAATCC-1	A
ACATGGTGTCTGAGCC-1	G
ACATGGTGTTTAAGCC-1	G
ACATGGTGTTTGATCG-1	G
ACATGGTTCACCGCGA-1	G
ACATGGTTCGCCAGAC-1	A
ACATGGTTCGGAGTTT-1	A
ACCAAACAGATGCGAC-1	G
ACCAAACAGCATGTGG-1	G
ACCAAACAGGGTGTTG-1	G
ACCAAACAGGTCTTTG-1	G
ACCAAACCAATTCAGC-1	G
ACCAAACCATTAGCAC-1	A
ACCAAACCATTTGTTC-1	G
ACCAAACGTAAGTCTC-1	G
ACCAAACGTACAACGG-1	A
ACCAAACGTAGTCTGT-1	A
ACCAAACGTATGCTAC-1	G
ACCAAACGTCTGCGCA-1	A
ACCAAACGTTCCGGCA-1	A
ACCAAACGTTGGCTTA-1	A
ACCAAACTCAGATACC-1	G
ACCAAACTCGCTAGTA-1	A
ACCAAACTCTGGCACG-1	G
ACCATCCAGACCCATT-1	A
ACCATCCAGCACCATT-1	A
ACCATCCAGCGCATTT-1	G
ACCATCCAGTACAACA-1	A
ACCATCCCACTGCTTC-1	A
ACCATCCCAGGTAGGT-1	G
ACCATCCCATTGCACA-1	G
ACCATCCGTAGCGAGT-1	A
ACCATCCGTGATCAGG-1	G
ACCATCCGTGCAAGCA-1	A
ACCATCCGTTATCGAC-1	A
ACCATCCTCACTCGGG-1	A
ACCATCCTCAGAACGG-1	G
ACCATCCTCAGGATCT-1	A
ACCATCCTCGTGCTTC-1	G
ACCCAAAAGAAGACTT-1	A
ACCCAAAAGACGAAAG-1	G
ACCCAAAAGGACCGAT-1	G
ACCCAAAAGGGTCCCT-1	A
ACCCAAAAGGTACATA-1	A
ACCCAAAAGTCCAGAG-1	A
ACCCAAAAGTGCTGAG-1	A
ACCCAAACAAGGAGGG-1	A
ACCCAAACACAGCTTA-1	G
ACCCAAACAGCACATT-1	G
ACCCAAACATTGCCTC-1	G
ACCCAAAGTAGCATGG-1	A
ACCCAAAGTAGTCCAT-1	G
ACCCAAAGTTACCACA-1	G
ACCCAAAGTTAGGAAT-1	A
ACCCAAAGTTCTTATC-1	G
ACCCAAATCGGATCGC-1	G
ACCCAAATCGGGATCC-1	A
ACCGAATAGACTTGAA-1	A
ACCGAATAGGCAAGGG-1	G
ACCGAATAGGGCGAAG-1	A
ACCGAATAGTTAGCAA-1	G
ACCGAATCAATGCATC-1	A
ACCGAATCACAGCCAC-1	A
ACCGAATGTGAGTCGA-1	A
ACCGAATGTTCCGCGA-1	G
ACCGAATTCAGAACGG-1	A
ACCGAATTCAGTCTTT-1	A
ACCGCAGAGAGAGTTT-1	A
ACCGCAGAGAGCGGTT-1	G
ACCGCAGAGGTAAGTT-1	G
ACCGCAGAGGTACATA-1	G
ACCGCAGAGTCTAGAA-1	G
ACCGCAGCACAAACGG-1	G
ACCGCAGCACCTACCT-1	G
ACCGCAGCATTAAGGA-1	A
ACCGCAGGTCGCGCTA-1	A
ACCGCAGGTTGTGACT-1	G
ACCGCAGTCAGGCCGT-1	A
ACCGCAGTCGGGTCCA-1	G
ACCGGGTAGCATGTGG-1	A
ACCGGGTAGGGCTTCC-1	G
ACCGGGTAGTAGAAGG-1	A
ACCGGGTAGTCGACCC-1	G
ACCGGGTCACCCATCT-1	A
ACCGGGTCAGATAAGT-1	A
ACCGGGTCAGCACATT-1	G
ACCGGGTCATGCCCTT-1	G
ACCGGGTGTAACATAG-1	A
ACCGGGTGTCAGACGA-1	A
ACCGGGTGTTGCCGCA-1	A
ACCGGGTTCCATTGAG-1	A
ACCGGGTTCTTTCGAT-1	G
ACCTGCTAGCACCATT-1	G
ACCTGCTAGGTCACTT-1	G
ACCTGCTAGTCATCTG-1	A
ACCTGCTCACTGTCGG-1	A
ACCTGCTGTCGTCGCA-1	G
ACCTGCTTCCATTGAG-1	A
ACCTGCTTCCCAGCGA-1	A
ACCTGCTTCGCAGATT-1	A
ACCTGCTTCTGCTACC-1	G
ACGGATTAGAAGAGTG-1	A
ACGGATTAGAGCAGCT-1	A
ACGGATTAGATACCAA-1	A
ACGGATTAGCTAACAA-1	A
ACGGATTAGTCTCGAT-1	A
ACGGATTAGTTCGACT-1	A
ACGGATTCAAGCCCTG-1	G
ACGGATTCAAGTTGCT-1	A
ACGGATTCAATGGTAA-1	A
ACGGATTCAATGTAAG-1	A
ACGGATTCAATTGCCA-1	A
ACGGATTCACAGAAGC-1	G
ACGGATTCACGCTAAT-1	A
ACGGATTCAGGTGTGA-1	G
ACGGATTCAGTAACTC-1	G
ACGGATTTCAAACCCA-1	G
ACGGATTTCAGTGTAC-1	G
ACGGATTTCGCGTGAC-1	A
ACGGATTTCGGATGTT-1	A
ACGTGGCAGAGCACTG-1	A
ACGTGGCAGCGCCTAC-1	G
ACGTGGCAGGTAGGCT-1	A
ACGTGGCCAATCCATG-1	G
ACGTGGCCACATCATG-1	G
ACGTGGCCACCCATCT-1	A
ACGTGGCCACTAGGAG-1	G
ACGTGGCCAGCCACGT-1	A
ACGTGGCCAGGTTATC-1	A
ACGTGGCGTACAAGCG-1	G
ACGTGGCGTAGAATAC-1	A
ACGTGGCTCATCGCCT-1	G
ACGTGGCTCCTCCAGT-1	G
ACGTGGCTCGTGCTGG-1	G
ACGTGGCTCTAGCAAC-1	G
ACGTTAGAGAACGCCA-1	A
ACGTTAGAGATGAGGA-1	A
ACGTTAGAGCAGAGCT-1	A
ACGTTAGAGTACGACG-1	A
ACGTTAGAGTGAATAC-1	G
ACGTTAGCAATCATCG-1	A
ACGTTAGCACAGAAGC-1	A
ACGTTAGCACTTACAG-1	A
ACGTTAGCAGAGAGAA-1	G
ACGTTAGCAGCAGGTA-1	G
ACGTTAGCAGTCCTGG-1	A
ACGTTAGCATTAGCAC-1	G
ACGTTAGGTATTCTCT-1	G
ACGTTAGTCCAGGGAA-1	A
ACGTTAGTCCTGTAGA-1	A
ACGTTAGTCTCTTCCT-1	A
ACGTTAGTCTCTTCTC-1	A
ACTAACGAGAAACGCC-1	A
ACTAACGAGGCCAGTA-1	A
ACTAACGAGTCGCCTG-1	G
ACTAACGAGTTAGAGT-1	G
ACTAACGCAGTTACAC-1	A
ACTAACGCATAGCCAT-1	A
ACTAACGCATGTATCG-1	A
ACTAACGCATTTGTTC-1	G
ACTAACGGTCACCCGA-1	G
ACTAACGGTGTCTACA-1	G
ACTAACGTCTCCCTTT-1	G
ACTACCCAGACCAATA-1	A
ACTACCCAGTAACACA-1	A
ACTACCCCAATGTGCT-1	G
ACTACCCCAGGACCTC-1	A
ACTACCCCATGGTAAA-1	A
ACTACCCGTCCACCAG-1	G
ACTACCCTCAGATACC-1	A
ACTACCCTCAGTACAC-1	A
ACTACCCTCCCGGGTA-1	A
ACTACCCTCCTCTCTT-1	G
ACTACCCTCTCTGACC-1	G
ACTACGAAGGCAAGGG-1	A
ACTACGAAGTGCTCGC-1	A
ACTACGACAAAGCTGG-1	A
ACTACGACAAAGGAAG-1	G
ACTACGACAAGACACG-1	A
ACTACGACAAGGAGGG-1	G
ACTACGACAAGTGGCA-1	A
ACTACGACATCGACCG-1	A
ACTACGAGTGGAAGCT-1	A
ACTAGGTAGCCTGTAT-1	A
ACTAGGTAGCGAGCTA-1	A
ACTAGGTAGCTTTCCC-1	A
ACTAGGTCAAGCGGTA-1	G
ACTAGGTCAATGGTCT-1	A
ACTAGGTCAGCACATT-1	G
ACTAGGTCAGTAAGAT-1	A
ACTAGGTCATGGTAAA-1	A
ACTAGGTCATTTAGGC-1	A
ACTAGGTTCATCATGG-1	A
ACTAGGTTCCATGTTT-1	A
ACTAGGTTCGACGGAA-1	G
ACTAGGTTCTGAGTAC-1	G
ACTATTCAGAACGCCA-1	A
ACTATTCAGGATCCTT-1	A
ACTATTCGTTGCCTGG-1	G
ACTATTCTCAATGCAC-1	G
ACTATTCTCTCTTAAC-1	G
ACTCGGGAGGAAGGTA-1	G
ACTCGGGCAAGTGGCA-1	A
ACTCGGGCATGGCCTG-1	A
ACTCGGGGTACGGAGT-1	A
ACTCGGGGTAGCCATT-1	G
ACTCGGGGTGTCCTTC-1	A
ACTCGGGGTTGGAGGT-1	G
ACTCGGGTCAAGAGAT-1	A
ACTCGGGTCGAAGCCC-1	A
ACTCGGGTCTATAGGC-1	A
ACTCGGGTCTTTGCAT-1	A
ACTGCAAAGCTGCCAC-1	A
ACTGCAAAGGCTAAAT-1	G
ACTGCAAAGTCCCTCT-1	A
ACTGCAACAACTCCCT-1	A
ACTGCAACAAGAGCGT-1	G
ACTGCAACAAGCCAGA-1	G
ACTGCAACACTGTTAG-1	G
ACTGCAACAGCCACGT-1	A
ACTGCAACAGCTATAC-1	G
ACTGCAACAGCTTACA-1	G
ACTGCAAGTAAGGTCG-1	G
ACTGCAAGTAGGGTCA-1	G
ACTGCAAGTCGAGAAC-1	G
ACTGCAATCAAACCAC-1	A
ACTGCAATCAGGTTTG-1	A
ACTGCAATCCAGTTAG-1	A
ACTGCAATCCGAATTG-1	G
ACTGCAATCTGTTTAC-1	G
ACTGCGGAGCGATACG-1	G
ACTGCGGAGGAGACTC-1	A
ACTGCGGCAAGGGTAC-1	A
ACTGCGGCACAATAAG-1	A
ACTGCGGCACATATCG-1	A
ACTGCGGCAGCGTGAA-1	A
ACTGCGGCAGCTTACA-1	A
ACTGCGGGTGAATACA-1	A
ACTGCGGGTTCCAGTA-1	G
ACTGCGGGTTCCATCC-1	G
ACTGCGGTCTCTCAAT-1	G
ACTGTCCAGACTTCCA-1	A
ACTGTCCAGATCGAGC-1	A
ACTGTCCAGGGAGATA-1	G
ACTGTCCAGTGAAACT-1	A
ACTGTCCCATTACCTT-1	A
ACTGTCCGTCTAAGAA-1	A
ACTGTCCGTCTGCGCA-1	G
ACTGTCCTCAAGAGGC-1	G
ACTGTCCTCCATGTTT-1	A
ACTTCCGAGGCAGTGT-1	A
ACTTCCGAGTGAGTGC-1	A
ACTTCCGCAAACAGTA-1	A
ACTTCCGCAAAGAAGG-1	A
ACTTCCGCACGGCCAT-1	A
ACTTCCGCAGGGCTTC-1	G
ACTTCCGGTACTTCGA-1	A
ACTTCCGGTAGCAGGT-1	G
ACTTCCGGTCTAACCA-1	A
ACTTCCGGTGCACCCA-1	A
ACTTCCGGTGCCAAGA-1	A
ACTTCCGTCCACTAGA-1	G
ACTTCCGTCCGCTATC-1	A
ACTTCCGTCCTGTGGG-1	A
ACTTTCAAGAGGAAGT-1	G
ACTTTCAAGCAGAATT-1	G
ACTTTCAAGCCGCTGT-1	A
ACTTTCAAGCTACGTT-1	G
ACTTTCAAGCTGAAAT-1	A
ACTTTCAAGGACTTTC-1	A
ACTTTCAAGGCCAGTA-1	A
ACTTTCAAGTTCCCGG-1	G
ACTTTCACACATATCG-1	A
ACTTTCACATTCACCC-1	G
ACTTTCAGTGCATTGT-1	A
ACTTTCAGTTGTATCG-1	A
ACTTTCATCATACTTC-1	A
ACTTTCATCATCGCAA-1	A
ACTTTCATCCGCCTAT-1	G
ACTTTCATCGGATGTT-1	A
ACTTTCATCTACCCGT-1	G
AGACAAAAGAGGAAGT-1	A
AGACAAAAGCAGGACT-1	A
AGACAAAAGCTAGCAG-1	A
AGACAAACAAGATTAG-1	A
AGACAAACAAGTAACA-1	G
AGACAAACACACTAGT-1	G
AGACAAACAGGCATCC-1	A
AGACAAACATGTGGGA-1	G
AGACAAAGTAAAGCTA-1	G
AGACAAAGTAGATTAG-1	G
AGACAAAGTATCTGCA-1	A
AGACAAAGTATTGTGC-1	A
AGACAAAGTCACATTG-1	A
AGACAAAGTCGCTACG-1	A
AGACAAATCTCTGCGT-1	A
AGATAGAAGTTACACC-1	A
AGATAGACAACTCGAT-1	G
AGATAGACAAGCTTTG-1	G
AGATAGACACTTTGGA-1	A
AGATAGAGTAAGCCTT-1	G
AGATAGAGTATTTGCG-1	G
AGATAGATCACCGCGA-1	G
AGATAGATCCTGAAAC-1	A
AGATAGATCCTGACCT-1	G
AGATAGATCGAGAACG-1	A
AGATAGATCGATCTTT-1	G
AGATAGATCGTGCTTC-1	G
AGATAGATCTATTTCG-1	A
AGATAGATCTGATCTT-1	G
AGATTCGAGATCCGAG-1	A
AGATTCGGTAGAGAGA-1	G
AGATTCGGTAGCCATT-1	A
AGATTCGGTCGATTAC-1	A
AGATTCGGTGAGCTAG-1	A
AGATTCGGTTAGGCTT-1	A
AGATTCGTCACCCTTG-1	A
AGATTCGTCCTAGAGT-1	G
AGATTCGTCTCGGCGA-1	A
AGCCAGCAGCTGATTC-1	G
AGCCAGCAGGTAGGAA-1	A
AGCCAGCCAACGTAGG-1	G
AGCCAGCCAATCACTG-1	A
AGCCAGCCATTTAGGC-1	A
AGCCAGCGTAGAAAGG-1	A
AGCCAGCGTATCACAC-1	G
AGCCAGCGTCAAGACG-1	G
AGCCAGCGTCCCGTGA-1	A
AGCCAGCGTTATGCAC-1	G
AGCCAGCTCAAGGCCC-1	A
AGCCAGCTCCCAATAG-1	G
AGCCAGCTCTCTGCAC-1	A
AGCCCGAAGAAGCCGT-1	G
AGCCCGAAGTACCTCA-1	G
AGCCCGACAAGCCAGA-1	G
AGCCCGACATACCCGG-1	G
AGCCCGAGTTCTGAGT-1	A
AGCCCGAGTTTGCATG-1	A
AGCCCGATCACTCGGG-1	A
AGCCCGATCCACTAGA-1	G
AGCCGCAAGAATGCTA-1	A
AGCCGCAAGATAGGTT-1	A
AGCCGCAAGTACCTCA-1	G
AGCCGCACACTACACA-1	G
AGCCGCAGTATGTCCA-1	A
AGCCGCAGTGCGCTCA-1	A
AGCCGCATCCAAACCA-1	A
AGCCGCATCGTTCTAT-1	G
AGCCTCTAGAAATGGG-1	G
AGCCTCTAGCTCCGGT-1	G
AGCCTCTAGGAATGGA-1	G
AGCCTCTAGGGTCTGA-1	A
AGCCTCTAGTCGAGCA-1	A
AGCCTCTAGTTAGAGT-1	G
AGCCTCTCAAGCCTTA-1	G
AGCCTCTCAGAGCCAA-1	G
AGCCTCTCAGCAACAG-1	G
AGCCTCTCATCCCTTG-1	G
AGCCTCTGTAACGGTG-1	A
AGCCTCTGTAATGCCT-1	A
AGCCTCTGTTACCACA-1	G
AGCCTCTGTTTGGATC-1	A
AGCCTCTTCATGTTCT-1	A
AGCCTCTTCGAACCGC-1	G
AGCCTCTTCGACTCGG-1	A
AGCCTCTTCGATGCAT-1	A
AGCCTCTTCGGCTATA-1	A
AGCCTGGAGCGTTGCC-1	A
AGCCTGGAGGGCATTG-1	G
AGCCTGGAGGGTCCCT-1	G
AGCCTGGAGTTAGCAA-1	A
AGCCTGGCAACCTCCT-1	A
AGCCTGGCAACTCGTA-1	A
AGCCTGGCACTCGGAC-1	G
AGCCTGGCATGCGTTA-1	A
AGCCTGGGTCCCTAAA-1	A
AGCCTGGGTTCAGTAC-1	G
AGCCTGGGTTGGCTTA-1	A
AGCCTGGTCAGGTTTG-1	A
AGCCTGGTCAGTGGTT-1	A
AGCCTGGTCGTTGTTT-1	G
AGCCTGGTCTCGCGGA-1	A
AGCCTTCAGAGGCCTA-1	A
AGCCTTCAGGAACCGT-1	A
AGCCTTCAGGGCGAAG-1	G
AGCCTTCAGGGTAATT-1	A
AGCCTTCCAAAGGTCG-1	A
AGCCTTCCACGATATC-1	G
AGCCTTCCACTGCTTC-1	G
AGCCTTCCAGACTAAA-1	A
AGCCTTCCAGGTGTCC-1	G
AGCCTTCCAGGTGTGA-1	A
AGCCTTCCAGTAAGCG-1	A
AGCCTTCGTAGAAGCC-1	G
AGCCTTCGTAGCGGTA-1	G
AGCCTTCGTGAAACAT-1	G
AGCCTTCGTTATGCAC-1	G
AGCCTTCTCACGTCAA-1	G
AGCCTTCTCCAAACCA-1	G
AGCCTTCTCGCATACA-1	G
AGCCTTCTCGGGTCCA-1	A
AGCCTTCTCGTTGTTT-1	A
AGCGATTAGAGAATTC-1	A
AGCGATTAGCTAGCAG-1	A
AGCGATTAGGAGTACC-1	A
AGCGATTAGGATTGAT-1	A
AGCGATTAGTGAGTTA-1	A
AGCGATTCACATAAAG-1	A
AGCGATTCACTGTCAA-1	A
AGCGATTCAGTAACGG-1	A
AGCGATTGTATCTGCA-1	A
AGCGATTGTCCAACCG-1	A
AGCGATTGTGTCTCGG-1	G
AGCGATTGTGTTAGAA-1	A
AGCGATTGTTACTTTC-1	G
AGCGATTGTTATGCAC-1	G
AGCGATTGTTTAGGAA-1	A
AGCGATTTCCAGCACG-1	G
AGCGATTTCGACTCGG-1	G
AGCGTATAGGCAAGCT-1	G
AGCGTATAGTAACACA-1	G
AGCGTATAGTTCCCGG-1	A
AGCGTATCAATGGCAG-1	G
AGCGTATCACATATCG-1	G
AGCGTATGTAGTGATA-1	A
AGCGTATGTCAGCAAG-1	A
AGCGTATGTCCTATTT-1	A
AGCGTATGTTTCAGCA-1	A
AGCGTATTCAAAGTAG-1	A
AGCGTATTCTCGACCT-1	G
AGCGTATTCTCTGCGT-1	G
AGCGTATTCTTAATCC-1	A
AGCGTGCAGGCTTAAA-1	A
AGCGTGCAGGGTGTTG-1	G
AGCGTGCCAAAGAAGG-1	A
AGCGTGCCAACGGACA-1	G
AGCGTGCCATATACGC-1	A
AGCGTGCCATCGGCCA-1	A
AGCGTGCCATGCTATG-1	A
AGCGTGCCATGTATCG-1	G
AGCGTGCCATTATGGC-1	A
AGCGTGCCATTTGGTG-1	G
AGCGTGCGTAACCGAG-1	A
AGCGTGCGTACCCATA-1	A
AGCGTGCGTTGCCTGG-1	A
AGCGTGCTCGCACCGA-1	G
AGCTATGAGTACCTCA-1	A
AGCTATGAGTAGAAGG-1	A
AGCTATGCAAAGGAAG-1	G
AGCTATGCACAGTTAC-1	G
AGCTATGCACTAGGAG-1	A
AGCTATGCAGATAAGT-1	G
AGCTATGGTAGCATGG-1	A
AGCTATGGTAGTCCAT-1	A
AGCTATGGTATTCTGG-1	A
AGCTATGGTCAGCTTA-1	A
AGCTATGGTCTGTGTA-1	A
AGCTGATAGACGCCAA-1	G
AGCTGATAGGCCTAAG-1	A
AGCTGATAGGTAAGTT-1	G
AGCTGATCAGCAATGG-1	A
AGCTGATCAGGTTATC-1	G
AGCTGATCAGTAACGG-1	A
AGCTGATCAGTGCGAA-1	A
AGCTGATGTAGGTCTT-1	A
AGCTGATGTCTCTGCT-1	G
AGCTGATGTCTTAGCA-1	G
AGCTGATGTGATGCGA-1	G
AGCTGATGTGCATTCA-1	G
AGCTGATTCACAGGGA-1	A
AGCTGATTCAGTGGTT-1	A
AGCTGATTCCGTGCAG-1	A
AGCTGATTCGGTTGTA-1	A
AGCTGATTCTTGCGCT-1	A
AGCTGGCAGAGGAACA-1	G
AGCTGGCCAACTCAAC-1	A
AGCTGGCCACTAAACC-1	G
AGCTGGCCATAGTCCA-1	A
AGCTGGCCATCACAGT-1	G
AGCTGGCGTGACGCAA-1	G
AGCTGGCGTTGTGAGG-1	A
AGCTGGCTCATACTTC-1	A
AGCTGGCTCCCAATAG-1	A
AGCTGGCTCCTTTGCG-1	A
AGCTGGCTCGTAGCGC-1	A
AGCTGGCTCTCGCGTT-1	A
AGCTGTAAGAGCTACG-1	A
AGCTGTAAGTTAGAGT-1	G
AGCTGTAAGTTCCCGG-1	G
AGCTGTACAATAGTGA-1	A
AGCTGTACAATGGCTT-1	A
AGCTGTACACAACGGA-1	G
AGCTGTACACAGCCAC-1	A
AGCTGTACACGATATC-1	G
AGCTGTACAGAGATGC-1	A
AGCTGTACAGCGCGTT-1	G
AGCTGTACATCAGCTA-1	G
AGCTGTACATTCACGA-1	A
AGCTGTACATTCTCGC-1	A
AGCTGTAGTTACTTTC-1	A
AGCTGTAGTTTGATCG-1	G
AGGACGAAGACAGTGC-1	A
AGGACGAAGCAACTGG-1	A
AGGACGAAGGAGGCGA-1	G
AGGACGAAGTCTGGGA-1	G
AGGACGACACAATAAG-1	G
AGGACGACACGGTTAT-1	A
AGGACGACACGTTAGT-1	A
AGGACGACAGCAGGTA-1	A
AGGACGACAGGACCTC-1	A
AGGACGACATTCGTCC-1	A
AGGACGAGTAGCGTTT-1	G
AGGACGAGTGGACCAA-1	G
AGGACGAGTTCCGCGA-1	G
AGGACGAGTTTGCATG-1	A
AGGACGATCGAGAAGC-1	G
AGGACGATCGCACCTT-1	A
AGGACGATCGCCTTAC-1	G
AGGACGATCGGTACTA-1	G
AGGACGATCTTAAGCG-1	G
AGGCCCAAGAGGAAGT-1	A
AGGCCCAAGCATGATA-1	G
AGGCCCAAGGGAAGCG-1	A
AGGCCCACAAAGGCCA-1	G
AGGCCCACACCGTCTT-1	G
AGGCCCAGTAGGTCTT-1	G
AGGCCCAGTCGATAGG-1	G
AGGCCCAGTGCTGTGC-1	G
AGGCCCATCACTCGGG-1	G
AGGCCTGAGGAGGCGA-1	G
AGGCCTGAGGATTGCG-1	G
AGGCCTGAGTTCCCGG-1	G
AGGCCTGCACCGAAAG-1	A
AGGCCTGCAGTTGGAG-1	A
AGGCCTGCATCCCAAA-1	A
AGGCCTGGTATTTGCG-1	A
AGGCCTGGTGTACGCC-1	G
AGGCCTGTCCAACGCG-1	G
AGGCCTGTCGCTCTAC-1	G
AGGCGAAAGCGAGAAA-1	G
AGGCGAAAGCGTTGCC-1	A
AGGCGAAAGGCAGATC-1	G
AGGCGAAAGGTCCTCG-1	A
AGGCGAAAGGTGATGC-1	A
AGGCGAAAGTGAGTTA-1	A
AGGCGAAAGTGTTCCA-1	A
AGGCGAACAAACGTTC-1	A
AGGCGAACAAGACTTC-1	A
AGGCGAAGTAAACGTA-1	A
AGGCGAAGTGCTTGAT-1	A
AGGCGAAGTTTGCGAT-1	G
AGGCGAATCCATACGA-1	A
AGGCGAATCCTTGACC-1	G
AGGCGTCAGAAACGCC-1	G
AGGCGTCAGTATCTGC-1	A
AGGCGTCAGTTCTCCC-1	A
AGGCGTCCAACTCGAT-1	G
AGGCGTCCAGCAGGTA-1	A
AGGCGTCGTAAGCCTT-1	A
AGGCGTCGTATTGTCG-1	A
AGGCGTCGTTCCCGGA-1	A
AGGCGTCTCAGTACAC-1	A
AGGCGTCTCTCATCCG-1	A
AGTCAACAGTAGGTCG-1	G
AGTCAACGTGCGTAGA-1	A
AGTCAACGTTAACCAC-1	A
AGTCAACTCCTCTCTT-1	A
AGTCCGGAGATCGCCC-1	G
AGTCCGGAGCTCCGGT-1	A
AGTCCGGAGGCCTAAG-1	A
AGTCCGGAGTAACATG-1	G
AGTCCGGCAAGGAACC-1	A
AGTCCGGCAGATACAA-1	G
AGTCCGGCAGCTATAC-1	G
AGTCCGGCATCGACCG-1	A
AGTCCGGGTCTGTCCT-1	G
AGTCCGGTCCTCCCAA-1	A
AGTCCGGTCGGGAATG-1	A
AGTGCCGAGTGAGTGC-1	A
AGTGCCGAGTTTGGAA-1	G
AGTGCCGCACTCCTCA-1	A
AGTGCCGCAGAGCCAA-1	A
AGTGCCGCATTACTCT-1	A
AGTGCCGGTAGCAGCA-1	A
AGTGCCGGTCATAAGA-1	A
AGTGCCGGTCGTAATC-1	A
AGTGCCGGTGCATTCA-1	A
AGTGCCGTCGATTACG-1	G
AGTGCGCCAGGCAAGT-1	G
AGTGCGCCAGTAAGCG-1	A
AGTGCGCCAGTGCTCG-1	G
AGTGCGCGTCCCTTTG-1	G
AGTGCGCGTCCGGTAC-1	G
AGTGCGCGTGATAACA-1	G
AGTGCGCGTGCGCATC-1	A
AGTGCGCGTGGCCTCA-1	G
AGTGCGCGTTCTTAGG-1	A
AGTGCGCTCGGTTGTA-1	G
AGTGTACAGAGCTCCC-1	G
AGTGTACAGGACTAGC-1	A
AGTGTACAGGTAGGCT-1	G
AGTGTACAGTATAGTG-1	G
AGTGTACCAGATGGCA-1	A
AGTGTACGTGCTTGAT-1	G
AGTGTACGTTACGAAA-1	G
AGTGTACGTTGGACGA-1	A
AGTGTACGTTGGGAAC-1	A
AGTGTACTCCTGTAGA-1	G
AGTGTACTCTCTATTG-1	A
AGTGTACTCTTCTTCC-1	G
AGTTACGAGACACAAT-1	G
AGTTACGAGATTAGAC-1	A
AGTTACGAGCTAGTTC-1	A
AGTTACGAGTCGAGCA-1	G
AGTTACGAGTTAGCGG-1	G
AGTTACGCAAGCCAGA-1	A
AGTTACGCAATGCACT-1	G
AGTTACGCACTTATGG-1	A
AGTTACGCATCCTCGT-1	A
AGTTACGCATCGCCTT-1	A
AGTTACGCATGGATGG-1	A
AGTTACGGTGAGTAAT-1	A
AGTTACGTCGCTCTAC-1	G
AGTTACGTCTTTCGAT-1	A
AGTTTGGAGCGTGTTT-1	A
AGTTTGGAGGCGTCCT-1	A
AGTTTGGAGGTCCTCG-1	G
AGTTTGGAGTAGGAAG-1	A
AGTTTGGAGTGCACAG-1	A
AGTTTGGAGTGGGACT-1	A
AGTTTGGGTAACATAG-1	A
AGTTTGGGTCATAGCT-1	A
AGTTTGGGTGCAAGAC-1	G
AGTTTGGGTGCGTTTA-1	A
AGTTTGGTCATCATGG-1	G
AGTTTGGTCCAAACCA-1	G
AGTTTGGTCGAGCGCT-1	G
AGTTTGGTCGGTACTA-1	A
ATAGGCTAGCTTTCCC-1	A
ATAGGCTAGTAGCAAT-1	A
ATAGGCTCAAGCCAGA-1	G
ATAGGCTCAAGCCCTG-1	G
ATAGGCTCATCGAGTT-1	G
ATAGGCTCATTACTCT-1	A
ATAGGCTGTCAGAGTG-1	A
ATAGGCTGTGATAAGT-1	A
ATAGGCTGTTCCTATT-1	G
ATAGGCTTCCGAGAGA-1	A
ATAGGCTTCGAACCGC-1	A
ATAGGCTTCGATATGC-1	A
ATAGGCTTCTCGTGAA-1	A
ATAGTCGAGAACTCCT-1	A
ATAGTCGAGAATGCTA-1	G
ATAGTCGAGAGACTCG-1	G
ATAGTCGAGCCATTCA-1	G
ATAGTCGAGGAGTACC-1	A
ATAGTCGAGGATGTCG-1	G
ATAGTCGAGTTTGGAA-1	G
ATAGTCGCAAGTAATG-1	G
ATAGTCGCACAAACGG-1	G
ATAGTCGCACACATTG-1	A
ATAGTCGCACTCCACT-1	A
ATAGTCGCAGATTAAG-1	A
ATAGTCGGTACAAATG-1	A
ATAGTCGGTAGCGAGT-1	A
ATAGTCGGTCAAACAA-1	A
ATAGTCGGTCAATACC-1	A
ATAGTCGGTGTCTACA-1	G
ATAGTCGGTTAGAGAT-1	G
ATAGTCGTCGGGAATG-1	A
ATAGTCGTCGTATAGC-1	A
ATAGTCGTCTGACTTT-1	G
ATAGTCGTCTGGCCAG-1	G
ATATTCCAGACCCATT-1	A
ATATTCCAGTAGCAAT-1	A
ATATTCCAGTCTGGGA-1	G
ATATTCCAGTTCCCGG-1	A
ATATTCCCAAGACTTC-1	A
ATATTCCCACCACAGC-1	G
ATATTCCCACCCTTAC-1	A
ATATTCCCACCCTTTG-1	G
ATATTCCCACCTACCT-1	G
ATATTCCCATTGTTCT-1	G
ATATTCCGTACATGGG-1	A
ATATTCCGTCTCTGGG-1	G
ATATTCCGTTACCACA-1	A
ATATTCCTCCAACAAC-1	A
ATATTCCTCCCAATAG-1	A
ATATTCCTCCGCCTAT-1	A
ATATTCCTCGGCATAT-1	G
ATATTCCTCTACTTTG-1	A
ATATTCCTCTGGCCAG-1	G
ATATTCCTCTTCATAC-1	A
ATCCAGAAGCTACGCC-1	G
ATCCAGAAGGATATCA-1	A
ATCCAGAAGGCAATTA-1	G
ATCCAGAAGTCCGTGC-1	G
ATCCAGACAAGCAACG-1	A
ATCCAGACACAGAAGC-1	A
ATCCAGACACCTGTGG-1	A
ATCCAGACAGTAGTCT-1	G
ATCCAGACATGGGAAC-1	A
ATCCAGAGTAGCCATT-1	G
ATCCAGAGTATGAAGT-1	G
ATCCAGAGTCAAACAA-1	G
ATCCAGAGTGAATGTA-1	A
ATCCAGATCCATCTAT-1	G
ATCCAGATCCTAAAGC-1	A
ATCCAGATCGCGGCAT-1	A
ATCCCTGAGCTTCAAC-1	A
ATCCCTGAGGAAGAAC-1	G
ATCCCTGAGGTACACG-1	G
ATCCCTGCAAGACACG-1	A
ATCCCTGCAATACTGC-1	A
ATCCCTGGTCCAACCG-1	A
ATCCCTGGTGCGCATC-1	G
ATCCCTGGTGCTTTGA-1	G
ATCCCTGGTGTCGTCG-1	A
ATCCCTGGTTGGACGA-1	A
ATCCCTGTCACCACAA-1	A
ATCCCTGTCAGTGTGT-1	A
ATCCCTGTCCAGTTAG-1	A
ATCCCTGTCGAGAAGC-1	A
ATCCCTGTCTAGCAGT-1	A
ATCCTCGAGACTTCCA-1	G
ATCCTCGAGCCCATTA-1	A
ATCCTCGAGCTGGAGT-1	A
ATCCTCGAGGATGTAT-1	G
ATCCTCGCACTCCTCA-1	A
ATCCTCGGTAGCCATT-1	A
ATCCTCGGTCGCTAGC-1	G
ATCCTCGGTGCGCATC-1	A
ATCCTCGGTGCTGAAG-1	A
ATCCTCGGTTCTTATC-1	A
ATCCTCGGTTGGAGGT-1	G
ATCCTCGTCCAGGGAA-1	A
ATCCTCGTCCGGACTG-1	G
ATCCTCGTCCGGCTGA-1	A
ATCCTCGTCGATAGCT-1	A
ATCCTCGTCGCTAGTA-1	A
ATCCTCGTCTATTTCG-1	G
ATCCTCGTCTCTATCA-1	A
ATCCTGCAGACAACGC-1	G
ATCCTGCAGACTAGCG-1	G
ATCCTGCAGCATGATA-1	A
ATCCTGCCAGCAGGTA-1	G
ATCCTGCCATAGCCGC-1	G
ATCCTGCCATCTGCAA-1	A
ATCCTGCCATTACCTT-1	G
ATCCTGCCATTGAACC-1	G
ATCCTGCGTAAACCCT-1	A
ATCCTGCGTACAAGCG-1	G
ATCCTGCGTACTATGC-1	A
ATCCTGCGTCAAACAA-1	A
ATCCTGCGTCCCTTTG-1	G
ATCCTGCGTCCGCTTT-1	A
ATCCTGCGTCGAGGTA-1	A
ATCCTGCTCTTCCACG-1	G
ATCGAGTAGATGTTGA-1	A
ATCGAGTCACTCGTGG-1	G
ATCGAGTGTCAGTGTT-1	A
ATCGAGTGTCGATTAC-1	A
ATCGAGTGTGCAACAG-1	A
ATCGAGTGTGCAAGAC-1	A
ATCGAGTGTGGACAGT-1	A
ATCGAGTGTGGACGAT-1	A
ATCGAGTGTGGATTTC-1	A
ATCGAGTTCAGGTTTG-1	G
ATCGAGTTCGATCGCG-1	A
ATGCATGAGAAAGGGT-1	G
ATGCATGAGCCATGGA-1	A
ATGCATGAGCGTATCT-1	A
ATGCATGCAGCGTACC-1	A
ATGCATGCATCCCTCA-1	A
ATGCATGCATTGTTCT-1	A
ATGCATGGTCTGGATT-1	G
ATGCATGGTTACGAAA-1	A
ATGCATGGTTCGGGAA-1	A
ATGCATGGTTTAGAAG-1	G
ATGCATGTCATTGCCC-1	G
ATGCATGTCCAGAGAG-1	G
ATGCATGTCCATGTTT-1	G
ATGCATGTCGCTATTT-1	G
ATGGATCAGACCATAA-1	G
ATGGATCAGCGTTAGG-1	G
ATGGATCAGCTGAAAT-1	A
ATGGATCAGGGTTCTT-1	A
ATGGATCAGTCGTATC-1	A
ATGGATCCACATGATC-1	G
ATGGATCCAGAAAGAG-1	G
ATGGATCCAGTAAGCG-1	A
ATGGATCCAGTTAAAG-1	G
ATGGATCCATGCCCTT-1	G
ATGGATCGTAACCCAT-1	G
ATGGATCGTAAGCCGA-1	A
ATGGATCGTCATTGCA-1	G
ATGGATCGTCTCTGGG-1	A
ATGGATCGTCTGGTCG-1	A
ATGGATCGTGACAAGC-1	G
ATGGATCGTGATTCCA-1	G
ATGGATCGTGCCCTAG-1	G
ATGGATCGTGCTTTGA-1	A
ATGGATCGTGGATTTC-1	G
ATGGATCTCAACTTGG-1	A
ATGGATCTCACTACCC-1	G
ATGGATCTCCAGAATC-1	A
ATGGATCTCCTCATTA-1	A
ATGGATCTCGTAGCGC-1	A
ATGGATCTCTGTTGCC-1	G
ATGTACGAGGCAATTA-1	A
ATGTACGAGGGAGATA-1	G
ATGTACGAGTGATAAC-1	A
ATGTACGAGTTCCAGT-1	A
ATGTACGCACAGCTTA-1	A
ATGTACGCACGAACGA-1	A
ATGTACGCAGGCATTT-1	A
ATGTACGGTAGCGTTT-1	A
ATGTACGGTCCACCAG-1	G
ATGTACGTCTCATCCG-1	G
ATGTACGTCTGGACAT-1	A
ATGTCGAAGGAAGACA-1	G
ATGTCGACACTCGGAC-1	A
ATGTCGACATAGGCGA-1	G
ATGTCGACATGACTGT-1	A
ATGTCGACATGCCTTC-1	G
ATGTCGAGTAACGTAA-1	G
ATGTCGAGTAGCGAGT-1	G
ATGTCGAGTAGGTGAC-1	A
ATGTCGAGTATGGATA-1	A
ATGTCGAGTATTCGAC-1	G
ATGTCGAGTATTCTGG-1	A
ATGTCGAGTCTGCACG-1	A
ATGTCGAGTGATGCGA-1	A
ATGTCGAGTGCACCCA-1	G
ATGTCGAGTGTGAGGT-1	G
ATGTCGAGTTTGTGAC-1	G
ATGTCGATCAACTTGG-1	G
ATGTCGATCAGGTCTA-1	A
ATGTCGATCTGTTTAC-1	G
ATGTCTTAGATTGACA-1	G
ATGTCTTAGCGCATTT-1	A
ATGTCTTCAACGACAG-1	A
ATGTCTTCACAGCCAC-1	A
ATGTCTTCAGAACAGC-1	G
ATGTCTTCAGAACTTC-1	G
ATGTCTTCATTCTCGC-1	A
ATGTCTTGTACGCCCA-1	A
ATGTCTTGTAGATTAG-1	A
ATGTCTTGTCAGTGTT-1	G
ATGTCTTGTGCATTCA-1	A
ATGTCTTGTTAGTAGA-1	A
ATGTCTTTCACCACAA-1	A
ATGTCTTTCCACGAGC-1	A
ATGTCTTTCCTATCAT-1	A
ATGTCTTTCGATATGC-1	G
ATGTCTTTCGTTACAG-1	G
ATGTCTTTCTCTGCGT-1	G
ATGTTTCAGAACGTCG-1	A
ATGTTTCAGGTTGTGG-1	A
ATGTTTCAGTCGTGAG-1	G
ATGTTTCAGTGTAATG-1	A
ATGTTTCCAACAACTC-1	G
ATGTTTCCAATTGCCA-1	A
ATGTTTCCACAGAAGC-1	A
ATGTTTCCAGCGTGAA-1	G
ATGTTTCGTAACCGAG-1	A
ATGTTTCGTGTTGTTG-1	G
ATGTTTCTCGATGTAC-1	A
ATGTTTCTCGCGTGAC-1	A
ATGTTTCTCTCTATTG-1	A
ATGTTTCTCTTAAGCG-1	A
ATTACCTAGGCGATTG-1	A
ATTACCTAGTGCTGAG-1	A
ATTACCTAGTGGACGT-1	A
ATTACCTCAGATAAGT-1	A
ATTACCTCAGATTTGC-1	G
ATTACCTCAGGATAGC-1	A
ATTACCTCATGTGGGA-1	G
ATTACCTGTATCAGCT-1	G
ATTACCTGTCACCCGA-1	G
ATTACCTGTCTCAAAC-1	G
ATTACCTGTCTGATTG-1	A
ATTACCTGTGATGTGG-1	G
ATTACCTTCCACGCTT-1	G
ATTACCTTCTTCTCTC-1	A
ATTACTCAGAATCAAC-1	A
ATTACTCAGCATACCT-1	G
ATTACTCAGGAAGGTA-1	A
ATTACTCAGGACCGAT-1	G
ATTACTCAGGACTAGC-1	G
ATTACTCAGGGTCCCT-1	A
ATTACTCAGTAGCAAT-1	A
ATTACTCAGTGCACAG-1	A
ATTACTCAGTGGGACT-1	A
ATTACTCAGTTGGAAT-1	A
ATTACTCCACCTGAAT-1	A
ATTACTCCATAGATAG-1	A
ATTACTCGTAGGTCTT-1	A
ATTACTCGTGAGTAAT-1	A
ATTACTCTCTCTTCTC-1	A
ATTCGTTAGTACGCGA-1	G
ATTCGTTCAGGATGTG-1	A
ATTCGTTCATGGCCGT-1	G
ATTCGTTGTAACAATG-1	G
ATTCGTTGTGCCCAGT-1	A
ATTCGTTGTTACTTTC-1	G
ATTCGTTGTTCCGCGA-1	G
ATTCGTTTCAGCACGC-1	A
ATTCGTTTCCGATGCG-1	A
ATTCGTTTCCTGGAAT-1	A
ATTCGTTTCGGGACAA-1	A
ATTGTCTAGCTGAATA-1	A
ATTGTCTAGGCCAGTA-1	G
ATTGTCTCAAGTCTGT-1	A
ATTGTCTCACATTCTT-1	G
ATTGTCTCAGGTAGCA-1	G
ATTGTCTCATAGGCGA-1	G
ATTGTCTGTAGTCTGT-1	G
ATTGTCTGTATGGGTG-1	A
ATTGTCTGTCAAGACG-1	G
ATTGTCTGTCCCTTTG-1	A
ATTGTCTGTCTGTGTA-1	G
ATTGTCTGTTCCAATG-1	A
ATTGTCTTCCAACGCG-1	A
ATTGTCTTCCATCGAA-1	A
ATTGTCTTCCGAGGAA-1	G
ATTGTCTTCCGGACTG-1	A
ATTGTGGAGACGCCAA-1	A
ATTGTGGAGCCGCAAA-1	G
ATTGTGGAGTGAGTGC-1	A
ATTGTGGAGTGAGTTA-1	G
ATTGTGGCAACGCACC-1	A
ATTGTGGCAAGCAGGT-1	A
ATTGTGGCATCATAGC-1	G
ATTGTGGGTATTGTCG-1	G
ATTGTGGGTCTAACCA-1	A
ATTGTGGGTCTCTGGG-1	G
ATTGTGGGTGCCCGAT-1	G
ATTGTGGTCAAGGCAG-1	A
ATTGTGGTCAGGGTTT-1	G
ATTGTGGTCATTCATC-1	A
ATTTGTCAGTGCCCTG-1	A
ATTTGTCCACTCGCAG-1	G
ATTTGTCCATAGCCGC-1	A
ATTTGTCCATTAGCCA-1	A
ATTTGTCGTCATCAAC-1	A
ATTTGTCGTGATCAGG-1	G
ATTTGTCGTGCACTTA-1	A
ATTTGTCGTGCGCATC-1	A
ATTTGTCGTGTCGTGC-1	G
ATTTGTCTCTCGACCT-1	A
CAAAGCTAGATGTTGA-1	G
CAAAGCTAGCCCATTA-1	G
CAAAGCTCAAACGACG-1	G
CAAAGCTCACCGTTGG-1	A
CAAAGCTGTAGTTTGC-1	G
CAAAGCTGTTCAGTTG-1	A
CAAAGCTTCAGCACGC-1	G
CAAAGCTTCGGTCGAC-1	G
CAACCAAAGTCGACCC-1	G
CAACCAACAAGGTCGA-1	G
CAACCAACAGGAGCAT-1	G
CAACCAACATTTAGGC-1	G
CAACCAAGTACCGGCT-1	A
CAACCAAGTGACGCAA-1	A
CAACCAAGTGCTTGAT-1	G
CAACCAATCCGGCTGA-1	A
CAACCAATCCTGAAAC-1	A
CAACCAATCGATATGC-1	A
CAACCAATCGCCTTAC-1	A
CAACCAATCTAGCTGA-1	G
CAACCAATCTCGTGAA-1	A
CAACGGCAGCAATAAC-1	G
CAACGGCAGGTACTCT-1	G
CAACGGCCAAGCGTCC-1	G
CAACGGCCACTCGCAG-1	A
CAACGGCGTCAGGTGA-1	A
CAACGGCGTGGAAAGA-1	G
CAACGGCTCACCCTTG-1	G
CAACGGCTCCTATCCG-1	G
CAACGGCTCGGTTCCT-1	A
CAACGGCTCTCTTCCT-1	A
CAACGGCTCTTTGCAT-1	G
CAACGTAAGATCGCCC-1	A
CAACGTAAGTACTCTG-1	A
CAACGTACAAATGCTC-1	A
CAACGTACAAGACTTC-1	G
CAACGTACAAGTAACA-1	G
CAACGTACAGGATAGC-1	A
CAACGTACAGTAACTC-1	G
CAACGTAGTAAACGTA-1	G
CAACGTAGTAAAGCTA-1	A
CAACGTAGTTTAGGAA-1	A
CAACGTATCCAGAATC-1	A
CAACGTATCCATCTAT-1	A
CAACGTATCCCACTAC-1	G
CAACGTATCGCTCTAC-1	A
CAAGAAAAGGAAGAAC-1	A
CAAGAAAAGGTTAGTA-1	G
CAAGAAAAGTTGCTTG-1	A
CAAGAAACACCATTCC-1	G
CAAGAAACATGTGAGG-1	G
CAAGAAACATTAAGGA-1	A
CAAGAAAGTCCTTATT-1	A
CAAGAAAGTCTGCGCA-1	G
CAAGAAAGTGCCGGTT-1	A
CAAGAAATCACTGGTA-1	A
CAAGAAATCAGGCGCT-1	G
CAAGAAATCCCTACCA-1	G
CAAGAAATCTCGTAGA-1	A
CAAGAAATCTGGCACG-1	G
CAAGAAATCTGGCTAA-1	A
CAAGCTAAGAGGCGGA-1	A
CAAGCTAAGCAGTAGC-1	A
CAAGCTAAGCATGTGG-1	G
CAAGCTAAGTTCAACC-1	G
CAAGCTACACCTGAAT-1	G
CAAGCTACACTCCACT-1	A
CAAGCTAGTCAGAGTG-1	A
CAAGCTAGTCTGGGAA-1	A
CAAGCTATCACTGATG-1	A
CAAGCTATCGCAAACT-1	A
CAAGGCCAGAAATCTG-1	A
CAAGGCCAGATTAGAC-1	A
CAAGGCCAGCTAACAA-1	G
CAAGGCCAGGCACTAG-1	G
CAAGGCCAGGCTTAAA-1	A
CAAGGCCCAATCACTG-1	G
CAAGGCCCACAGGAAC-1	A
CAAGGCCCAGATTTGC-1	G
CAAGGCCCATGTATCG-1	A
CAAGGCCGTAAGTCTC-1	A
CAAGGCCGTCATCAAC-1	A
CAAGGCCGTGAATGTA-1	G
CAAGGCCTCGAGAAGC-1	A
CAAGGCCTCGCCACTT-1	A
CAAGGCCTCGGGATCC-1	G
CAAGGCCTCTTACGGA-1	A
CAATCCCAGAGATTAC-1	G
CAATCCCAGGGCGAAG-1	G
CAATCCCCAAGCAACG-1	A
CAATCCCCAAGGGTAC-1	A
CAATCCCCAGATGGCA-1	G
CAATCCCCAGCGTGAA-1	G
CAATCCCCATCCCAAA-1	A
CAATCCCGTCTCAAAC-1	A
CAATCCCTCACGATTG-1	A
CAATCCCTCATTCTCA-1	A
CAATCCCTCGACTTAG-1	A
CAATCCCTCGATATGC-1	A
CAATCCCTCTTAATCC-1	A
CACAACAAGGCTCCTG-1	G
CACAACACAATTGGCT-1	A
CACAACACAGGCAGAT-1	G
CACAACACATCATCGA-1	G
CACAACACATCCTCGT-1	A
CACAACACATGCGTTA-1	G
CACAACACATGGTTTG-1	A
CACAACACATTAGCAC-1	G
CACAACAGTAGAACGC-1	A
CACAACAGTCAATCCA-1	A
CACAACAGTCAGAAGC-1	A
CACAACAGTGAATACA-1	A
CACAACAGTTTCTACT-1	A
CACAACATCCAAACCA-1	G
CACAACATCCGGACTG-1	A
CACAACATCTCCACTG-1	G
CACAACATCTCGCGTT-1	A
CACAACATCTTGCGCT-1	A
CACAGATAGCCCATGC-1	A
CACAGATAGGTGTCGA-1	A
CACAGATAGTGAACCG-1	A
CACAGATAGTGGTGTG-1	A
CACAGATCAAGAGATT-1	A
CACAGATCAAGGAAGA-1	A
CACAGATCACTGTAAC-1	G
CACAGATCAGACCTGC-1	G
CACAGATGTAACAATG-1	G
CACAGATGTGCAGACA-1	A
CACAGATGTTATCGAC-1	G
CACAGATTCCTCCTGA-1	A
CACAGATTCGCTTACC-1	A
CACAGATTCTTACCTA-1	A
CACATGAAGACAACGC-1	G
CACATGAAGGCTTCGC-1	G
CACATGACAACGGGTA-1	A
CACATGACAGCGTACC-1	G
CACATGAGTATTGTCG-1	G
CACATGATCACTACCC-1	G
CACATGATCACTAGGT-1	A
CACATGATCGCCACTT-1	A
CACATGATCGCCTTAC-1	A
CACATGATCTTAACGG-1	A
CACCACTAGAGCGGTT-1	G
CACCACTAGAGGAATG-1	A
CACCACTAGCAGGAGG-1	A
CACCACTAGTCCCGCA-1	G
CACCACTCAATGCATC-1	G
CACCACTCATCCCTCA-1	A
CACCACTTCACTCCCA-1	A
CACCTGTAGCGCGTTC-1	G
CACCTGTAGGTTTCTG-1	G
CACCTGTAGTAACTCC-1	G
CACCTGTAGTATGGGC-1	G
CACCTGTAGTCCCTCT-1	G
CACCTGTCAAGGAACC-1	A
CACCTGTCAGGTGTCC-1	A
CACCTGTCAGGTTATC-1	G
CACCTGTCATTGTTCT-1	G
CACCTGTGTAGGGTCA-1	A
CACCTGTGTCAACGGA-1	G
CACCTGTGTCACATTG-1	A
CACCTGTGTCAGTGCC-1	G
CACCTGTGTGTACGCC-1	A
CACCTGTGTGTAGGAC-1	A
CACCTGTGTTGTCGGC-1	A
CACCTGTGTTTGTGAC-1	A
CACCTGTTCACAACAC-1	G
CACCTGTTCCAGCACG-1	G
CACCTGTTCGCATACA-1	G
CACCTGTTCTAAACGC-1	A
CACCTTGAGGTGATGC-1	G
CACCTTGAGTTGCGCC-1	A
CACCTTGCACAAGGGT-1	G
CACCTTGCATTTGGTG-1	A
CACCTTGGTAGCTGTT-1	A
CACCTTGGTATTCTTC-1	A
CACCTTGGTGCACTTA-1	G
CACCTTGGTTCATTTC-1	G
CACCTTGGTTTCGTTT-1	G
CACCTTGTCCTAAAGC-1	G
CACCTTGTCGAGTGTT-1	A
CACCTTGTCTCGACAA-1	A
CACCTTGTCTTAAGCG-1	G
CACCTTGTCTTTCGAT-1	A
CACGTTCCAAGCAATA-1	A
CACGTTCCACGGTTAT-1	A
CACGTTCCACTTACAG-1	G
CACGTTCCATGTATCG-1	A
CACGTTCGTAGTACAA-1	G
CACGTTCGTATTCACG-1	G
CACGTTCGTCAATCCA-1	G
CACGTTCGTGCGTTTA-1	A
CACGTTCTCCTCCATG-1	G
CACTAAGAGGACCGAT-1	G
CACTAAGCAAAGGAAG-1	G
CACTAAGCACATCATG-1	A
CACTAAGCACGTGAAG-1	G
CACTAAGCAGGGAGTT-1	A
CACTAAGGTATCACAC-1	G
CACTAAGGTCAATCCA-1	A
CACTAAGGTGGTAAGC-1	A
CACTAAGGTTCCCGGA-1	A
CACTAAGTCAGGCGCT-1	G
CACTAAGTCCATGTTT-1	G
CACTAAGTCCGGGCAT-1	G
CACTAAGTCCGTACGG-1	A
CACTAAGTCGCGCCAA-1	A
CACTAAGTCTATACCT-1	G
CACTGAAAGACTCGGA-1	A
CACTGAAAGAGTAAGG-1	A
CACTGAAAGATGCGCA-1	G
CACTGAAAGGGTGTTG-1	A
CACTGAAAGGTAGGCT-1	A
CACTGAAAGTACCTCA-1	G
CACTGAAAGTTGGAAT-1	G
CACTGAACACAGTTAC-1	A
CACTGAACAGGGTAAC-1	G
CACTGAACAGTCCTGG-1	G
CACTGAAGTACTTCAG-1	A
CACTGAAGTCGCTACG-1	A
CACTGAAGTGCAAGAC-1	G
CACTGAAGTGCGACCT-1	A
CACTGAAGTGTACGCC-1	A
CACTGAAGTTGTCGGC-1	G
CACTGAATCATTGCCC-1	A
CACTGAATCCTGTGGG-1	A
CACTGAATCGCGTTCT-1	A
CACTGAATCGGGACAA-1	A
CACTGAATCTGCGTCT-1	G
CAGCCTTAGAAGGGCG-1	A
CAGCCTTAGGATGTAT-1	A
CAGCCTTAGGTTCTCA-1	G
CAGCCTTAGTGCAACG-1	A
CAGCCTTAGTTAGCGG-1	G
CAGCCTTAGTTGACAA-1	G
CAGCCTTCAACTAGAA-1	A
CAGCCTTCAAGCGTCC-1	G
CAGCCTTCACCGAATT-1	G
CAGCCTTCATAGCCAT-1	G
CAGCCTTCATCCTGGG-1	A
CAGCCTTCATTAGCCA-1	A
CAGCCTTGTAACCGAG-1	G
CAGCCTTTCGAGAAGC-1	A
CAGCTAAAGGATTGAT-1	G
CAGCTAACAAAGACGC-1	G
CAGCTAACAACCTCTC-1	A
CAGCTAACACAGTTCA-1	A
CAGCTAACAGCGTGAA-1	A
CAGCTAACAGGCATTT-1	A
CAGCTAACAGTAACTC-1	A
CAGCTAAGTCACTCTC-1	A
CAGCTAAGTCCCTAAA-1	A
CAGCTAAGTCCTTCAC-1	G
CAGCTAAGTGCATCAT-1	G
CAGCTAAGTTATGCAC-1	G
CAGCTAATCACCCTTG-1	A
CAGCTAATCGTCCCAT-1	A
CAGCTAATCTCTTAAC-1	A
CAGCTGGAGAGGCAGG-1	G
CAGCTGGAGAGGTCCA-1	A
CAGCTGGAGATATGTG-1	G
CAGCTGGAGATTGACA-1	A
CAGCTGGAGCCTGTAT-1	A
CAGCTGGAGGATGTCG-1	G
CAGCTGGCATCCGTAA-1	G
CAGCTGGCATGCGACC-1	A
CAGCTGGGTCTCTAAG-1	A
CAGCTGGGTTACGAAA-1	A
CAGCTGGGTTCCAATG-1	A
CAGCTGGTCCAACGCG-1	A
CAGCTGGTCTTGCGCT-1	A
CAGGATTAGACCATAA-1	A
CAGGATTAGGATGTAT-1	G
CAGGATTCAATTGCCA-1	A
CAGGATTCAGGCATCC-1	G
CAGGATTGTAAACGGC-1	G
CAGGATTGTACAAATG-1	A
CAGGATTGTGCTGGCT-1	A
CAGGATTGTTGTATCG-1	A
CAGGATTTCCAGCACG-1	G
CAGGATTTCTCCCTTT-1	G
CAGGGCTAGAAATGGG-1	A
CAGGGCTAGCTTACCA-1	A
CAGGGCTAGTATAGTG-1	A
CAGGGCTCAACGTAGG-1	G
CAGGGCTCAATTGGCT-1	A
CAGGGCTCACGCGACT-1	G
CAGGGCTCATCATCGA-1	A
CAGGGCTCATGGCCTG-1	A
CAGGGCTGTAAACGGC-1	A
CAGGGCTGTCTGGGCT-1	A
CAGGGCTGTTCCGCGA-1	A
CAGGGCTGTTTCTACT-1	G
CAGGGCTTCAGCACTA-1	A
CAGGGCTTCCTAAGTG-1	A
CAGTATGAGAATATCG-1	G
CAGTATGAGAGTTCGG-1	A
CAGTATGAGATGGGAA-1	A
CAGTATGAGCAGGAGG-1	G
CAGTATGAGCTCCGGT-1	G
CAGTATGAGTCGACCC-1	G
CAGTATGAGTGAACCG-1	A
CAGTATGAGTGCTGAG-1	A
CAGTATGCAAAGGCCA-1	A
CAGTATGGTAGTCCAT-1	G
CAGTATGGTATATGGA-1	A
CAGTATGGTGTGAGGT-1	A
CAGTATGGTTCCCAAA-1	G
CAGTATGTCGAGTTAC-1	G
CAGTATGTCGCGCCAA-1	A
CAGTATGTCTGAACGT-1	A
CAGTGCGAGTATACGA-1	A
CAGTGCGAGTATAGTG-1	A
CAGTGCGAGTTGACAA-1	A
CAGTGCGCAAGAGATT-1	A
CAGTGCGCACTTTGGA-1	A
CAGTGCGCAGTAACTC-1	A
CAGTGCGCATCCCTTG-1	G
CAGTGCGGTAGACGCA-1	G
CAGTGCGGTATCGCGC-1	G
CAGTGCGGTCATCGTA-1	A
CAGTGCGGTCCGGTAC-1	G
CAGTGCGGTGATGCTT-1	A
CAGTGCGTCGGCAATT-1	A
CAGTGCGTCGTGATAC-1	A
CAGTGTAGTCATAGAA-1	G
CAGTGTAGTGACCAGA-1	A
CAGTGTAGTTATAGAG-1	A
CAGTGTAGTTGCCTGG-1	G
CAGTGTATCCAGGGAA-1	A
CAGTGTATCCAGGTAT-1	G
CAGTGTATCGGTCAGC-1	A
CATAACGAGTACCCAT-1	G
CATAACGCAGAACAGC-1	G
CATAACGCATAAAGTG-1	A
CATAACGCATCTCACC-1	A
CATAACGTCGACTTAG-1	A
CATAACGTCGTAGCGC-1	A
CATAACGTCTAAACGC-1	A
CATAACGTCTTACTCA-1	A
CATGCCTAGAGTGGTC-1	G
CATGCCTAGCCATCAT-1	A
CATGCCTAGCTGATTC-1	G
CATGCCTCAACTCAAC-1	A
CATGCCTCAAGTTCGT-1	G
CATGCCTCAAGTTGCT-1	A
CATGCCTCAGTCAGAG-1	A
CATGCCTGTATTCGAC-1	A
CATGCCTGTCACATTG-1	G
CATGCCTGTGCATTGT-1	G
CATGCCTGTGGACTGA-1	A
CATGCCTTCCGGGCAT-1	A
CATGCCTTCGTGGAAG-1	G
CATGTTTAGACGCCCT-1	G
CATGTTTAGACTCGGA-1	G
CATGTTTAGAGGAACA-1	A
CATGTTTAGATACCAA-1	G
CATGTTTAGCACACCC-1	A
CATGTTTAGGATGTCG-1	A
CATGTTTAGGGAGATA-1	A
CATGTTTAGTCACACT-1	G
CATGTTTCAAGCGAAC-1	G
CATGTTTCACAGATGG-1	A
CATGTTTGTAGCGAGT-1	G
CATGTTTGTGCTTGAT-1	G
CATGTTTGTGTCCAGC-1	G
CATGTTTGTGTCTACA-1	A
CATGTTTGTTAGAGAT-1	A
CATGTTTTCACAGGGA-1	A
CATGTTTTCTTAACGG-1	G
CATTCATAGACACGGT-1	G
CATTCATAGATTCCGT-1	A
CATTCATAGTCCGATT-1	A
CATTCATCAGAAGTGC-1	A
CATTCATCAGGCATCC-1	G
CATTCATGTATCGCGC-1	A
CATTCATGTGGTTCTA-1	G
CATTCATGTGTGACCC-1	G
CATTCATGTTGGGAAC-1	A
CATTCATTCAAGAGAT-1	A
CATTCATTCCAGAGAG-1	A
CATTCATTCCCAATGA-1	G
CATTCATTCCGGCTGA-1	A
CATTCATTCGTGTGCG-1	A
CATTCATTCTGTCGGG-1	A
CATTCCGAGAGAGTTT-1	A
CATTCCGAGATTGACA-1	A
CATTCCGAGGGTGTTG-1	A
CATTCCGCAATGACTC-1	A
CATTCCGCACGCTCAG-1	G
CATTCCGCAGGTCCTG-1	A
CATTCCGCAGGTTATC-1	G
CATTCCGCATAAAGTG-1	A
CATTCCGGTAGACACG-1	A
CATTCCGGTGAATCAA-1	G
CATTCCGGTGAGGGTT-1	A
CATTCCGGTGTGAGGT-1	G
CATTCCGTCAGGAAGC-1	G
CATTCCGTCGCTTCAC-1	A
CATTCCGTCGGTTAGT-1	G
CATTCCGTCGTCCCTA-1	G
CATTGGAAGAGCTACG-1	G
CATTGGAAGCTCGGCT-1	G
CATTGGAAGGAAGAAC-1	A
CATTGGAAGTAACACA-1	A
CATTGGAAGTGAACCG-1	A
CATTGGAAGTGCTCGC-1	G
CATTGGACAAGCGTCC-1	A
CATTGGACATATTGGC-1	A
CATTGGAGTAGGTGAC-1	A
CATTGGAGTGAATGGC-1	A
CATTGGAGTGAGTTGG-1	A
CATTGGATCCGAGAGA-1	A
CATTGGATCCGCCTAT-1	A
CCAATGAAGAGAAGCA-1	A
CCAATGAAGGCAATTA-1	A
CCAATGAAGTCGATAA-1	A
CCAATGACACGCGATC-1	A
CCAATGACAGGTAGCA-1	A
CCAATGACATTCCCGT-1	G
CCAATGAGTACAAATG-1	G
CCAATGAGTACCCACG-1	G
CCAATGAGTGCTGAAG-1	A
CCAATGAGTTCCCTTG-1	A
CCAATGAGTTTAGAAG-1	G
CCAATGATCTATACCT-1	A
CCACAGGAGACTTCCA-1	G
CCACAGGAGAGTTCGG-1	A
CCACAGGAGCTAGTTC-1	G
CCACAGGAGCTATCCA-1	A
CCACAGGAGGCGATTG-1	G
CCACAGGAGTTGCTTG-1	A
CCACAGGCAAACCGAG-1	G
CCACAGGCAGGCAAGT-1	A
CCACAGGCAGTAACCT-1	A
CCACAGGCAGTTAAAG-1	G
CCACAGGCATATAGAG-1	A
CCACAGGGTCAGTGCC-1	G
CCACAGGGTGAGGGTT-1	G
CCACAGGGTGTCCTTC-1	G
CCACAGGGTTCTACCC-1	G
CCACAGGTCCATCGAA-1	A
CCACAGGTCGAACCGC-1	G
CCACAGGTCGTTGTTT-1	A
CCACAGGTCTAGCTGA-1	G
CCACGTTAGAACGACC-1	A
CCACGTTAGGTCTTTG-1	A
CCACGTTAGTGAACCG-1	A
CCACGTTCAAGGTTCT-1	G
CCACGTTCATATACGC-1	A
CCACGTTGTATCTAGC-1	A
CCACGTTGTCAACTGT-1	A
CCACGTTGTTAACCAC-1	A
CCACGTTTCACACGTA-1	A
CCACGTTTCACATTCT-1	G
CCACGTTTCCACGCTT-1	A
CCACGTTTCCCTACGT-1	G
CCACGTTTCCGTGCGA-1	G
CCACGTTTCTGGCGCA-1	G
CCAGAATAGCGAATAT-1	A
CCAGAATAGTCGAAAT-1	A
CCAGAATCATCCGTGG-1	A
CCAGAATCATGGCCGT-1	G
CCAGAATTCATTCTTG-1	A
CCAGAATTCCTCTCTT-1	A
CCAGAATTCGCTTACC-1	A
CCAGATAAGAAACGCC-1	G
CCAGATAAGGTTAGTA-1	G
CCAGATAAGTGTCACT-1	G
CCAGATACACAAACGG-1	A
CCAGATACATCGTACA-1	A
CCAGATAGTAGTCTGT-1	A
CCAGATAGTATTGTCG-1	A
CCAGATAGTGATGCGA-1	G
CCAGATATCACCACAA-1	A
CCAGATATCACCCGGA-1	G
CCAGATATCCAGAATC-1	A
CCAGATATCTCGCGTT-1	A
CCATACCAGGACTTTC-1	G
CCATACCAGGCTTTAC-1	G
CCATACCCAATCATCG-1	A
CCATACCCACCTGTGG-1	A
CCATACCCACTCAGCG-1	A
CCATACCCATGGGTGA-1	A
CCATACCGTATTTGCG-1	A
CCATACCGTGAGGGTT-1	A
CCATACCTCCCGATTC-1	A
CCATACCTCCTATCCG-1	A
CCATACCTCGAGGCTC-1	G
CCATACCTCGTTCCGT-1	A
CCATACCTCTGACATG-1	G
CCCACATAGAGGCAGG-1	G
CCCACATAGCGTATCT-1	G
CCCACATAGCTGCCAC-1	G
CCCACATAGGCAAGGG-1	G
CCCACATAGGCTTCGC-1	G
CCCACATAGGGATCCA-1	G
CCCACATAGTGAATAC-1	A
CCCACATCAAGGACCA-1	G
CCCACATCAAGTCCTA-1	G
CCCACATCAAGTCTGT-1	G
CCCACATCAAGTTCGT-1	G
CCCACATCAGATAAGT-1	A
CCCACATGTCAATCCA-1	A
CCCACATGTCACATTG-1	A
CCCACATGTCCATTGA-1	A
CCCACATGTGGCGCTT-1	G
CCCACATGTGTTTCTT-1	A
CCCACATTCACCACAA-1	G
CCCACATTCACTAGGT-1	A
CCCACATTCATGTTCT-1	G
CCCACATTCGGTCGAC-1	A
CCCAGAGAGAAGGGCG-1	G
CCCAGAGAGACGAAAG-1	A
CCCAGAGAGAGAGTAG-1	G
CCCAGAGAGATAGGTT-1	G
CCCAGAGAGCAGAATT-1	G
CCCAGAGAGGGACGTT-1	G
CCCAGAGCATATACGC-1	G
CCCAGAGCATGGATGG-1	A
CCCAGAGGTAGTTTGC-1	A
CCCAGAGGTTACGAAA-1	G
CCCAGAGGTTTCCTAT-1	A
CCCAGAGTCACGTGTA-1	A
CCCAGAGTCCATACGA-1	G
CCCAGAGTCCATAGGT-1	G
CCCAGAGTCGTATAGC-1	A
CCCAGAGTCTAGCAGT-1	A
CCCAGAGTCTCTATCA-1	G
CCCAGAGTCTTGTCAT-1	G
CCCGTTAAGACTCGGA-1	A
CCCGTTAAGAGATTAC-1	A
CCCGTTAAGCCATCAT-1	A
CCCGTTAAGGAGAACA-1	A
CCCGTTAAGGTAGGAA-1	A
CCCGTTAAGGTAGGCT-1	A
CCCGTTAAGTAGAAGG-1	A
CCCGTTAAGTTTGGAA-1	G
CCCGTTACATGCACTA-1	G
CCCGTTAGTACAAGCG-1	G
CCCGTTAGTCTCGGGT-1	A
CCCGTTATCAGTCTTT-1	G
CCCGTTATCATACTTC-1	A
CCCGTTATCCTCCAGT-1	G
CCCGTTATCGTGGTAT-1	A
CCCGTTATCTATAGGC-1	A
CCCTAACAGAAATGGG-1	A
CCCTAACAGCGCCTAC-1	A
CCCTAACAGGTTCGAG-1	A
CCCTAACCAAAGGAAG-1	A
CCCTAACCACAGATGG-1	A
CCCTAACCAGTAGGCA-1	G
CCCTAACCATTGTGAC-1	A
CCCTAACGTAACAATG-1	G
CCCTAACGTCCCTTTG-1	A
CCCTAACGTGCGCATC-1	A
CCCTAACTCCCAGCAG-1	A
CCCTAACTCCCGAAGC-1	A
CCCTAACTCGGACGAA-1	A
CCCTAACTCTTGTGCC-1	A
CCCTAGTCACCTGTGG-1	G
CCCTAGTGTCAGACGA-1	A
CCCTAGTGTCCAAGTT-1	A
CCCTAGTGTCTGGGAA-1	A
CCCTAGTTCAGGCGCT-1	A
CCCTAGTTCTATCTCA-1	G
CCCTCTCAGAGCTCCC-1	G
CCCTCTCAGGACTTTC-1	G
CCCTCTCAGTACCACT-1	G
CCCTCTCCATCTCACC-1	A
CCCTCTCGTAACGGAC-1	A
CCCTCTCGTAGGTCTT-1	A
CCCTCTCGTCTGTGTA-1	G
CCCTCTCGTTCCAGTA-1	G
CCCTCTCTCCTCCAGT-1	G
CCCTCTCTCGGTCTAA-1	G
CCCTCTCTCGTGCTTC-1	A
CCCTGATAGGAATGGA-1	A
CCCTGATAGGTGAACC-1	G
CCCTGATCACAGTTAC-1	G
CCCTGATCAGCCACGT-1	G
CCCTGATCAGCTATAC-1	G
CCCTGATCAGTAAGCG-1	A
CCCTGATCATCGCCTT-1	G
CCCTGATCATCGCTAA-1	A
CCCTGATCATTGTGAC-1	G
CCCTGATGTCAAACAA-1	G
CCCTGATGTCACCCGA-1	A
CCCTGATGTTCCCAAA-1	A
CCCTGATGTTTGCCCT-1	G
CCCTGATTCAGTTGAC-1	A
CCCTGATTCGAGGCTC-1	G
CCCTGATTCGATAGCT-1	A
CCCTGATTCTTCTCTC-1	A
CCGAAGCAGCAGGAGG-1	G
CCGAAGCAGCTGCTCG-1	A
CCGAAGCAGTCGCCTG-1	A
CCGAAGCAGTGGACGT-1	G
CCGAAGCCAGAGTCGA-1	A
CCGAAGCCAGTATACC-1	A
CCGAAGCCATACCCGG-1	G
CCGAAGCGTACGGATG-1	A
CCGAAGCGTACGTATC-1	G
CCGAAGCGTATTGTCG-1	A
CCGAAGCGTGCACCCA-1	G
CCGAAGCGTGCCCGAT-1	A
CCGAAGCGTTACGCTA-1	G
CCGAAGCTCGGCAATT-1	A
CCGCATTAGAAGAGTG-1	G
CCGCATTAGTGCAACG-1	G
CCGCATTAGTTTGGAA-1	A
CCGCATTCACGGCCAT-1	A
CCGCATTCAGTAGTCT-1	G
CCGCATTCATCACAGT-1	A
CCGCATTGTAATGTAG-1	G
CCGCATTGTACGTAAA-1	A
CCGCATTGTCCAAGAG-1	G
CCGCATTGTGAGGGTT-1	A
CCGCATTGTGCCCAGT-1	G
CCGCATTTCAAGAGAT-1	A
CCGCATTTCCCACTTG-1	A
CCGCATTTCCGTGCAG-1	G
CCGCATTTCCTCCCAA-1	A
CCGCATTTCGTCCCAT-1	G
CCGTACTAGTCAACTC-1	A
CCGTACTAGTCCTTCC-1	A
CCGTACTAGTGAGTGC-1	G
CCGTACTCAAACGACG-1	A
CCGTACTCAACGCAAG-1	G
CCGTACTCATAGCAGG-1	G
CCGTACTCATGGTTTG-1	A
CCGTACTGTCTGCACG-1	A
CCGTACTGTTTGAAGA-1	A
CCGTACTTCAGCCGGT-1	A
CCGTACTTCCGCCTAT-1	G
CCGTACTTCGTTCCGT-1	G
CCGTACTTCTTCTCTC-1	G
CCGTAGGAGGATTGCG-1	A
CCGTAGGAGTCCGTGC-1	A
CCGTAGGAGTGCTAGG-1	A
CCGTAGGCAAAGAGAG-1	G
CCGTAGGCAAGCGGTA-1	A
CCGTAGGCACTAGCCG-1	G
CCGTAGGCAGAGATGC-1	G
CCGTAGGCATCGTACA-1	G
CCGTAGGGTAATGTGA-1	G
CCGTAGGGTCCAAGAG-1	A
CCGTAGGGTGGTCGAA-1	A
CCGTAGGTCGAACCGC-1	A
CCGTAGGTCGCGCCAA-1	G
CCGTAGGTCGCGTTCT-1	G
CCGTAGGTCTATACCT-1	A
CCGTAGGTCTTGTCGC-1	G
CCGTGAGAGACACGGT-1	A
CCGTGAGAGCTCCGGT-1	A
CCGTGAGAGCTTACCA-1	A
CCGTGAGAGGTGTTGG-1	A
CCGTGAGAGTGAGTGC-1	A
CCGTGAGCAAACGTTC-1	G
CCGTGAGGTAGTAACA-1	G
CCGTGAGGTCATAGAA-1	A
CCGTGAGGTCGATTAC-1	G
CCGTGAGGTCGCTAGC-1	G
CCGTGAGGTTAGTAGA-1	G
CCGTGAGGTTTCTTAC-1	A
CCGTGAGTCATTCTCA-1	A
CCGTGAGTCCATCATT-1	A
CCTAAAGAGAGTGGAA-1	A
CCTAAAGAGATGGGAA-1	A
CCTAAAGAGGCCTCGT-1	G
CCTAAAGCAAATGCTC-1	A
CCTAAAGCAAGTCTCA-1	G
CCTAAAGCACGTTACA-1	A
CCTAAAGCAGCGTGAA-1	G
CCTAAAGCATGGTAAA-1	G
CCTAAAGCATTACTTC-1	G
CCTAAAGGTTCTTAGG-1	A
CCTAAAGGTTTCGACA-1	G
CCTAAAGTCCACGAGC-1	G
CCTAAAGTCCCAATGA-1	A
CCTAAAGTCGAGTTAC-1	G
CCTAAAGTCTCCCTTT-1	G
CCTAAAGTCTCGTAGA-1	G
CCTAAAGTCTCTATTG-1	A
CCTAAAGTCTGAACGT-1	A
CCTAAAGTCTGAGTAC-1	A
CCTAAAGTCTTAGTGG-1	G
CCTATTAAGCCTTTGA-1	G
CCTATTAAGGAAGACA-1	A
CCTATTAAGGGATCCA-1	A
CCTATTACATCCCAAA-1	G
CCTATTACATCGCTAA-1	G
CCTATTAGTAGCGTTT-1	A
CCTATTAGTGAATACA-1	A
CCTATTAGTGTTAGAA-1	G
CCTATTAGTTCCAATG-1	A
CCTATTATCAGGAATA-1	G
CCTATTATCTCCTTAA-1	G
CCTATTATCTGGCCAG-1	A
CCTCCCTAGAGAATTC-1	A
CCTCCCTAGCCGCTGT-1	A
CCTCCCTAGGTCTTTG-1	A
CCTCCCTAGTGATATG-1	A
CCTCCCTCAAGATGCG-1	A
CCTCCCTGTATTCTCT-1	G
CCTCCCTGTGAGTAAT-1	G
CCTCCCTTCCGTTAGA-1	G
CCTCCCTTCGATAGCT-1	A
CCTCCCTTCGATGAAA-1	A
CCTCCCTTCGCCCTTA-1	A
CCTCCCTTCTACTTTG-1	A
CCTCCCTTCTCTATCA-1	A
CCTGCTACAACCTCCT-1	A
CCTGCTACAGATTTGC-1	A
CCTGCTACAGTAAGCG-1	A
CCTGCTACATGGGTGA-1	G
CCTGCTAGTGCATCAT-1	G
CCTGCTAGTTGTATCG-1	G
CCTGCTAGTTTGGATC-1	G
CCTGCTATCGCATAAC-1	A
CCTGCTATCTGTTGCC-1	G
CCTGGGAAGTCGAAAT-1	A
CCTGGGAGTCATCAAC-1	G
CCTGGGAGTCATTGGT-1	A
CCTGGGAGTCCTCAGG-1	A
CCTGGGAGTGACCAGA-1	G
CCTGGGATCCAAGTCA-1	G
CCTGGGATCCAGGTCG-1	A
CCTGGGATCCATCTAT-1	A
CCTGGGATCCCACTAC-1	A
CCTGGGATCCTCAAGA-1	A
CCTTAATAGAGAATTC-1	A
CCTTAATCATTGTGAC-1	A
CCTTAATGTCCCGAGT-1	G
CCTTAATGTGCCAAGA-1	G
CCTTAATGTGTGTGCC-1	G
CCTTAATGTTCGGGAA-1	G
CCTTGCAAGACGTCAG-1	A
CCTTGCAAGCTAGTTC-1	A
CCTTGCAAGTGGACGT-1	G
CCTTGCACAAAGAGAG-1	A
CCTTGCACAGTGCGAA-1	G
CCTTGCACAGTTCGGC-1	G
CCTTGCACATGACTGT-1	A
CCTTGCAGTACCCATA-1	G
CCTTGCAGTAGGGTCA-1	G
CCTTGCAGTCTCTGCT-1	A
CCTTGCAGTCTGCACG-1	A
CCTTGCAGTTGGCTTA-1	A
CCTTGCATCTTGTCAT-1	G
CCTTGGTAGTAATCAG-1	A
CCTTGGTCAGGGCTTC-1	A
CCTTGGTCAGTTGCAT-1	A
CCTTGGTCATATAGAG-1	A
CCTTGGTGTACGCAAG-1	A
CCTTGGTGTATCACAC-1	A
CCTTGGTGTATTCACG-1	A
CCTTGGTGTCGTAATC-1	A
CCTTGGTTCGCTTCAC-1	A
CCTTGGTTCTATAGGC-1	G
CGAGTTAAGATGCGAC-1	G
CGAGTTAAGCGCCTAC-1	G
CGAGTTAAGGTACTCT-1	G
CGAGTTAAGGTCACTT-1	A
CGAGTTACAAAGGTCG-1	G
CGAGTTACACGCTGTG-1	G
CGAGTTACATCTGCAA-1	G
CGAGTTAGTAACGGTG-1	G
CGAGTTAGTGATAAGT-1	A
CGAGTTAGTTGGAGGT-1	A
CGAGTTATCCACTAGA-1	A
CGAGTTATCGTTCCGT-1	A
CGAGTTATCTCCACTG-1	A
CGATGATAGATGGCAC-1	A
CGATGATAGCATTGGG-1	A
CGATGATAGGAATGGA-1	A
CGATGATAGTGATATG-1	G
CGATGATAGTGTGTAA-1	A
CGATGATCAACGTAGG-1	G
CGATGATCACTGTAAC-1	A
CGATGATCATCTGCAA-1	A
CGATGATGTAGAAAGG-1	G
CGATGATGTGCATTGT-1	A
CGATGATGTGCCAAGA-1	A
CGATGATGTGCGTTTA-1	G
CGATGATGTTAACCAC-1	A
CGATGATGTTAGTAGA-1	A
CGATGATGTTCACGTA-1	A
CGATGATGTTCAGAAA-1	A
CGATGATGTTTGCCCT-1	A
CGATGATTCAACTTGG-1	G
CGATGATTCAAGGCCC-1	G
CGATGATTCATGTTCT-1	A
CGATGATTCGGTTAGT-1	G
CGATGATTCTCTATCA-1	A
CGCAATAAGAATATCG-1	G
CGCAATAAGAGCAGCT-1	A
CGCAATAAGAGGAACA-1	A
CGCAATACAAGCACTT-1	A
CGCAATACAATCAGGG-1	G
CGCAATACACAGTTCA-1	A
CGCAATACACCCTTTG-1	A
CGCAATACAGCAAACG-1	G
CGCAATACATCGACCG-1	G
CGCAATACATTAACGC-1	G
CGCAATAGTAAACCCT-1	A
CGCAATAGTCGTAGTT-1	G
CGCAATAGTTGCAGAG-1	A
CGCAATATCCCAATAG-1	A
CGCAATATCCCGTAGG-1	A
CGCAATATCGGAAAGC-1	A
CGCAATATCGGAGTTT-1	G
CGCAATATCTCTGCAC-1	A
CGCACAGAGATATGAC-1	A
CGCACAGAGCGTCTGC-1	A
CGCACAGAGGATTAAC-1	G
CGCACAGAGGGCGAAG-1	A
CGCACAGCAAGCACTT-1	A
CGCACAGCAATGTAAG-1	A
CGCACAGGTCAGCAAG-1	G
CGCACAGGTCTCTAAG-1	G
CGCACAGGTGATCAGG-1	G
CGCACAGTCACAAGCT-1	A
CGCACAGTCAGGAAGC-1	G
CGCACAGTCATCATGG-1	G
CGCACAGTCATTCATC-1	G
CGCACAGTCCCAGCAG-1	A
CGCACAGTCGGGTCCA-1	G
CGCAGGTAGCGAATAT-1	G
CGCAGGTAGGAATGGA-1	G
CGCAGGTAGGCTTAAA-1	A
CGCAGGTAGTATACGA-1	G
CGCAGGTCAAGGCGTA-1	A
CGCAGGTCAAGTGGCA-1	A
CGCAGGTCATGGCCGT-1	A
CGCAGGTGTATCCTTT-1	A
CGCAGGTGTCACAGTT-1	G
CGCAGGTGTGTCGTGC-1	G
CGCAGGTGTTCAGTAC-1	G
CGCAGGTTCGCTTGAA-1	G
CGCAGGTTCTAGTCGA-1	G
CGCGCAAAGAGCACTG-1	G
CGCGCAACAAACGACG-1	G
CGCGCAACACTCAAGT-1	G
CGCGCAACACTCCCAT-1	G
CGCGCAACATCCGTAA-1	G
CGCGCAACATGTATCG-1	A
CGCGCAAGTACTTCAG-1	A
CGCGCAAGTGCCGGTT-1	G
CGCGCAAGTTGCAGCC-1	G
CGCGCAATCCCAGCGA-1	G
CGCTAGGAGATATGAC-1	A
CGCTAGGAGGGTCTGA-1	A
CGCTAGGCAGGAGCAT-1	G
CGCTAGGCAGGTGGTA-1	G
CGCTAGGCATCGTACA-1	A
CGCTAGGCATGGTTTG-1	G
CGCTAGGCATTACCTT-1	G
CGCTAGGGTCCTCAGG-1	A
CGCTAGGGTGGTTCTA-1	A
CGCTAGGGTGTCCCAG-1	A
CGCTAGGTCAGTCACA-1	A
CGCTAGGTCCGAATTG-1	A
CGCTATCAGTGTCGGA-1	G
CGCTATCCAACCTCTC-1	A
CGCTATCCAAGAGATT-1	A
CGCTATCCAAGCAACG-1	G
CGCTATCCACGCTCAG-1	G
CGCTATCCAGAGTCGA-1	G
CGCTATCCAGATGGCA-1	G
CGCTATCGTGAATACA-1	G
CGCTATCGTTCCCGGA-1	A
CGCTATCGTTCTTTCA-1	A
CGCTATCTCAACTTGG-1	G
CGCTATCTCACAACAC-1	A
CGCTATCTCCTTTGCG-1	G
CGCTATCTCGCGATGC-1	A
CGCTATCTCTATTTCG-1	G
CGCTATCTCTCGACAA-1	A
CGCTATCTCTGGCTAA-1	G
CGCTATCTCTTCAGAG-1	G
CGCTGGAAGCGCCTAC-1	G
CGCTGGAAGCTTCAAC-1	G
CGCTGGAAGGTCTTTG-1	G
CGCTGGAAGTAATGTG-1	G
CGCTGGACAAGTCTCA-1	G
CGCTGGACAATTGTGC-1	A
CGCTGGACAGATGGCA-1	A
CGCTGGACATCACAGT-1	G
CGCTGGAGTATATGGA-1	A
CGCTGGAGTTATCGAC-1	G
CGCTGGAGTTGAATAG-1	A
CGCTGGATCAATTCCT-1	G
CGCTGGATCCACACCT-1	A
CGCTGGATCGACGGAA-1	G
CGGACCAAGAATCAAC-1	A
CGGACCAAGGCGCTTC-1	G
CGGACCACAACTGCGC-1	A
CGGACCACAAGTCCTA-1	A
CGGACCACACAGTAGG-1	A
CGGACCACAGATTAAG-1	G
CGGACCACATTAACGC-1	A
CGGACCAGTAGGTAAT-1	A
CGGACCAGTATGCTAC-1	G
CGGACCAGTTGCCTGG-1	G
CGGACCAGTTTCGATG-1	A
CGGACCATCACTGGTA-1	A
CGGACCATCCGAGAGA-1	A
CGGACCATCGAGGTAG-1	G
CGGACCATCTGGAAGG-1	A
CGGACTGAGACGAAAG-1	A
CGGACTGAGCAGGAGG-1	A
CGGACTGAGGAATGGA-1	G
CGGACTGCAACGCACC-1	G
CGGACTGCAACTCCCT-1	A
CGGACTGCAAGGAACC-1	G
CGGACTGCACGTTAGT-1	A
CGGACTGCAGGTAACG-1	A
CGGACTGGTCATGAGG-1	A
CGGACTGGTCTGAGCC-1	A
CGGACTGGTGATAACA-1	A
CGGACTGGTGGCATAG-1	A
CGGACTGGTGTAGGAC-1	A
CGGACTGTCACGTGTA-1	G
CGGTGCAAGAGGAATG-1	A
CGGTGCAAGGTCTTTG-1	G
CGGTGCACAATTCTCT-1	G
CGGTGCACACAGATGG-1	G
CGGTGCACACGATATC-1	A
CGGTGCACAGGTGTGA-1	A
CGGTGCACATGCGTTA-1	A
CGGTGCAGTCAAACAA-1	G
CGGTGCAGTCAAATCC-1	G
CGGTGCAGTGGTAAGC-1	A
CGGTGCAGTTCAGAAA-1	G
CGGTGCAGTTGGTAAA-1	A
CGGTGCAGTTTAGAAG-1	A
CGGTGCATCCAGGGAA-1	G
CGTAAACAGAACGACC-1	A
CGTAAACAGAGCCACA-1	A
CGTAAACAGATATGAC-1	A
CGTAAACAGGTTAACA-1	A
CGTAAACAGTAGGTCG-1	A
CGTAAACAGTCTCTAG-1	A
CGTAAACCAAGAAACT-1	G
CGTAAACCAGCAAACG-1	A
CGTAAACCATAGATAG-1	G
CGTAAACCATAGGCGA-1	A
CGTAAACCATTTGGCA-1	A
CGTAAACGTACCCATA-1	A
CGTAAACGTAGGTAAT-1	G
CGTAAACGTAGTTTGC-1	A
CGTAAACTCGGTCTAA-1	G
CGTACAAAGCTGCCAC-1	A
CGTACAAAGTACAACA-1	A
CGTACAACAAAGCATA-1	A
CGTACAACAAGCCAGA-1	G
CGTACAACACCGAAAG-1	G
CGTACAACAGTAGGCA-1	A
CGTACAACATGATTGC-1	A
CGTACAAGTACGACCC-1	A
CGTACAAGTACGGATG-1	A
CGTACAAGTACGTAGG-1	A
CGTACAAGTCTGGTTA-1	G
CGTACAAGTGCAACAG-1	A
CGTACAAGTTCAGAAA-1	G
CGTACAATCGCTCTAC-1	A
CGTACAATCGCTTCAC-1	G
CGTACAATCGTTGTAG-1	A
CGTACAATCTTGTCGC-1	G
CGTGGCAAGGCTCCTG-1	G
CGTGGCACAAGACTAA-1	A
CGTGGCACAGTAGTCT-1	G
CGTGGCACATCGTACA-1	A
CGTGGCACATTCTCGC-1	G
CGTGGCAGTACGGTTT-1	A
CGTGGCAGTCTTAGCA-1	A
CGTGGCAGTGATAGAT-1	G
CGTGGCAGTTCCTATT-1	G
CGTGGCATCCTCTCTT-1	A
CGTTCCAAGAAAGCAG-1	A
CGTTCCAAGGATTGCG-1	A
CGTTCCAAGGTCTTTG-1	G
CGTTCCACAAGCAGGT-1	A
CGTTCCACACTGTCGG-1	A
CGTTCCACAGGCAGAT-1	A
CGTTCCACATACCCGG-1	A
CGTTCCACATCAGAAA-1	G
CGTTCCACATCGGCTG-1	G
CGTTCCAGTGCATTGT-1	G
CGTTCCAGTTGGTAAA-1	A
CGTTCCATCACCCGGA-1	A
CGTTCCATCTCCTTAA-1	A
CTAACTTAGCCATTCA-1	G
CTAACTTAGGTAGGCT-1	A
CTAACTTAGTTGTCCA-1	A
CTAACTTCAAAGGCCA-1	A
CTAACTTCAAGGGAGG-1	A
CTAACTTCACATCATG-1	G
CTAACTTCAGAAGTGC-1	A
CTAACTTCATCGGCTG-1	A
CTAACTTCATTACTTC-1	G
CTAACTTGTATGGGTG-1	A
CTAACTTGTTCCAGTA-1	A
CTAACTTGTTCTGATG-1	G
CTAACTTTCCAAGTCA-1	G
CTAACTTTCCACCTAC-1	A
CTAACTTTCCGTGCGA-1	A
CTAACTTTCTGGCGCA-1	A
CTACAGAAGACGTCAG-1	G
CTACAGAAGAGCACTG-1	A
CTACAGAAGATGTTGA-1	A
CTACAGAAGGATGTAT-1	G
CTACAGAAGTCGTGAG-1	A
CTACAGACACAAACGG-1	G
CTACAGACACCTACCT-1	A
CTACAGAGTCAGCTTA-1	G
CTACAGATCCTCCTGA-1	A
CTACAGATCGGGAATG-1	A
CTACAGATCGGTCAGC-1	G
CTACTTAAGACCAATA-1	G
CTACTTAAGTATGGGC-1	A
CTACTTAAGTCATCTG-1	G
CTACTTAAGTTCGCGC-1	A
CTACTTACAAACTACC-1	G
CTACTTACAAAGCATA-1	A
CTACTTACAACGACAG-1	A
CTACTTACAAGGCGTA-1	A
CTACTTACAATGCCAT-1	A
CTACTTACAGTAAGCG-1	A
CTACTTACATTAGCAC-1	G
CTACTTAGTACCAAGG-1	A
CTACTTAGTCAGTGTT-1	A
CTACTTATCAGGTTTG-1	A
CTACTTATCCGTTAGA-1	A
CTACTTATCGCGCTGA-1	A
CTAGCGGAGCGTCAAG-1	G
CTAGCGGAGCTAGTTC-1	A
CTAGCGGAGCTGGAGT-1	A
CTAGCGGAGGGACGTT-1	A
CTAGCGGAGGGTCTGA-1	G
CTAGCGGAGTACCCAT-1	G
CTAGCGGAGTGATTAG-1	G
CTAGCGGAGTGTAATG-1	A
CTAGCGGCACATCATG-1	A
CTAGCGGCATCATGTG-1	A
CTAGCGGGTCTCGGGT-1	A
CTAGCGGGTTTCGTTT-1	A
CTAGCGGTCCATGACA-1	G
CTAGCGGTCCGATGCG-1	A
CTAGCGGTCGGATGTT-1	A
CTAGCGGTCGGCATAT-1	A
CTAGGATAGAAATACC-1	A
CTAGGATAGGCAGTAC-1	G
CTAGGATAGTGTTCCA-1	A
CTAGGATCAAGATTAG-1	A
CTAGGATCAGCGTAGA-1	A
CTAGGATCATCGAGTT-1	G
CTAGGATCATTTCACT-1	A
CTAGGATGTAGGGTCA-1	A
CTAGGATGTATGAAGT-1	A
CTAGGATGTCACATTG-1	A
CTAGGATGTCCAACCG-1	A
CTAGGATGTGCCCAGT-1	G
CTAGGATGTTTGTGAC-1	G
CTAGGATTCTGCTACC-1	G
CTAGGATTCTTCGTTA-1	G
CTAGGGCAGAACAGGA-1	A
CTAGGGCAGGTAGGCT-1	A
CTAGGGCCACATTCTT-1	A
CTAGGGCCACCTGGTG-1	A
CTAGGGCGTACAACGG-1	A
CTAGGGCGTAGTAACA-1	A
CTAGGGCGTATACGCT-1	A
CTAGGGCGTTGTCGGC-1	A
CTAGGGCTCCACACCT-1	G
CTAGGGCTCCTCAAGA-1	G
CTCAACCAGGTTGACG-1	A
CTCAACCCAACACGGA-1	G
CTCAACCCACCCTTTG-1	A
CTCAACCCACCTGAAT-1	G
CTCAACCCAGACCTGC-1	A
CTCAACCGTACCCATA-1	A
CTCAACCGTAGTCCAT-1	A
CTCAACCGTCATAGAA-1	A
CTCAACCGTTTCTTAC-1	A
CTCAACCTCCCAGCAG-1	A
CTCAACCTCGTCCCAT-1	A
CTCAACCTCTTCAGAG-1	A
CTCACCAAGAATCAAC-1	G
CTCACCAAGTAACATG-1	A
CTCACCAAGTCTGCTA-1	A
CTCACCAAGTTCCAGT-1	A
CTCACCACAACGTCCG-1	G
CTCACCACAAGCCTTA-1	G
CTCACCACACGCCGAT-1	A
CTCACCACATGCCCTT-1	A
CTCACCAGTAAACGTA-1	G
CTCACCAGTAACATAG-1	A
CTCACCAGTGCATCAT-1	G
CTCACCAGTTAACCGT-1	A
CTCACCATCCGATTGA-1	A
CTCACCATCCGTTTCG-1	A
CTCACCATCCTTACGC-1	G
CTCACCATCGCCGAAC-1	G
CTCACCATCGCGCCAA-1	A
CTCACCATCGCTTACC-1	G
CTCACCATCTAGCTGA-1	G
CTCACCATCTCCTTAA-1	A
CTCAGAAAGAGGAATG-1	A
CTCAGAAAGGATTAAC-1	G
CTCAGAAAGTAGCAAT-1	A
CTCAGAAAGTTCGACT-1	G
CTCAGAACAAGCCTTA-1	G
CTCAGAACACAGCTTA-1	A
CTCAGAACACATCATG-1	A
CTCAGAACATTAACGC-1	A
CTCAGAAGTAGGGTCA-1	G
CTCAGAAGTATGTCCA-1	A
CTCAGAAGTCGATTAC-1	A
CTCAGAAGTTCCGCGA-1	G
CTCAGAAGTTGCCTGG-1	G
CTCAGAATCAGGGTTT-1	A
CTCAGAATCAGGTTTG-1	G
CTCAGAATCCAACGCG-1	G
CTCAGAATCGCACCGA-1	A
CTCAGAATCGGATAGG-1	G
CTCAGCTAGAGCTCCC-1	A
CTCAGCTAGTAGACCG-1	G
CTCAGCTCACTTATGG-1	A
CTCAGCTGTACAAATG-1	A
CTCAGCTGTGAGTTGG-1	G
CTCAGCTGTTGGCTTA-1	A
CTCAGCTTCTTACGGA-1	G
CTCATGCAGCAGAAAG-1	A
CTCATGCAGTAACACA-1	G
CTCATGCAGTGAGTTA-1	G
CTCATGCCACTGAAGG-1	A
CTCATGCCACTGTCAA-1	A
CTCATGCCAGAAGTGC-1	A
CTCATGCCAGTTGGAG-1	G
CTCATGCGTGAATGGC-1	A
CTCATGCTCAGTGTGT-1	G
CTCATGCTCTCGGCGA-1	G
CTCCCAAAGGGTTCTT-1	G
CTCCCAACACCATTCC-1	G
CTCCCAACATCTCACC-1	A
CTCCCAAGTAAACGGC-1	A
CTCCCAAGTACTTCAG-1	A
CTCCCAAGTGTGACCC-1	A
CTCCCAAGTGTTGTTG-1	G
CTCCCAATCAGGTTTG-1	A
CTCCCAATCGACTCGG-1	A
CTCCCAATCGAGTGTT-1	A
CTCCCAATCTGTTTAC-1	A
CTCGCTAAGAAGAGTG-1	G
CTCGCTAAGAGCAGCT-1	G
CTCGCTAAGCCTTTGA-1	A
CTCGCTAAGGCGACTA-1	G
CTCGCTAAGTGCTAGG-1	A
CTCGCTACAAATGTCC-1	G
CTCGCTACAACTCCCT-1	G
CTCGCTACACCGAATT-1	A
CTCGCTACACTCGCAG-1	G
CTCGCTACAGGAGCAT-1	G
CTCGCTACAGTAACTC-1	G
CTCGCTACATTGATGC-1	A
CTCGCTAGTATGGTTC-1	G
CTCGCTAGTCTGGTTA-1	A
CTCGCTATCCTAAGTG-1	A
CTCGCTATCTCGACCT-1	G
CTCGCTATCTGGACAT-1	G
CTCTACGAGAAGACTT-1	A
CTCTACGAGACCTATC-1	G
CTCTACGAGAGCTCCC-1	A
CTCTACGAGGTTTCTG-1	G
CTCTACGAGTATAGTG-1	A
CTCTACGCAACGGACA-1	G
CTCTACGCAAGTCCTA-1	A
CTCTACGCACGATATC-1	A
CTCTACGCAGAGATGC-1	G
CTCTACGGTGGATTCT-1	A
CTCTACGTCCTGGAAT-1	A
CTCTACGTCGGATCGC-1	A
CTCTAGCAGGCGTAGT-1	G
CTCTAGCAGGTGTCGA-1	G
CTCTAGCCAACTCCCT-1	G
CTCTAGCGTGAATACA-1	A
CTCTAGCGTTATGCAC-1	G
CTCTCAGAGACCTATC-1	A
CTCTCAGAGATTCCGT-1	A
CTCTCAGAGTCAGGAC-1	G
CTCTCAGAGTGAGTGC-1	G
CTCTCAGAGTGATTAG-1	G
CTCTCAGCATGACTGT-1	A
CTCTCAGGTCTAACCA-1	G
CTCTCAGGTCTTAGCA-1	G
CTCTCAGGTGTCCTTC-1	A
CTCTCAGTCATGAACC-1	G
CTCTCAGTCCACCTAC-1	G
CTCTCAGTCGTGATAC-1	A
CTCTCAGTCTGCGTCT-1	G
CTCTCGAAGGTAAGCC-1	A
CTCTCGAAGGTTCGAG-1	A
CTCTCGAAGTCAGCCC-1	G
CTCTCGACAACGTAGG-1	A
CTCTCGACACGCTAAT-1	A
CTCTCGACAGGCACAA-1	A
CTCTCGAGTGCACATT-1	G
CTCTCGAGTGCATCAT-1	G
CTCTCGAGTTAACTCG-1	A
CTCTCGATCGGATCGC-1	A
CTCTCGATCTCGCGTT-1	A
CTCTCGATCTGAAAGA-1	A
CTCTCGATCTGTTGCC-1	G
CTGAATGAGAGCTCCC-1	A
CTGAATGAGCCCATTA-1	G
CTGAATGCAACATAAG-1	G
CTGAATGCAAGTAACA-1	A
CTGAATGCACGTTACA-1	A
CTGAATGCACTCCACT-1	G
CTGAATGGTAGAGAGA-1	A
CTGAATGGTGGCGCTT-1	A
CTGAATGGTTCTGAGT-1	G
CTGAATGTCCAGGGAA-1	A
CTGAATGTCCATTGTT-1	A
CTGAATGTCCTAAAGC-1	A
CTGAATGTCCTCCCAA-1	A
CTGAATGTCCTCTCTT-1	G
CTGAATGTCGCACAAT-1	G
CTGCGTTAGCAGAATT-1	A
CTGCGTTAGCAGTAGC-1	A
CTGCGTTAGGCAATTA-1	G
CTGCGTTAGTCTCCAA-1	G
CTGCGTTCAACAAACA-1	G
CTGCGTTCACGCTCAG-1	A
CTGCGTTCAGAATGCG-1	A
CTGCGTTCAGGTGTGA-1	A
CTGCGTTCATCCCGGA-1	G
CTGCGTTCATTGAACC-1	A
CTGCGTTGTAGTAACA-1	A
CTGCGTTGTGTACGCC-1	G
CTGCGTTGTTGGAGGT-1	A
CTGCGTTGTTGGCGAA-1	A
CTGCGTTTCCTGAAAC-1	A
CTGCGTTTCGACTATG-1	G
CTGCGTTTCTCCCTTT-1	A
CTGCTCAAGAAACGCC-1	G
CTGCTCAAGCCATGGA-1	G
CTGCTCAAGCTATCCA-1	A
CTGCTCAAGGATGCCA-1	A
CTGCTCAAGGTTCTCA-1	G
CTGCTCAAGTGGGACT-1	A
CTGCTCACAATGCACT-1	A
CTGCTCAGTAGTCCAT-1	A
CTGCTCAGTCCAAGTT-1	G
CTGCTCAGTCCCTTTG-1	A
CTGCTCAGTGCAAGCA-1	G
CTGCTCAGTGGAGTGT-1	G
CTGCTCAGTTGTGAGG-1	A
CTGCTCATCGGGATCC-1	G
CTGGCAGAGACAACGC-1	A
CTGGCAGAGAGGAATG-1	G
CTGGCAGAGCAGGACT-1	A
CTGGCAGAGTAACTCC-1	G
CTGGCAGCAATGTGCT-1	A
CTGGCAGCACCTCGTT-1	A
CTGGCAGCAGAAGTGC-1	A
CTGGCAGCATTTGGTG-1	A
CTGGCAGGTCAAATCC-1	A
CTGGCAGGTCAGAGTG-1	A
CTGGCAGGTCGAGGAT-1	G
CTGGCAGGTGCTGGCT-1	G
CTGGCAGGTTGGCTAT-1	A
CTGGGACAGCGTTAGG-1	G
CTGGGACAGTTACCAC-1	A
CTGGGACCAACGCAAG-1	G
CTGGGACCAGGCATCC-1	G
CTGGGACCATTAGCAC-1	G
CTGGGACTCCTGTAGA-1	A
CTGGGACTCGCCGAAC-1	A
CTGTATTAGAGCTACG-1	A
CTGTATTAGATAGGTT-1	G
CTGTATTAGATCCGAG-1	A
CTGTATTCACTCGCAG-1	A
CTGTATTCAGAAAGAG-1	A
CTGTATTCAGGGCTTC-1	A
CTGTATTCAGTAACCT-1	G
CTGTATTGTCAAGACG-1	G
CTGTATTGTCAGCAAG-1	A
CTGTATTGTCCTATTT-1	G
CTGTATTGTCTCTGCT-1	A
CTGTATTTCGCACAAT-1	G
CTGTATTTCGTTGTAG-1	A
CTGTATTTCTCCTTGG-1	G
CTGTATTTCTGATCTT-1	A
CTGTTCGAGAATCAAC-1	A
CTGTTCGAGCTACGCC-1	A
CTGTTCGAGGCAGTGT-1	A
CTGTTCGCACACATGT-1	G
CTGTTCGCAGTAACTC-1	A
CTGTTCGCATTCCCGT-1	G
CTGTTCGGTATATGGA-1	G
CTGTTCGGTATCTAGC-1	A
CTGTTCGGTGCCCAGT-1	A
CTGTTCGGTGGAAAGA-1	A
CTGTTCGTCACTCCCA-1	A
CTGTTCGTCAGTCTTT-1	A
CTGTTCGTCCATATCT-1	G
CTGTTCGTCGCTTACC-1	A
CTGTTCGTCGTTACAG-1	G
CTTAATCAGAGCAGCT-1	A
CTTAATCAGAGTTCGG-1	A
CTTAATCAGCAGTAGC-1	A
CTTAATCCAACTACTG-1	A
CTTAATCCAACTGCGC-1	A
CTTAATCCAAGCTTTG-1	A
CTTAATCCAGTGCTCG-1	A
CTTAATCGTAACGTAA-1	G
CTTAATCGTCGAGAAC-1	G
CTTCCAGAGAACCATA-1	A
CTTCCAGAGACCAATA-1	A
CTTCCAGAGAGGCAGG-1	G
CTTCCAGAGCCATGGA-1	G
CTTCCAGAGCCCATTA-1	G
CTTCCAGAGGCGTCCT-1	A
CTTCCAGAGTGGGACT-1	A
CTTCCAGCAATGCATC-1	A
CTTCCAGCAGCGTGAA-1	G
CTTCCAGCATTCACCC-1	G
CTTCCAGGTAACCCAT-1	A
CTTCCAGGTGAATGGC-1	G
CTTCCAGGTGATGTGG-1	A
CTTCCAGGTGCGCATC-1	A
CTTCCAGGTGGAAGCT-1	G
CTTCCAGGTTAGGAAT-1	A
CTTCCAGTCGCCCTTA-1	A
CTTCTAAGTCAGAAAT-1	G
CTTCTAAGTGTCCTTC-1	A
CTTCTAATCCAGTACA-1	A
CTTCTAATCCTGTGGG-1	A
CTTCTAATCTATTTCG-1	G
CTTGAAGAGATACCAA-1	G
CTTGAAGAGCAATAAC-1	G
CTTGAAGAGCGTGTTT-1	A
CTTGAAGAGGCACCTC-1	A
CTTGAAGAGTAGTGTA-1	G
CTTGAAGAGTCCAGAG-1	A
CTTGAAGAGTGCCCTG-1	A
CTTGAAGAGTGTGTAA-1	G
CTTGAAGAGTTCGACT-1	G
CTTGAAGGTAGCTGTT-1	G
CTTGAAGGTGATTCCA-1	A
CTTGAAGTCAACTTGG-1	A
CTTGAAGTCGCATACA-1	G
CTTGAAGTCGTTCCGT-1	G
CTTGAAGTCTGACTTT-1	A
CTTGCCAAGAGCAGCT-1	G
CTTGCCAAGGTTCGAG-1	A
CTTGCCACAAACCCTA-1	A
CTTGCCACAATTCGTG-1	A
CTTGCCACACGCCGAT-1	A
CTTGCCACATAGAATG-1	A
CTTGCCACATGCTATG-1	G
CTTGCCAGTAGTCCAT-1	A
CTTGCCAGTTACCCAA-1	G
CTTGCCAGTTTCTCTA-1	A
CTTGCCATCAGAACGG-1	A
CTTGCCATCCATCGAA-1	G
CTTGCCATCTTCTCTC-1	G
CTTGCCATCTTTATCG-1	A
CTTGCTGAGCGCACAA-1	G
CTTGCTGAGCTTCAAC-1	A
CTTGCTGCAAGACTTC-1	A
CTTGCTGCACATAAAG-1	A
CTTGCTGCACTCCCAT-1	G
CTTGCTGGTGCCAAGA-1	A
CTTGCTGGTTCTTATC-1	G
CTTGCTGGTTGCTTGA-1	G
CTTGCTGGTTGGCGAA-1	A
CTTGCTGGTTGTCGGC-1	A
CTTGCTGTCAGAACGG-1	A
CTTGCTGTCAGTCTTT-1	G
CTTGCTGTCATCGCAA-1	G
CTTGCTGTCCATTGTT-1	A
CTTGTCGAGAAACGCC-1	G
CTTGTCGAGGTTGTGG-1	A
CTTGTCGCATCGGCTG-1	G
CTTGTCGGTAACATAG-1	A
CTTGTCGGTACTTGAC-1	A
CTTGTCGGTTAAGGGC-1	G
CTTGTCGTCAGAGTGG-1	G
CTTGTCGTCCATCATT-1	A
CTTGTCGTCCTCATTA-1	A
CTTTGCGAGCATGATA-1	G
CTTTGCGAGGATTGCG-1	A
CTTTGCGAGGGAGATA-1	G
CTTTGCGAGGTCGTTT-1	G
CTTTGCGCAAGACACG-1	A
CTTTGCGCAGGCAGAT-1	A
CTTTGCGCATGTAGAA-1	G
CTTTGCGTCAGATACC-1	A
CTTTGCGTCATACTTC-1	G
CTTTGCGTCATTCTCA-1	A
CTTTGCGTCCTCCCAA-1	A
CTTTGCGTCGATGCAT-1	G
CTTTGCGTCGCATAAC-1	G
CTTTGCGTCGCTAGTA-1	A
CTTTGCGTCGCTATTT-1	A
CTTTGCGTCTCTCAAT-1	A
CTTTGCGTCTGAGTAC-1	G
GAAACAAAGAAGAGTG-1	G
GAAACAAAGAGCGAAA-1	A
GAAACAAAGAGGAAGT-1	G
GAAACAAAGCTGAGGT-1	A
GAAACAAAGGGAAATG-1	G
GAAACAAAGTGAGTTA-1	A
GAAACAACACATCATG-1	A
GAAACAACATCTGCAA-1	G
GAAACAAGTCCGCTTT-1	G
GAAACAAGTCGACTGC-1	A
GAAACAAGTTACCACA-1	A
GAAACAAGTTGGACGA-1	A
GAAACAATCCCGATTC-1	A
GAAACAATCCGCGATG-1	A
GAAACAATCCTTCGAC-1	A
GAAACAATCGAGCGCT-1	A
GAAACAATCTGACATG-1	G
GAAAGTAAGAATGCTA-1	A
GAAAGTAAGAGCTACG-1	G
GAAAGTAAGCGTGTTT-1	A
GAAAGTAAGGATTTGA-1	A
GAAAGTAAGGCATGCA-1	G
GAAAGTACAAGCGAAC-1	A
GAAAGTACACTGCTTC-1	G
GAAAGTACAGGCATCC-1	A
GAAAGTAGTACCCATA-1	A
GAAAGTAGTACTTCAG-1	A
GAAAGTAGTATCCCTC-1	G
GAAAGTAGTCGGCTGT-1	G
GAAAGTAGTGCAGACA-1	A
GAAAGTATCACTCCCA-1	G
GAAAGTATCAGGATCT-1	A
GAAAGTATCCATGACA-1	G
GAAAGTATCCTGTGGG-1	A
GAAAGTATCTGTGTCC-1	A
GAAATGAAGCGTATCT-1	G
GAAATGAAGGAAGAAC-1	G
GAAATGAAGGGACGTT-1	G
GAAATGAAGTTTACGC-1	G
GAAATGACAACGTCCG-1	A
GAAATGACAAGAGATT-1	A
GAAATGACACCGTTGG-1	A
GAAATGACACTTGCGG-1	G
GAAATGACATTACCTT-1	G
GAAATGAGTACGCAAG-1	A
GAAATGAGTAGGTCTT-1	A
GAAATGAGTCTTAGCA-1	G
GAAATGAGTGTCCTTC-1	A
GAAATGATCCCAATAG-1	A
GAAATGATCCGATGCG-1	G
GAAATGATCTCTTCTC-1	G
GAACCGCAGGCCTCGT-1	A
GAACCGCAGTAACTCC-1	G
GAACCGCAGTAATCAG-1	A
GAACCGCAGTGGTGTG-1	A
GAACCGCAGTTCAGGG-1	A
GAACCGCCAAACCTAC-1	A
GAACCGCCATCTGCAA-1	A
GAACCGCGTAGAAAGG-1	G
GAACCGCGTAGATGAT-1	A
GAACCGCGTTGAATAG-1	G
GAACCGCGTTTGCCAA-1	A
GAACCGCTCACTGATG-1	G
GAACCGCTCGCCCTTA-1	G
GAACCGCTCGGGCTCA-1	G
GAACCGCTCTGAGTCA-1	G
GAACCTAAGAATCAAC-1	A
GAACCTAAGATCTCAC-1	G
GAACCTACAACGTCGC-1	G
GAACCTACAACTAGAA-1	G
GAACCTACAAGAGATT-1	A
GAACCTACAAGGACCA-1	G
GAACCTACAATGGTCT-1	A
GAACCTACACATTCTT-1	A
GAACCTACAGCGCGTT-1	A
GAACCTAGTATTCGCA-1	G
GAACCTAGTGTTAGAA-1	A
GAACCTATCAAACCAC-1	A
GAACCTATCAATTCCT-1	A
GAACGTTAGTACAACA-1	A
GAACGTTAGTTGCCGC-1	G
GAACGTTCAACAAACA-1	A
GAACGTTCAGGTAGCA-1	G
GAACGTTCAGTGGTCC-1	G
GAACGTTCATTAACGC-1	G
GAACGTTCATTCCCGT-1	G
GAACGTTCATTTCTTG-1	G
GAACGTTGTACTTCAG-1	A
GAACGTTGTCTGGTCG-1	A
GAACGTTGTGTCCCAG-1	G
GAACGTTTCTGTCGGG-1	G
GAACGTTTCTTGTCAT-1	A
GAACTTGAGCCGCAAA-1	A
GAACTTGAGGCCTCGT-1	G
GAACTTGCACGTGAAG-1	G
GAACTTGCACTCGCAG-1	A
GAACTTGCATTCACGA-1	A
GAACTTGGTAACATAG-1	A
GAACTTGGTCAACTGT-1	G
GAACTTGGTCAGACGA-1	A
GAACTTGGTGCAAGCA-1	A
GAACTTGGTTCTTATC-1	A
GAACTTGTCCTGTAGA-1	A
GAACTTGTCGACTCGG-1	G
GAACTTGTCGATTACG-1	A
GAACTTGTCTTACGGA-1	G
GAAGAGCAGCTCCATA-1	A
GAAGAGCAGGCGTCCT-1	A
GAAGAGCAGTGATATG-1	G
GAAGAGCCAACTCAAC-1	A
GAAGAGCCAATGATGA-1	G
GAAGAGCCATAGGCGA-1	A
GAAGAGCGTGGTTCTA-1	A
GAAGAGCTCCTTACGC-1	A
GAAGAGCTCCTTTGCG-1	A
GAAGAGCTCTGTAGAC-1	G
GAAGAGCTCTTGTCAT-1	A
GAAGTCTAGAAGACTT-1	G
GAAGTCTAGAGCAGCT-1	A
GAAGTCTAGGCTGGAT-1	G
GAAGTCTCAAACAGTA-1	A
GAAGTCTCAGACCTGC-1	G
GAAGTCTGTCCGCTTT-1	A
GAAGTCTGTCCGGTAC-1	G
GAAGTCTGTCTAAAGA-1	A
GAAGTCTGTGCAAGAC-1	A
GAAGTCTGTTTCTCTA-1	G
GAAGTCTTCCCAGTAA-1	A
GAAGTCTTCCCTATTA-1	A
GAAGTCTTCGGTCAGC-1	A
GAAGTGGAGACTTGAA-1	A
GAAGTGGAGCCATGGA-1	G
GAAGTGGAGGGCGAAG-1	A
GAAGTGGCAAGGCTTT-1	G
GAAGTGGCATCGCCTT-1	G
GAAGTGGGTACTAGAA-1	G
GAAGTGGGTCATGAGG-1	G
GAAGTGGGTTCTGATG-1	A
GAAGTGGGTTGGCTTA-1	A
GAAGTGGTCCGGCTGA-1	G
GAAGTGGTCCGTCAAA-1	A
GAAGTGGTCTAGCAGT-1	G
GAAGTGGTCTCGCGGA-1	G
GAAGTGGTCTGAACGT-1	A
GAATCTGAGACACAAT-1	A
GAATCTGAGGAGACTC-1	A
GAATCTGAGGGAGTTC-1	A
GAATCTGCAACGAGGT-1	G
GAATCTGCAAGGAGGG-1	A
GAATCTGCACATTCTT-1	A
GAATCTGCACTAGCCG-1	A
GAATCTGCATGGCCTG-1	G
GAATCTGGTAATGTGA-1	G
GAATCTGGTACGTAAA-1	G
GAATCTGGTCTCTGCT-1	G
GAATCTGGTGCTGAAG-1	G
GAATCTGGTTATCGAC-1	A
GAATCTGGTTTCCACC-1	A
GAATCTGTCCAAGTCA-1	G
GAATCTGTCGGGAAAC-1	G
GAATCTGTCGGGTCCA-1	A
GAATCTGTCTATGAGC-1	A
GACCAATAGTAACATG-1	A
GACCAATAGTCTCGAT-1	A
GACCAATCAAGCGAAC-1	A
GACCAATCAATGACTC-1	G
GACCAATCACCACGAC-1	G
GACCAATCACCTATTT-1	G
GACCAATCACGTTAGT-1	A
GACCAATCACTGAAGG-1	G
GACCAATCACTGTCAA-1	G
GACCAATCAGGAGCAT-1	A
GACCAATGTGCGACCT-1	G
GACCAATGTTTGATCG-1	A
GACCAATTCATTCGGA-1	G
GACCAATTCCTGTGGG-1	A
GACCAATTCTCTGTTA-1	A
GACCAATTCTGAGTAC-1	A
GACCCAGAGCTAGTTC-1	A
GACCCAGAGTCCCTCT-1	G
GACCCAGCAACGGGTA-1	A
GACCCAGCAAGTAACA-1	G
GACCCAGCAAGTTCGT-1	G
GACCCAGCACTGATTG-1	A
GACCCAGCAGTCCTGG-1	G
GACCCAGCATGACTGT-1	A
GACCCAGGTCAATCCA-1	A
GACCCAGGTCAGACGA-1	G
GACCCAGGTCATAAGA-1	G
GACCCAGGTTCTCGAA-1	G
GACCCAGTCAATGCAC-1	G
GACCCAGTCCTTACGC-1	A
GACCCAGTCGAGTTAC-1	A
GACCCAGTCGCAAACT-1	G
GACCCAGTCGCGATGC-1	A
GACCCAGTCTCAGATG-1	A
GACCGACAGTGAAGGA-1	G
GACCGACCAAGCCTTA-1	A
GACCGACCACCGAATT-1	G
GACCGACCACTCGCAG-1	G
GACCGACGTATTGTCG-1	A
GACCGACGTCTGTGTA-1	A
GACCGACGTGACAAGC-1	A
GACCGACGTTTGTGAC-1	A
GACCGACTCCGCGATG-1	A
GACCTTCAGCCCATGC-1	G
GACCTTCAGCGCACAA-1	G
GACCTTCAGGTAGGAA-1	G
GACCTTCAGGTTAACA-1	G
GACCTTCAGTAATGTG-1	G
GACCTTCCAACTACTG-1	A
GACCTTCCAAGGAAGA-1	A
GACCTTCCAATGCATC-1	A
GACCTTCCAGGTAACG-1	A
GACCTTCCATGTCCCT-1	A
GACCTTCGTCCAAGAG-1	G
GACCTTCGTCGCTACG-1	A
GACCTTCGTGTTAGAA-1	A
GACCTTCGTTAGAGAT-1	G
GACCTTCTCGCTAGTA-1	A
GACCTTCTCGCTTCAC-1	A
GACCTTCTCTGGCGCA-1	G
GACTAACAGCAATAAC-1	G
GACTAACAGTAACTCC-1	A
GACTAACCACCGAATT-1	A
GACTAACCACTGCTCT-1	A
GACTAACCACTGTCAA-1	G
GACTAACCATGCGCTG-1	G
GACTAACGTACGTAAA-1	A
GACTAACGTAGTTTGC-1	G
GACTAACGTCGCGCTA-1	A
GACTAACGTGCACCCA-1	A
GACTAACGTGCTGAAG-1	G
GACTAACGTTCTTATC-1	G
GACTAACTCCACGGCA-1	A
GACTAACTCCCTACCA-1	G
GACTAACTCGAAGCCC-1	A
GACTAACTCGTATAGC-1	G
GACTAACTCTGTTTAC-1	A
GACTAGTAGAGCTGTG-1	A
GACTAGTAGATAGGTT-1	A
GACTAGTAGCAATAAC-1	A
GACTAGTAGCACGTAG-1	A
GACTAGTAGCTACGCC-1	A
GACTAGTAGTACAGTA-1	A
GACTAGTCATGTAGAA-1	A
GACTAGTCATTCTCGC-1	G
GACTAGTCATTGTTCT-1	G
GACTAGTGTTGCAGCC-1	A
GACTAGTTCAATTGGC-1	G
GACTAGTTCAGTGTAC-1	G
GACTAGTTCCAAACCA-1	A
GACTAGTTCCAGCACG-1	G
GACTAGTTCTTGTACT-1	A
GAGAACGAGAGAAGCA-1	A
GAGAACGAGGTCGTTT-1	G
GAGAACGCACACACAT-1	A
GAGAACGCACAGAAGC-1	G
GAGAACGCACATGATC-1	G
GAGAACGCAGTAAGAT-1	A
GAGAACGCATACAACC-1	A
GAGAACGCATCAGAAA-1	G
GAGAACGCATTCACCC-1	G
GAGAACGGTCAGAAAT-1	A
GAGAACGGTGAATCGG-1	A
GAGAACGGTTCCTATT-1	A
GAGAACGTCACTGATG-1	A
GAGAACGTCCGCGATG-1	G
GAGAACGTCCTCCAGT-1	A
GAGAACGTCGAGGTAG-1	A
GAGACTTAGACAACGC-1	G
GAGACTTAGACACAAT-1	G
GAGACTTAGACCGCAA-1	G
GAGACTTAGCGTAGCA-1	G
GAGACTTCAAGCAATA-1	G
GAGACTTCACGCTGTG-1	G
GAGACTTGTGCGTTTA-1	A
GAGACTTGTTCTTTGT-1	G
GAGACTTTCAACTTGG-1	A
GAGACTTTCCTATCCG-1	G
GAGACTTTCGCAAGCC-1	A
GAGACTTTCGGTTCCT-1	G
GAGACTTTCGTTTGAG-1	A
GAGATTCAGACGTCAG-1	A
GAGATTCAGTACGCGA-1	A
GAGATTCAGTTCAAGA-1	G
GAGATTCCAGATACAA-1	A
GAGATTCCAGCAACCC-1	G
GAGATTCGTAGTGATA-1	A
GAGATTCGTATCCTTT-1	A
GAGATTCGTCTCAAAC-1	G
GAGATTCTCAAGGCAG-1	G
GAGATTCTCCGATGCG-1	G
GAGATTCTCGCTAGTA-1	A
GAGATTCTCTATATCC-1	G
GAGCATTAGGATTTGA-1	G
GAGCATTAGGTAAGCC-1	A
GAGCATTCAAGCGGTA-1	A
GAGCATTCACCTATTT-1	G
GAGCATTCAGGACCTC-1	G
GAGCATTCATTAGCAC-1	A
GAGCATTCATTCTTTG-1	A
GAGCATTGTAAAGCTA-1	G
GAGCATTGTCAGTGTT-1	A
GAGCATTGTGCAAAGC-1	G
GAGCATTGTTTCGACA-1	G
GAGCATTGTTTGCATG-1	A
GAGCATTTCCAGTTAG-1	G
GAGCATTTCCTATCAT-1	A
GAGCATTTCGCGTTCT-1	A
GAGCATTTCGGTCAGC-1	A
GAGCATTTCTTCCGTG-1	G
GAGCATTTCTTTCGAT-1	G
GAGCGCTAGAACGACC-1	G
GAGCGCTAGCTGAAAT-1	A
GAGCGCTAGGCCTAAG-1	A
GAGCGCTAGGGTTCCC-1	A
GAGCGCTCACCGTTGG-1	A
GAGCGCTCACGCCGAT-1	A
GAGCGCTCACTCCTCA-1	G
GAGCGCTCAGATAAGT-1	G
GAGCGCTCAGGCTACC-1	G
GAGCGCTCATCAGAAA-1	A
GAGCGCTGTAACGGCA-1	G
GAGCGCTGTAGTTTGC-1	G
GAGCGCTGTCCGCTTT-1	A
GAGCGCTGTTTCAGCA-1	A
GAGCGCTTCCACGCTT-1	G
GAGCGCTTCCCAGCAG-1	G
GAGCGCTTCCCTAAAG-1	A
GAGCGCTTCCTTTGCG-1	G
GAGCGCTTCTGTGTGA-1	G
GAGCGCTTCTTCATAC-1	A
GAGGATGAGAACGTCG-1	A
GAGGATGAGAGTTCGG-1	A
GAGGATGAGGATTAAC-1	A
GAGGATGAGTGCTCGC-1	A
GAGGATGCACCACAGC-1	A
GAGGATGGTGAATCAA-1	A
GAGGATGGTGCGTCCA-1	A
GAGGATGGTTAGGAAT-1	G
GAGGATGGTTAGGCTT-1	A
GAGGATGGTTCAGAAA-1	A
GAGGATGTCCATAACG-1	A
GAGGATGTCCATACGA-1	G
GAGGATGTCCGTACGG-1	A
GAGGATGTCGGCAATT-1	A
GAGGATGTCTGAACGT-1	A
GAGGATGTCTTAATCC-1	G
GAGGATGTCTTGGCCT-1	A
GAGGCTCAGAATGCTA-1	A
GAGGCTCAGTACGACG-1	G
GAGGCTCCACATAAAG-1	A
GAGGCTCGTGATAGAT-1	G
GAGGCTCGTGATCAGG-1	G
GAGGCTCGTTCTACGA-1	A
GAGGCTCGTTCTTAGG-1	A
GAGGCTCGTTTAGAAG-1	G
GAGGCTCGTTTGATCG-1	A
GAGGCTCTCATTCTCA-1	A
GAGGCTCTCCCAATGA-1	A
GAGGCTCTCGAACACT-1	A
GAGGCTCTCGCTCGGA-1	G
GAGGCTCTCGGCAATT-1	A
GAGGCTCTCGGTTCCT-1	A
GAGGCTCTCTGCTACC-1	G
GAGGTCCAGACGCCAA-1	G
GAGGTCCAGAGAGTAG-1	A
GAGGTCCAGATCGATA-1	A
GAGGTCCAGCGGACAT-1	A
GAGGTCCAGGTACATA-1	A
GAGGTCCCAAAGCTGG-1	G
GAGGTCCCAATAGCGG-1	G
GAGGTCCCAATGATGA-1	A
GAGGTCCCACAATAAG-1	A
GAGGTCCCACCAAGGA-1	G
GAGGTCCCAGTAAGAT-1	G
GAGGTCCCATCCCTCA-1	G
GAGGTCCCATGGTATC-1	G
GAGGTCCCATTGAACC-1	A
GAGGTCCCATTGATGC-1	A
GAGGTCCCATTTGTTC-1	G
GAGGTCCGTCGATAGG-1	A
GAGGTCCGTGCGCTCA-1	A
GAGGTCCGTGTGTGCC-1	G
GAGGTCCGTTGAAGCG-1	A
GAGGTCCTCCAAGAGG-1	G
GAGGTCCTCCCATAGA-1	A
GAGGTCCTCCTCTCTT-1	G
GAGGTCCTCGGTTCCT-1	G
GAGGTCCTCTGGAAGG-1	A
GAGTGAGAGAGCAGCT-1	G
GAGTGAGAGATGCGCA-1	G
GAGTGAGAGCGCCTAC-1	G
GAGTGAGAGTTAGCAA-1	A
GAGTGAGCAAATTCCG-1	G
GAGTGAGCACACTAGT-1	A
GAGTGAGCACTGTAAC-1	G
GAGTGAGGTATGCTAC-1	G
GAGTGAGTCGCGCTGA-1	G
GAGTGAGTCGCTACCT-1	A
GAGTGAGTCTCTGCAC-1	G
GATCATGAGAGGTGGG-1	A
GATCATGAGCAATAAC-1	A
GATCATGAGGTAGGAA-1	A
GATCATGCAATTGCCA-1	A
GATCATGCAGGCATTT-1	G
GATCATGGTATCTGCA-1	G
GATCATGGTTTAGAAG-1	A
GATCATGGTTTCTTAC-1	A
GATCATGTCAGGCGCT-1	A
GATCGTAAGATCTCAC-1	G
GATCGTAAGGAAGAAC-1	A
GATCGTAAGTCCGGAA-1	G
GATCGTACACCGTTGG-1	A
GATCGTACACTGTCGG-1	A
GATCGTACAGTATCTG-1	A
GATCGTAGTACTAGAA-1	G
GATCGTAGTCAGTGTT-1	G
GATCGTAGTCGGCTGT-1	A
GATCGTAGTGCACATT-1	G
GATCGTAGTTGCAGCC-1	A
GATCGTAGTTTCGTTT-1	G
GATCGTATCAACTTGG-1	A
GATCGTATCCCAGCGA-1	G
GATCGTATCCCAGTAA-1	A
GATCGTATCGCGCTGA-1	A
GATCGTATCTAGCTGA-1	A
GATGATCAGGTAAGCC-1	A
GATGATCAGTACAGTA-1	G
GATGATCCACCGAAAG-1	A
GATGATCCAGCTATAC-1	G
GATGATCCAGTTGGAG-1	A
GATGATCCATGGTTTG-1	A
GATGATCGTAATGCAA-1	A
GATGATCGTAATGTAG-1	A
GATGATCGTACTTGAC-1	G
GATGATCGTAGGTGAC-1	A
GATGATCGTCCTTCAC-1	A
GATGATCGTGGCCTCA-1	A
GATGATCGTGTCCTTC-1	G
GATGATCGTTCACGTA-1	A
GATGATCTCACACGTA-1	G
GATGATCTCTTCGTTA-1	A
GATGGCCAGAGCCTGA-1	G
GATGGCCAGCACCATT-1	G
GATGGCCAGTCCCGCA-1	A
GATGGCCCACGACGAA-1	A
GATGGCCGTCGCTAGC-1	G
GATGGCCGTGCCCAGT-1	G
GATGGCCTCCCGATTC-1	G
GATGGCCTCCTCCAGT-1	A
GATTAGCAGATATGAC-1	A
GATTAGCAGCGCATTT-1	A
GATTAGCAGTCATACC-1	G
GATTAGCCAAAGCATA-1	A
GATTAGCCAAGCGAAC-1	A
GATTAGCCATCCCGGA-1	A
GATTAGCGTAAACGAT-1	A
GATTAGCGTATGTTCG-1	A
GATTAGCGTCAGCTTA-1	G
GATTAGCGTGCAAAGC-1	A
GATTAGCGTTCGGGAA-1	A
GATTAGCTCAACACGT-1	G
GATTAGCTCCAATCCC-1	G
GATTAGCTCGGTCTAA-1	A
GATTAGCTCTCGGCGA-1	A
GATTAGCTCTGGACAT-1	A
GATTAGCTCTTAACGG-1	A
GATTGACAGAATGCTA-1	G
GATTGACAGACAGCTG-1	G
GATTGACAGCAACGGT-1	A
GATTGACAGCAGTAGC-1	A
GATTGACAGTTTGGAA-1	A
GATTGACCATCGCTAA-1	A
GATTGACGTAACACTC-1	A
GATTGACGTTTCCTAT-1	A
GATTGACTCCTCCCAA-1	A
GCAAAGGAGCAGAGCT-1	G
GCAAAGGAGCTCGTTA-1	G
GCAAAGGAGCTTCAAC-1	A
GCAAAGGAGTTCGCGC-1	A
GCAAAGGCAAGCAATA-1	A
GCAAAGGCACAGAAGC-1	A
GCAAAGGCATAGCCGC-1	A
GCAAAGGCATCCATAG-1	A
GCAAAGGGTCTGGGCT-1	G
GCAAAGGGTGCCAAGA-1	A
GCAAAGGGTGTGAGGT-1	A
GCAAAGGGTTGGAGGT-1	G
GCAAAGGTCAGTACAC-1	G
GCAAAGGTCCCAGCGA-1	A
GCAAAGGTCCGAATTG-1	A
GCAACCGAGCAGAATT-1	A
GCAACCGAGTAGACCG-1	G
GCAACCGGTAAACCCT-1	A
GCAACCGGTCTGCACG-1	G
GCAACCGGTCTGGGCT-1	G
GCAACCGTCAGAATGA-1	A
GCAACCGTCAGCACGC-1	G
GCAACCGTCCCGCAAG-1	G
GCAACCGTCCCTACCA-1	A
GCAACCGTCCTAAGTG-1	G
GCAACCGTCTTCTCTC-1	G
GCACCTTAGAGAGGTA-1	A
GCACCTTAGCTACGTT-1	A
GCACCTTAGTCCTTCC-1	A
GCACCTTAGTTCAACC-1	A
GCACCTTCACCGAATT-1	A
GCACCTTCACTCCACT-1	G
GCACCTTCACTTGCGG-1	A
GCACCTTGTAAACGAT-1	A
GCACCTTGTAGAAAGG-1	G
GCACCTTGTTCTTAGG-1	G
GCACCTTTCAGTCACA-1	G
GCACCTTTCGAGCGCT-1	G
GCACCTTTCGCTCGGA-1	A
GCACCTTTCGTGCTTC-1	A
GCACGCAAGACCATAA-1	A
GCACGCAAGACCGCAA-1	A
GCACGCAAGAGCCACA-1	G
GCACGCAAGAGTTCGG-1	A
GCACGCAAGGCTTTAC-1	G
GCACGCAAGGTTCGAG-1	G
GCACGCACAAATTGAG-1	A
GCACGCACACTGTCAA-1	G
GCACGCACAGGCTACC-1	A
GCACGCACATATACGC-1	G
GCACGCAGTAAGCCTT-1	G
GCACGCAGTACGCCCA-1	A
GCACGCAGTCCTATTT-1	G
GCACGCAGTCGCTACG-1	A
GCACGCAGTGTCGTGC-1	A
GCACGCATCAGTGTGT-1	A
GCACGCATCCATCGAA-1	A
GCACGCATCCCAGTAA-1	A
GCACGCATCGGGCTCA-1	A
GCACGCATCTATATCC-1	A
GCACGGTAGAACCCGA-1	A
GCACGGTAGATTACGA-1	G
GCACGGTAGCGGACTA-1	A
GCACGGTAGCGTCTGC-1	A
GCACGGTAGGTTACAA-1	A
GCACGGTCATACTGCA-1	A
GCACGGTCATCGACGC-1	A
GCACGGTGTGATAGAT-1	G
GCACGGTGTTCTGATG-1	A
GCACGGTGTTGCCGCA-1	A
GCACGGTTCAAGGCAG-1	A
GCACGGTTCACTAGGT-1	A
GCACGGTTCCAGGTCG-1	A
GCACGGTTCTCTTAAC-1	G
GCAGATTCAATGTGCT-1	A
GCAGATTGTGAATCAA-1	A
GCAGATTGTGGCGCTT-1	A
GCAGATTGTTGCCTGG-1	A
GCAGATTTCGCAGATT-1	A
GCAGCCAAGTTGGAAT-1	G
GCAGCCACAAAGGCCA-1	A
GCAGCCACAAGCCCTG-1	G
GCAGCCACACAGGAAC-1	A
GCAGCCACATGTATCG-1	G
GCAGCCAGTAGAAAGG-1	G
GCAGCCAGTGCAAGAC-1	G
GCAGCCAGTTATCGAC-1	A
GCAGCCAGTTCTTTCA-1	G
GCAGCCATCCAAGTCA-1	A
GCAGCCATCCATAACG-1	G
GCAGCCATCCTTGACC-1	G
GCAGCCATCGGGCTCA-1	G
GCAGCTGAGAATCAAC-1	G
GCAGCTGAGTCTCGAT-1	A
GCAGCTGAGTGATCTC-1	A
GCAGCTGCACCTGTGG-1	G
GCAGCTGCACGTGAAG-1	A
GCAGCTGGTAACCCAT-1	G
GCAGCTGGTAGTCCAT-1	G
GCAGCTGGTATCATGC-1	G
GCATGATAGAGAGGTA-1	A
GCATGATAGAGGCGGA-1	A
GCATGATAGATCTAAG-1	G
GCATGATCAATTGGCT-1	A
GCATGATTCGACTCGG-1	A
GCATGATTCGTCCCTA-1	G
GCATTCCAGAAGCCTG-1	A
GCATTCCAGCCGCTGT-1	G
GCATTCCAGCGCGTTC-1	G
GCATTCCAGGGCTTCC-1	A
GCATTCCAGTGCTCGC-1	A
GCATTCCAGTTACACC-1	A
GCATTCCCACGTGAAG-1	A
GCATTCCCATTTAGGC-1	G
GCATTCCGTAAACGTA-1	A
GCATTCCGTTGCTTGA-1	A
GCATTCCGTTGGAGGT-1	A
GCATTCCTCATTCATC-1	A
GCATTCCTCTATCTCA-1	A
GCATTCCTCTCCTTGG-1	G
GCATTCCTCTCTGACC-1	A
GCATTCCTCTCTGAGA-1	A
GCATTCCTCTGGAAGG-1	A
GCATTGAAGCAATAAC-1	G
GCATTGAAGCCATTCA-1	A
GCATTGAAGGAGAACA-1	G
GCATTGAAGGTACTCT-1	A
GCATTGACAAGGCTTT-1	A
GCATTGACAATGGTCT-1	A
GCATTGACACGCCGAT-1	A
GCATTGACACGCGATC-1	G
GCATTGACACTAGGAG-1	G
GCATTGACAGGTGTCC-1	G
GCATTGACAGTGGTCC-1	G
GCATTGAGTCTAAGAA-1	G
GCATTGAGTGTAGGAC-1	G
GCATTGATCAATTCCT-1	G
GCATTGATCAGGAAGC-1	G
GCATTGATCCAATAGC-1	G
GCATTGATCCGAATTG-1	A
GCATTGATCCTATCAT-1	A
GCCAGACAGAACTCCT-1	G
GCCAGACAGGCAGATC-1	G
GCCAGACAGTCATACC-1	A
GCCAGACCAAGATTAG-1	G
GCCAGACCACAGGTAG-1	A
GCCAGACCAGGATAGC-1	A
GCCAGACGTCACATTG-1	A
GCCAGACGTCCAAGTT-1	A
GCCAGACGTCGAGGTA-1	G
GCCAGACGTCTGAGCC-1	G
GCCAGACTCAGAATGA-1	A
GCCAGACTCCAAACCA-1	A
GCCAGACTCGCATAAC-1	G
GCCAGACTCTACTTTG-1	A
GCCAGCAAGGGTGTTG-1	G
GCCAGCAAGTACGACG-1	A
GCCAGCACAAGCAGGT-1	A
GCCAGCACAAGCGACA-1	A
GCCAGCACAATTAGGA-1	G
GCCAGCACAGGGCTTC-1	G
GCCAGCACAGTAACGG-1	G
GCCAGCACATTGTTCT-1	G
GCCAGCAGTATCCCTC-1	A
GCCAGCAGTCATCGTA-1	A
GCCAGCAGTCGCTAGC-1	A
GCCAGCAGTGCAACAG-1	A
GCCAGCAGTTCTTTGT-1	A
GCCAGCATCAACACGT-1	A
GCCAGCATCAGCACTA-1	A
GCCAGCATCCCGATTC-1	A
GCCAGCATCGGATCGC-1	G
GCCAGCATCGGTAGGA-1	A
GCCAGCATCTGGCTAA-1	A
GCCAGCATCTTCTTCC-1	G
GCCATAAAGAGCAGCT-1	G
GCCATAAAGATGCGAC-1	A
GCCATAAAGCATGATA-1	A
GCCATAAAGCGGACTA-1	A
GCCATAAAGGCAAGCT-1	A
GCCATAAAGGGTTCTT-1	G
GCCATAACACTAGGAG-1	G
GCCATAACAGTATACC-1	A
GCCATAACATAAAGTG-1	A
GCCATAACATGCGTTA-1	G
GCCATAAGTAAAGGCC-1	G
GCCATAAGTCCGTCGA-1	G
GCCATAAGTGGTACTT-1	A
GCCATAAGTTAACTCG-1	A
GCCATAAGTTACCCAA-1	A
GCCATAATCAAGTTGC-1	A
GCCATAATCAGGCGCT-1	A
GCCATAATCCAGGCCA-1	A
GCCATAATCCTCCATG-1	A
GCCCAGAAGCGATACG-1	A
GCCCAGAAGTGTCACT-1	G
GCCCAGACATTAGCAC-1	A
GCCCAGAGTACAAATG-1	G
GCCCAGAGTTATGCAC-1	A
GCCCAGAGTTGTGAGG-1	G
GCCCAGATCAAACCAC-1	A
GCCCAGATCACTTACT-1	A
GCCCAGATCGACTATG-1	A
GCCCAGATCTCTGTTA-1	A
GCCCGAAAGAAATTCG-1	A
GCCCGAAAGGCTTAAA-1	G
GCCCGAAAGTGGACGT-1	G
GCCCGAAAGTTCGACT-1	A
GCCCGAACAAGAGATT-1	A
GCCCGAAGTACTTCGA-1	G
GCCCGAAGTATTCGAC-1	G
GCCCGAAGTCAGAAAT-1	A
GCCCGAAGTCCAAGTT-1	A
GCCCGAATCAAGGCAG-1	G
GCCCGAATCCCACGGA-1	G
GCCCGAATCTCGTAGA-1	A
GCCCGAATCTTATCAC-1	A
GCCTACTAGGCGCTTC-1	G
GCCTACTAGGGTATCG-1	G
GCCTACTCACACATTG-1	G
GCCTACTCACGACGAA-1	G
GCCTACTCAGTAGTCT-1	A
GCCTACTCATGACTGT-1	A
GCCTACTGTACCCACG-1	A
GCCTACTGTACGACCC-1	G
GCCTACTGTCACAGGA-1	A
GCCTACTGTCATGAGG-1	A
GCCTACTGTCCTCAGG-1	A
GCCTACTGTCCTTCAC-1	A
GCCTACTGTGTCTCGG-1	G
GCCTACTGTTCTTTGT-1	G
GCCTACTGTTGGTAAA-1	A
GCCTACTTCCTTACGC-1	G
GCCTACTTCGGTCTAA-1	A
GCCTAGGAGGCCTCTG-1	G
GCCTAGGCAACGACAG-1	G
GCCTAGGCATTTCTTG-1	G
GCCTAGGGTTTAGGAA-1	A
GCCTAGGTCCAACAAC-1	A
GCGAGAAAGACGTCAG-1	A
GCGAGAAAGCCTCGCA-1	G
GCGAGAAAGCTAGTTC-1	A
GCGAGAAAGGGAGTTC-1	G
GCGAGAAAGTGGACGT-1	A
GCGAGAACACTGCTCT-1	A
GCGAGAACATGGCCCA-1	G
GCGAGAAGTAGCGTTT-1	A
GCGAGAAGTATGAAGT-1	A
GCGAGAAGTCCAAGAG-1	A
GCGAGAAGTGACAAGC-1	A
GCGAGAAGTGGGTAGT-1	G
GCGAGAATCCCTAAAG-1	A
GCGAGAATCTGGAAGG-1	A
GCGAGTCAGACCAATA-1	G
GCGAGTCAGCTCGTTA-1	A
GCGAGTCAGTTGCTTG-1	A
GCGAGTCCAACGTAGG-1	G
GCGAGTCCAGTAGTTC-1	A
GCGAGTCCATCAGAAA-1	G
GCGAGTCGTAAAGCTA-1	G
GCGAGTCGTACATGGG-1	G
GCGAGTCGTCCCTAAA-1	G
GCGAGTCGTCCGGTAC-1	G
GCGAGTCGTGCGACCT-1	G
GCGAGTCGTGGAAGCT-1	G
GCGAGTCGTTGAATAG-1	A
GCGAGTCTCAATTCCT-1	G
GCGAGTCTCCCTATTA-1	A
GCGAGTCTCCTCTCTT-1	G
GCGATCGAGATTCCGT-1	G
GCGATCGAGCCAGAAC-1	G
GCGATCGAGCTAACAA-1	A
GCGATCGAGGCTTTAC-1	G
GCGATCGCAAATAGTG-1	G
GCGATCGCAATGAAAC-1	G
GCGATCGCATGCCCTT-1	G
GCGATCGGTCCGCTTT-1	A
GCGATCGGTGGCGCTT-1	A
GCGATCGGTTACACTG-1	A
GCGATTAAGAACGCCA-1	A
GCGATTAAGGTACACG-1	G
GCGATTAAGTAGAAGG-1	G
GCGATTACAACTACTG-1	A
GCGATTAGTAGTGATA-1	G
GCGATTAGTCATAGAA-1	G
GCGATTAGTGATGCTT-1	A
GCGATTAGTGCTTCCT-1	A
GCGATTAGTGGTAAGC-1	G
GCGATTAGTTTGTAGC-1	A
GCGATTATCAGGAATA-1	G
GCGATTATCGAACACT-1	G
GCGATTATCTGATCCC-1	A
GCGATTATCTTCGTTA-1	G
GCGCATGCAGGCAAGT-1	A
GCGCATGCATGTCCCT-1	G
GCGCATGCATTCCCGT-1	G
GCGCATGGTGTGCTTA-1	G
GCGCATGGTTCGGGAA-1	G
GCGCATGGTTTCCGGG-1	A
GCGCATGTCCTCCAGT-1	A
GCGCATGTCTACCCGT-1	G
GCGCATGTCTCCTTGG-1	A
GCGCATGTCTCGCGGA-1	G
GCGCCAAAGAGGCAGG-1	A
GCGCCAAAGCGCAATG-1	G
GCGCCAAAGGAAACTT-1	G
GCGCCAAAGTAGAAGG-1	A
GCGCCAAAGTAGGTCG-1	G
GCGCCAACAACGTCCG-1	G
GCGCCAACAGAACTTC-1	A
GCGCCAACAGCAATGG-1	A
GCGCCAAGTCATGAGG-1	A
GCGCCAAGTGAATGGC-1	A
GCGCCAATCAGAGTGG-1	G
GCGCCAATCGAGAAGC-1	A
GCGCCAATCGGCAATT-1	A
GCGCCAATCTAGTCGA-1	G
GCGCCAATCTTGGCCT-1	G
GCGGAAAAGCCATCAT-1	A
GCGGAAAAGTGAAACT-1	A
GCGGAAACAAACAGTA-1	A
GCGGAAACAACGAGGT-1	A
GCGGAAACAATGGCTT-1	A
GCGGAAACACCACGAC-1	A
GCGGAAACAGTTGGAG-1	G
GCGGAAACATGTGAGG-1	G
GCGGAAAGTCACAGGA-1	A
GCGGAAAGTCGACTGC-1	G
GCGGAAAGTGCAACAG-1	A
GCGGAAAGTGCACATT-1	G
GCGGAAAGTGCCGGTT-1	G
GCGGAAAGTGCGACCT-1	G
GCGGAAAGTGGATTCT-1	A
GCGGAAAGTGTCGTCG-1	G
GCGGAAATCAGTTGAC-1	A
GCGGAAATCATTCTCA-1	G
GCGGAAATCCAACGCG-1	A
GCGGAAATCCGTTAGA-1	G
GCGGAAATCGAGAAGC-1	G
GCGGAAATCGCCAGAC-1	G
GCGGAAATCTATGAGC-1	A
GCGGAAATCTGGACAT-1	A
GCGGGTTAGAGGTACC-1	A
GCGGGTTAGTCGTACT-1	A
GCGGGTTCAAAGAAGG-1	G
GCGGGTTCAACCTCCT-1	A
GCGGGTTCAACGGACA-1	A
GCGGGTTCACAGTTAC-1	A
GCGGGTTCATTAACGC-1	G
GCGGGTTGTATCCTTT-1	G
GCGGGTTGTCAGACGA-1	G
GCGGGTTTCCAATCCC-1	A
GCGGGTTTCCCAGCGA-1	A
GCGGGTTTCCTTACGC-1	A
GCGGGTTTCGATGTAC-1	A
GCGGGTTTCTGGCGCA-1	G
GCGGGTTTCTTAATCC-1	A
GCGGGTTTCTTCATAC-1	A
GCGGTGTAGGGTATCG-1	G
GCGGTGTAGGTTAACA-1	A
GCGGTGTAGTGCACAG-1	A
GCGGTGTCAGGACCTC-1	G
GCGGTGTCAGGTGGTA-1	G
GCGGTGTCATCAGCTA-1	A
GCGGTGTCATTACTTC-1	G
GCGGTGTGTAACACTC-1	A
GCGGTGTGTGAATCAA-1	G
GCGGTGTGTGATGCGA-1	G
GCGGTGTTCTCATCCG-1	G
GCGTAGCAGGTTGACG-1	A
GCGTAGCAGTCCGTGC-1	A
GCGTAGCAGTTGCTTG-1	G
GCGTAGCCAACTTGGT-1	G
GCGTAGCCACCACGAC-1	A
GCGTAGCCACTCAGCG-1	G
GCGTAGCCAGAAAGAG-1	G
GCGTAGCCAGCACATT-1	G
GCGTAGCCAGCGTGAA-1	A
GCGTAGCGTAACATAG-1	G
GCGTAGCGTATTCGAC-1	A
GCGTAGCGTGCAAGCA-1	G
GCGTAGCGTGCGTCCA-1	A
GCGTAGCGTTAGAGAT-1	A
GCGTAGCGTTTGTCTT-1	G
GCGTAGCTCACATCCC-1	G
GCGTAGCTCCCAGTAA-1	A
GCGTAGCTCGGGAAAC-1	A
GCGTAGCTCGGTCCGA-1	G
GCGTTGGAGACACAAT-1	A
GCGTTGGAGAGACTCG-1	G
GCGTTGGAGCTATCCA-1	G
GCGTTGGAGGACCGAT-1	G
GCGTTGGCAACGTCGC-1	G
GCGTTGGCACTTTGGA-1	A
GCGTTGGCAGTCCTGG-1	G
GCGTTGGTCATTCATC-1	A
GCGTTGGTCCCAGCAG-1	G
GCGTTGGTCGGATGTT-1	A
GCGTTGGTCGTTCCGT-1	A
GCGTTGGTCTGATCCC-1	G
GCTCACTAGAGGTCCA-1	A
GCTCACTAGCCCATTA-1	G
GCTCACTAGCTGATTC-1	A
GCTCACTAGGCTCAGA-1	G
GCTCACTCAAATAGTG-1	A
GCTCACTCAAGCGGTA-1	G
GCTCACTCATCCTCGT-1	A
GCTCACTCATCTGCAA-1	A
GCTCACTGTAGTCCAT-1	G
GCTCACTGTCCCTTTG-1	A
GCTCACTGTCTGATTG-1	A
GCTCACTGTGCGCATC-1	A
GCTCACTGTTCTGAAC-1	A
GCTCACTGTTGTGACT-1	G
GCTCACTTCAAACCCA-1	A
GCTCACTTCCTATCCG-1	A
GCTCACTTCCTCCATG-1	A
GCTCACTTCGCTCTAC-1	A
GCTCACTTCTATCTCA-1	A
GCTCAGGAGACACTTC-1	G
GCTCAGGCATCCATAG-1	G
GCTCAGGGTCATAAGA-1	A
GCTCAGGGTCATGAGG-1	A
GCTCAGGGTCTCAAAC-1	A
GCTCAGGTCTTACGGA-1	G
GCTCCTAAGAGGAATG-1	G
GCTCCTAAGCTGCCAC-1	A
GCTCCTAAGGTTGTGG-1	G
GCTCCTAAGTATACGA-1	G
GCTCCTAAGTCAGCCC-1	A
GCTCCTAAGTCGCGTC-1	A
GCTCCTACAAGGAACC-1	A
GCTCCTACAATGGCAG-1	A
GCTCCTACACGCGACT-1	G
GCTCCTACAGTTGGAG-1	A
GCTCCTACATTGTGAC-1	A
GCTCCTAGTCAGCAAG-1	G
GCTCCTAGTGCCAAGA-1	G
GCTCCTAGTTTGCCCT-1	G
GCTCCTATCCAATAGC-1	A
GCTCCTATCGGAGTTT-1	A
GCTCCTATCGTGCTGG-1	A
GCTCCTATCTCTGTTA-1	A
GCTCCTATCTTTCGAT-1	A
GCTCGAGAGACGAAAG-1	A
GCTCGAGAGACTTGAA-1	G
GCTCGAGAGTGAGCAC-1	G
GCTCGAGAGTGTCGCC-1	A
GCTCGAGCAAGCGACA-1	G
GCTCGAGCACACACCG-1	G
GCTCGAGGTGCTGGCT-1	G
GCTCGAGGTGTTAGAA-1	A
GCTCGAGGTTTCAGCA-1	A
GCTCGAGTCCCACTAC-1	A
GCTCGAGTCGTATAGC-1	G
GCTGAGCAGGTCCTCG-1	G
GCTGAGCCAAGCAACG-1	A
GCTGAGCCACGCTCAG-1	A
GCTGAGCCACTGTAAC-1	G
GCTGAGCCATTTGTTC-1	G
GCTGAGCGTAACATAG-1	A
GCTGAGCGTCAATACC-1	A
GCTGAGCGTCAGAAAT-1	A
GCTGAGCGTTGTATCG-1	A
GCTGAGCGTTTAGAAG-1	A
GCTGAGCGTTTGAAGA-1	G
GCTGAGCTCAGGGTTT-1	A
GCTGAGCTCCAACAAC-1	G
GCTGAGCTCCACACCT-1	A
GCTGAGCTCCAGAATC-1	A
GCTGAGCTCCCTACCA-1	A
GCTGAGCTCTATACCT-1	G
GCTGAGCTCTCCCTTT-1	G
GCTGAGCTCTCTCAAT-1	A
GCTGCGAAGATCGAGC-1	A
GCTGCGAAGCTTTCCC-1	A
GCTGCGAAGGAGTAGA-1	A
GCTGCGAAGGGTTCTT-1	G
GCTGCGAAGTAATGTG-1	A
GCTGCGAAGTAGGTCG-1	G
GCTGCGAAGTCCTTCC-1	A
GCTGCGACAAGTCTCA-1	A
GCTGCGACATTGATGC-1	A
GCTGCGAGTGCGACCT-1	G
GCTGCGAGTTGGTAAA-1	A
GCTGCGATCAGAGTGG-1	A
GCTGCGATCCGGGCAT-1	A
GCTGCGATCCTCAAGA-1	A
GCTGTTCAGCGCCTAC-1	A
GCTGTTCAGGACTTTC-1	A
GCTGTTCAGTAACATG-1	A
GCTGTTCAGTCTCTAG-1	A
GCTGTTCAGTGATAAC-1	A
GCTGTTCCAAGGCTTT-1	G
GCTGTTCGTCAACAGG-1	G
GCTGTTCGTCTAACCA-1	A
GCTGTTCGTGGACAGT-1	A
GCTGTTCGTTACTTTC-1	A
GCTGTTCGTTCAGTTG-1	G
GCTGTTCGTTCTACGA-1	A
GCTGTTCTCCGCTCTA-1	A
GCTGTTCTCTGGAAGG-1	G
GCTTAAGAGAGCAGCT-1	A
GCTTAAGCAACTCCCT-1	A
GCTTAAGCAAGCACTT-1	G
GCTTAAGCACGTGAAG-1	G
GCTTAAGCAGTAGGCA-1	A
GCTTAAGGTACGTAAA-1	G
GCTTAAGGTGATGCTT-1	A
GCTTAAGGTGCACTTA-1	G
GCTTAAGTCCAAACCA-1	A
GCTTAAGTCGTGGTAT-1	A
GCTTAAGTCTGTTTAC-1	G
GCTTGCTAGGTCACTT-1	G
GCTTGCTCAAAGCTTC-1	A
GCTTGCTCATTACTCT-1	G
GCTTGCTGTTATCGAC-1	G
GCTTGCTTCACTGGTA-1	A
GCTTGCTTCAGTCTTT-1	G
GCTTGCTTCCATAACG-1	A
GCTTGCTTCGCGATGC-1	G
GCTTGCTTCGTCCCTA-1	G
GCTTTCGAGAGGCAGG-1	G
GCTTTCGAGCATTCCA-1	A
GCTTTCGAGTCGATAA-1	A
GCTTTCGCAACAAACA-1	G
GCTTTCGCACGCTAAT-1	A
GCTTTCGCAGTCCTGG-1	A
GCTTTCGGTACAACGG-1	A
GCTTTCGGTAGCAGGT-1	G
GCTTTCGGTAGCCATT-1	A
GCTTTCGGTGCGACCT-1	A
GCTTTCGGTTGGCGAA-1	G
GCTTTCGTCATTCTCA-1	A
GGAACCCAGGCTTAAA-1	A
GGAACCCAGGTTCGTT-1	A
GGAACCCAGTCGTACT-1	G
GGAACCCAGTGTTCCA-1	G
GGAACCCCAAACTACC-1	A
GGAACCCCACGCGCAT-1	G
GGAACCCCAGAGCCAA-1	A
GGAACCCCATGGTAAA-1	A
GGAACCCCATGTGGGA-1	A
GGAACCCGTCTGTCCT-1	G
GGAACCCGTGAGGTCA-1	A
GGAACCCGTGCAAAGC-1	A
GGAACCCTCGTGAACT-1	G
GGAACTTAGCGCGTTC-1	A
GGAACTTAGGAGTCTG-1	A
GGAACTTAGTCTTAGC-1	A
GGAACTTCAAGAGCGT-1	G
GGAACTTCATCGCCTT-1	G
GGAACTTGTAGTTTGC-1	G
GGAACTTGTCCCTAAA-1	A
GGAACTTGTCCTTATT-1	A
GGAACTTGTGGTGGTA-1	G
GGAACTTGTTTAGGAA-1	A
GGAACTTTCATGTTCT-1	G
GGAACTTTCCAGGTAT-1	A
GGAACTTTCGGAGTTT-1	G
GGAACTTTCGTTACAG-1	A
GGAACTTTCGTTGTAG-1	A
GGAATCTAGAATACTG-1	A
GGAATCTAGCTTTCCC-1	A
GGAATCTCAAGGTTCT-1	G
GGAATCTCAAGTCTCA-1	G
GGAATCTCACCCATCT-1	A
GGAATCTCACTGTCGG-1	A
GGAATCTCAGAACTTC-1	A
GGAATCTCATTCTTTG-1	G
GGAATCTGTAATGCCT-1	G
GGAATCTGTAGTAACA-1	G
GGAATCTGTATTCGAC-1	A
GGAATCTGTCCGGTAC-1	A
GGAATCTGTCCTTCAC-1	A
GGAATCTGTTAAGTCC-1	G
GGAATCTTCCACGAGC-1	A
GGAATCTTCCGCTATC-1	A
GGAATCTTCTCTTAAC-1	G
GGACACCAGAGATTAC-1	G
GGACACCAGATACCAA-1	A
GGACACCAGCATGATA-1	A
GGACACCAGTCCTTCC-1	G
GGACACCAGTGCTGAG-1	A
GGACACCCAAATGCTC-1	A
GGACACCCATGTGGGA-1	A
GGACACCGTAGAACGC-1	G
GGACACCGTAGTCCAT-1	A
GGACACCTCTCTGTTA-1	G
GGACACCTCTGAAAGA-1	A
GGAGAACAGAGCTACG-1	A
GGAGAACAGAGTCCGA-1	A
GGAGAACAGCATGATA-1	A
GGAGAACAGGTTAACA-1	G
GGAGAACAGTACAGTA-1	A
GGAGAACCAAATGTCC-1	A
GGAGAACCAAGGATGC-1	A
GGAGAACCAGGATAGC-1	A
GGAGAACGTACTATGC-1	A
GGAGAACGTAGATGAT-1	A
GGAGAACGTAGCTGTT-1	A
GGAGAACGTGCCGGTT-1	G
GGAGAACGTGCTGGCT-1	A
GGAGAACGTTCTGAGT-1	G
GGAGAACGTTGCAGAG-1	G
GGAGAACTCAGTGGTT-1	A
GGAGAACTCCGGCGAT-1	A
GGAGAACTCCTCTCTT-1	G
GGAGAACTCGTCCCAT-1	G
GGAGGATAGCGGACAT-1	A
GGAGGATAGGATATCA-1	A
GGAGGATAGGTGAACC-1	G
GGAGGATAGTGATAAC-1	A
GGAGGATCAGTCAGAG-1	G
GGAGGATGTGAATGGC-1	A
GGAGGATGTTTGTGAC-1	A
GGAGGATTCCCATAGA-1	G
GGAGGATTCCGTCAAA-1	A
GGAGGATTCGCACAAT-1	G
GGAGTAGAGATGGGAA-1	A
GGAGTAGAGCAATAAC-1	A
GGAGTAGCAAGAGATT-1	A
GGAGTAGCAATGACTC-1	G
GGAGTAGCAGCGTCGT-1	A
GGAGTAGCAGGGCTTC-1	A
GGAGTAGGTCGTCGCA-1	G
GGAGTAGGTGCCGGTT-1	A
GGAGTAGGTGGACGAT-1	A
GGAGTAGGTTAGGCTT-1	G
GGATAGGAGATCGATA-1	A
GGATAGGAGGGTCCCT-1	A
GGATAGGAGGGTTCTT-1	A
GGATAGGAGTGTCGGA-1	A
GGATAGGCAAATGCTC-1	G
GGATAGGCAACGAGGT-1	G
GGATAGGCAGTAGTCT-1	A
GGATAGGCATCCCTCA-1	A
GGATAGGCATGTGAGG-1	A
GGATAGGCATTGCACA-1	G
GGATAGGGTAGACACG-1	A
GGATAGGGTAGGTGAC-1	G
GGATAGGGTTTCTACT-1	A
GGATAGGTCCAACCTC-1	A
GGATAGGTCCATAACG-1	A
GGATAGGTCCCTACGT-1	A
GGATAGGTCCTCATTA-1	G
GGATAGGTCCTTTGAT-1	A
GGATAGGTCGCGATGC-1	A
GGATAGGTCGCTATAG-1	A
GGATGAGAGCATGATA-1	A
GGATGAGAGCTAACAA-1	G
GGATGAGAGGCTAAAT-1	G
GGATGAGGTACTATGC-1	A
GGATGAGGTACTTCAG-1	G
GGATGAGGTACTTGAC-1	G
GGATGAGGTCAATCCA-1	G
GGATGAGGTTAGGAAT-1	G
GGATGAGTCAGCCGAC-1	A
GGATGAGTCGAGCGCT-1	G
GGATGAGTCGCCACTT-1	G
GGCACGTCAACCTCCT-1	G
GGCACGTCAAGAGCGT-1	G
GGCACGTCAAGCCAGA-1	A
GGCACGTCACGTACAT-1	G
GGCACGTCATGGTAAA-1	A
GGCACGTGTAACGGCA-1	G
GGCACGTGTGCGTTTA-1	G
GGCACGTGTGTCCCAG-1	A
GGCACGTTCAACGTGT-1	G
GGCACGTTCAGCACGC-1	A
GGCACGTTCCCAATGA-1	A
GGCACGTTCTTCTCTC-1	G
GGCATTAAGAGGTACC-1	A
GGCATTAAGCAACTGG-1	A
GGCATTAAGTCACACT-1	G
GGCATTAAGTCTGCTA-1	G
GGCATTACACACACAT-1	G
GGCATTACACTCCCAT-1	A
GGCATTACACTGGGCT-1	G
GGCATTAGTGCTGGCT-1	G
GGCATTAGTGCTTGAT-1	A
GGCATTAGTGTAGGAC-1	G
GGCATTAGTTCTGAAC-1	G
GGCATTATCATCGCCT-1	G
GGCATTATCTGGCTAA-1	G
GGCGAAAAGGTCTTGT-1	A
GGCGAAACAAGAGATT-1	A
GGCGAAACATTACTTC-1	G
GGCGAAAGTATGCTAC-1	G
GGCGAAAGTCGCTAGC-1	G
GGCGAAAGTGAGTCGA-1	G
GGCGAAAGTGGTTCTA-1	A
GGCGAAAGTTATGCAC-1	G
GGCGAAAGTTTCAGCA-1	G
GGCGAAATCAAGTTGC-1	G
GGCGAAATCCAGTACA-1	G
GGCGAAATCCCACGGA-1	A
GGCGTTGAGCCATCAT-1	A
GGCGTTGAGCTGCTCG-1	A
GGCGTTGAGTCAGGAC-1	G
GGCGTTGAGTTAGAGT-1	A
GGCGTTGCAACGACAG-1	A
GGCGTTGCAGCTATAC-1	G
GGCGTTGGTATTCGCA-1	A
GGCGTTGGTTACTACG-1	G
GGCGTTGGTTTGAAGA-1	G
GGCGTTGTCACTACCC-1	A
GGCGTTGTCCAGTTAG-1	G
GGCGTTGTCGACTATG-1	A
GGCGTTGTCGAGAAGC-1	A
GGCGTTGTCGATAGGG-1	A
GGCGTTGTCGTTCCGT-1	A
GGCGTTGTCTTATCAC-1	A
GGGAACAAGCGGACTA-1	A
GGGAACAAGCTCCATA-1	A
GGGAACACACAGCTTA-1	A
GGGAACACACTCAGCG-1	A
GGGAACACAGCGTGAA-1	A
GGGAACACATGCTATG-1	A
GGGAACAGTATCATGC-1	G
GGGAACATCACTAGCA-1	G
GGGAACATCCACCTAC-1	G
GGGAACATCCCTACGT-1	G
GGGAACATCCGGAAAG-1	A
GGGAACATCGATGAAA-1	A
GGGAACATCTCATCCG-1	G
GGGAACATCTGGCTAA-1	G
GGGAACATCTTCGTTA-1	A
GGGACCTAGCTCGGCT-1	G
GGGACCTAGCTGCCAC-1	A
GGGACCTAGTGTAATG-1	G
GGGACCTCAAGGAACC-1	A
GGGACCTCAAGGGAGG-1	A
GGGACCTGTACTATGC-1	A
GGGACCTGTAGCGGTA-1	A
GGGACCTGTTCCGGCA-1	A
GGGACCTTCAACACGT-1	G
GGGACCTTCAATCGTG-1	A
GGGACCTTCTCCTTAA-1	A
GGGCCATCACTGCTTC-1	A
GGGCCATGTAGCGAGT-1	G
GGGCCATGTAGTCTGT-1	A
GGGCCATGTGATGTGG-1	G
GGGCCATGTTATCGAC-1	A
GGGCCATTCAAGGCAG-1	G
GGGCCATTCATGAACC-1	G
GGGTCTGAGAAATACC-1	G
GGGTCTGAGAACGACC-1	G
GGGTCTGAGCTAACAA-1	G
GGGTCTGAGGAAGGTA-1	G
GGGTCTGAGGTGATGC-1	A
GGGTCTGAGTTGACAA-1	G
GGGTCTGCAATCAGGG-1	A
GGGTCTGCACGAACGA-1	G
GGGTCTGCAGGTCCTG-1	A
GGGTCTGCATCCTGGG-1	A
GGGTCTGGTTGGTAAA-1	G
GGGTCTGTCACCCTTG-1	G
GGGTCTGTCGCTGATA-1	A
GGGTCTGTCGTCTTAT-1	A
GGGTGTCAGAGGAATG-1	A
GGGTGTCAGGCTTAAA-1	G
GGGTGTCAGTAACTCC-1	A
GGGTGTCCAGTTAAAG-1	A
GGGTGTCGTCACCCGA-1	G
GGGTGTCGTGCTTTGA-1	G
GGGTGTCGTGGCCTTG-1	A
GGGTGTCTCAAATGGA-1	A
GGGTGTCTCACACGTA-1	A
GGGTGTCTCCATACCC-1	A
GGGTGTCTCGGCTATA-1	G
GGGTGTCTCGGTAGGA-1	A
GGGTTATAGGTTGACG-1	G
GGGTTATCAAAGAAGG-1	G
GGGTTATCACCATTCC-1	G
GGGTTATCATCACAGT-1	G
GGGTTATGTAAGTCTC-1	A
GGGTTATGTACGTAAA-1	A
GGGTTATTCCCAATAG-1	A
GGGTTATTCCGGACTG-1	A
GGGTTATTCGCCAGAC-1	A
GGTACCGAGAGTTTGA-1	A
GGTACCGAGATCTCAC-1	G
GGTACCGAGGATCCTT-1	A
GGTACCGCAACGTAGG-1	A
GGTACCGCACAGTTAC-1	G
GGTACCGGTAACATAG-1	A
GGTACCGGTATGTTCG-1	G
GGTACCGGTCTCGGGT-1	G
GGTACCGGTTACGCTA-1	A
GGTACCGTCCAGAGAG-1	A
GGTACCGTCTATATCC-1	G
GGTACCGTCTTGTACT-1	G
GGTAGGAAGAGTGGAA-1	A
GGTAGGAAGCAACTGG-1	G
GGTAGGAAGGCGCTTC-1	A
GGTAGGAAGTACTCTG-1	G
GGTAGGACAACTCAAC-1	A
GGTAGGACACTCGTGG-1	G
GGTAGGACAGGGAGTT-1	A
GGTAGGACATCCATAG-1	G
GGTAGGAGTCAGGTGA-1	A
GGTAGGAGTCATAAGA-1	A
GGTAGGAGTGCGTTTA-1	G
GGTAGGATCATGTTCT-1	A
GGTAGGATCCAGGCCA-1	G
GGTAGGATCCATCATT-1	A
GGTAGGATCCCTAAAG-1	G
GGTAGGATCTAAACGC-1	A
GGTAGGATCTTCGTTA-1	G
GGTCATAAGAAGGGCG-1	G
GGTCATAAGGTCGTTT-1	G
GGTCATAAGTAGTCGG-1	A
GGTCATAAGTCACACT-1	A
GGTCATACAAAGACGC-1	A
GGTCATACAATTCTCT-1	A
GGTCATAGTAAAGCTA-1	A
GGTCATAGTGAATCAA-1	A
GGTCATAGTGTGCTTA-1	A
GGTCATATCACTCGGG-1	G
GGTCATATCGCCACTT-1	A
GGTCATATCGGTCCGA-1	A
GGTCATATCGTAGCGC-1	A
GGTGAAGAGAGGCAGG-1	A
GGTGAAGAGCAGGACT-1	G
GGTGAAGAGGAGACTC-1	G
GGTGAAGAGGGCTTCC-1	G
GGTGAAGAGGTGTCGA-1	G
GGTGAAGCAACTTGGT-1	A
GGTGAAGCATCAACTG-1	A
GGTGAAGCATCGCTAA-1	A
GGTGAAGGTAACCCAT-1	A
GGTGAAGGTGGTCGAA-1	G
GGTGAAGTCCGCTATC-1	A
GGTGCTGAGAATACTG-1	G
GGTGCTGAGAGAACCC-1	G
GGTGCTGAGCATGTGG-1	A
GGTGCTGAGCGTTAGG-1	G
GGTGCTGAGGGAAGCG-1	A
GGTGCTGCAAATGTCC-1	A
GGTGCTGCAAATTCCG-1	A
GGTGCTGCATCCATAG-1	G
GGTGCTGGTAGTGATA-1	A
GGTGCTGTCGTCCCTA-1	G
GGTGCTGTCTTGTGCC-1	G
GGTGTCGAGACGCCAA-1	A
GGTGTCGAGAGCACTG-1	A
GGTGTCGAGGGCTCTC-1	A
GGTGTCGAGGGCTTCC-1	A
GGTGTCGAGGTCGGTA-1	G
GGTGTCGAGGTTGTTC-1	G
GGTGTCGAGTAGTCGG-1	A
GGTGTCGAGTGAATAC-1	A
GGTGTCGCAAGCTTTG-1	G
GGTGTCGCACAGTTCA-1	A
GGTGTCGGTAGAATAC-1	A
GGTGTCGGTATCTCAG-1	A
GGTGTCGGTGAGTCGA-1	A
GGTGTCGTCGACTGGC-1	A
GGTGTCGTCGCAAACT-1	A
GGTGTCGTCGGGAATG-1	G
GGTGTCGTCTTGTACT-1	G
GGTTGCGAGACCGCAA-1	G
GGTTGCGAGAGTTCGG-1	A
GGTTGCGAGCAATGTA-1	A
GGTTGCGAGGAAACTT-1	A
GGTTGCGAGGTCTTTG-1	A
GGTTGCGAGTAACATG-1	A
GGTTGCGAGTAACTCC-1	G
GGTTGCGAGTAATGTG-1	A
GGTTGCGCAAGCCAGA-1	A
GGTTGCGCACCACGAC-1	G
GGTTGCGCATCCCAAA-1	A
GGTTGCGCATTGCGAT-1	A
GGTTGCGGTAGATTAG-1	G
GGTTGCGGTCAAACAA-1	A
GGTTGCGGTCAGCTTA-1	A
GGTTGCGGTCGATAGG-1	G
GGTTGCGGTGGTTCTA-1	A
GGTTGCGGTTTGCGAT-1	G
GGTTGCGTCACCACAA-1	A
GGTTGCGTCACTGATG-1	G
GGTTGCGTCGGTCAGC-1	A
GTAATCGAGACGTCAG-1	A
GTAATCGAGCCGCTGT-1	A
GTAATCGAGCTATCCA-1	A
GTAATCGAGGCAGTAC-1	G
GTAATCGCAACTTGGT-1	A
GTAATCGCAATAGCGG-1	G
GTAATCGCATCCTCGT-1	A
GTAATCGCATGGCCTG-1	G
GTAATCGCATGGGAAC-1	A
GTAATCGCATGTGAGG-1	G
GTAATCGCATTACACG-1	A
GTAATCGGTACAAGCG-1	G
GTAATCGGTCTGTGTA-1	G
GTAATCGGTGCTTGAT-1	A
GTAATCGGTGTGACCC-1	A
GTAATCGTCCCAGTAA-1	G
GTAATCGTCGCAAACT-1	G
GTAATCGTCGTTTGAG-1	G
GTAATCGTCTCTGTTA-1	A
GTACTTTAGGCAAGCT-1	G
GTACTTTAGGTAGGAA-1	A
GTACTTTAGTATCTGC-1	A
GTACTTTCACTAGCCG-1	G
GTACTTTGTAAGCCGA-1	A
GTACTTTGTGAGTTGG-1	A
GTACTTTGTTATAGAG-1	G
GTACTTTGTTCAGTTG-1	G
GTACTTTGTTGAATAG-1	G
GTACTTTGTTGGAGGT-1	A
GTACTTTTCCAGTTAG-1	G
GTACTTTTCTGGACAT-1	A
GTAGACTAGCACGTAG-1	A
GTAGACTAGGCGTAGT-1	G
GTAGACTAGGTGATGC-1	G
GTAGACTAGTCCTTCC-1	G
GTAGACTCAAATAGTG-1	G
GTAGACTCAATTCTCT-1	A
GTAGACTCACGCGCAT-1	G
GTAGACTCATCGTACA-1	G
GTAGACTGTAACACTC-1	A
GTAGACTGTTCCCGGA-1	G
GTAGACTTCGAGGTCC-1	A
GTAGACTTCGATAGCT-1	G
GTAGACTTCGGCATAT-1	G
GTAGACTTCGGGCTCA-1	A
GTAGACTTCTAGCAAC-1	A
GTAGACTTCTGATCCC-1	A
GTAGACTTCTTTCGAT-1	G
GTAGGAGAGCCTATAC-1	G
GTAGGAGAGTAACTCC-1	A
GTAGGAGCACGCGATC-1	A
GTAGGAGCAGAACTTC-1	A
GTAGGAGCAGTGCTCG-1	A
GTAGGAGGTCGCTAGC-1	A
GTAGGAGGTCGTAGTT-1	A
GTAGGAGGTGCAGACA-1	G
GTAGGAGTCACGTGTA-1	G
GTAGGAGTCACTTACT-1	G
GTAGGAGTCAGGATCT-1	G
GTAGGAGTCGGCAATT-1	G
GTAGGAGTCGGTCCGA-1	G
GTAGGAGTCTATCTTG-1	G
GTAGTACAGATCGATA-1	G
GTAGTACAGATTCCGT-1	A
GTAGTACAGTAGTCGG-1	A
GTAGTACAGTCGAAAT-1	A
GTAGTACCAACTCAAC-1	G
GTAGTACCACTCGGAC-1	A
GTAGTACGTAACGGTG-1	G
GTAGTACGTGCACCCA-1	A
GTAGTACGTTCAGTTG-1	G
GTAGTACGTTGAAGCG-1	A
GTAGTACGTTTCTCTA-1	A
GTAGTACTCGACTATG-1	G
GTAGTACTCGGATAGG-1	G
GTAGTACTCTAGTCGA-1	G
GTAGTACTCTCCACTG-1	G
GTCACAAAGAAGCCGT-1	A
GTCACAAAGAAGGGCG-1	A
GTCACAAAGAATACTG-1	G
GTCACAAAGAGGAAGT-1	A
GTCACAAAGAGGAATG-1	G
GTCACAAAGGGTTCCC-1	G
GTCACAAAGGTGTCGA-1	G
GTCACAAAGTACGACG-1	G
GTCACAACAACTACTG-1	G
GTCACAACAGAATGCG-1	A
GTCACAAGTAAAGGCC-1	A
GTCACAAGTAACCATC-1	A
GTCACAAGTCAGGCTC-1	G
GTCACAAGTCGAGGTA-1	G
GTCACAATCAGGATCT-1	A
GTCACAATCCACACCT-1	G
GTCACAATCCTGGGAC-1	G
GTCACAATCGCTTACC-1	A
GTCACAATCGGTCAGC-1	A
GTCACCTAGGTCGGTA-1	A
GTCACCTAGGTTACAA-1	A
GTCACCTCACTTGCGG-1	G
GTCACCTGTCATAGCT-1	A
GTCACCTGTGTGTGCC-1	A
GTCACCTGTTCTTAGG-1	A
GTCACCTTCTCTGCGT-1	G
GTCACCTTCTGTGTCC-1	G
GTCACGGAGACAGCTG-1	A
GTCACGGAGATCTCAC-1	A
GTCACGGAGCTGGAGT-1	G
GTCACGGAGTGAACCG-1	A
GTCACGGCACAGTTAC-1	A
GTCACGGCATCATGTG-1	A
GTCACGGCATCGGCCA-1	A
GTCACGGGTGTGTGCC-1	G
GTCACGGTCTTCAGAG-1	A
GTCACTCAGAAATTCG-1	G
GTCACTCAGACGTCAG-1	G
GTCACTCAGATTCCGT-1	A
GTCACTCAGGCTCAGA-1	G
GTCACTCAGGTAAGTT-1	G
GTCACTCAGTTACCAC-1	G
GTCACTCCAAGCACTT-1	A
GTCACTCCACACATGT-1	A
GTCACTCCAGTATACC-1	A
GTCACTCCATAGGCGA-1	A
GTCACTCCATCGCTAA-1	A
GTCACTCGTAGACGCA-1	A
GTCACTCGTATTCACG-1	G
GTCACTCGTCCTTATT-1	G
GTCACTCGTGAATGTA-1	A
GTCACTCGTGGAAAGA-1	A
GTCACTCGTGTGAGGT-1	A
GTCACTCGTTAGGCTT-1	G
GTCACTCGTTTCTACT-1	G
GTCACTCTCAAGGCCC-1	G
GTCACTCTCACTGATG-1	G
GTCACTCTCCACACCT-1	G
GTCACTCTCCTGGAAT-1	A
GTCACTCTCGTGGAAG-1	A
GTCACTCTCTCTGACC-1	G
GTCACTCTCTTAGTGG-1	G
GTCCATCAGCAGAATT-1	G
GTCCATCAGTAGTTCC-1	A
GTCCATCAGTCCCTCT-1	A
GTCCATCCAAGCACTT-1	G
GTCCATCCAGTATCTG-1	A
GTCCATCGTAACGGAC-1	G
GTCCATCGTCCCTTTG-1	A
GTCCATCGTGGTACTT-1	A
GTCCATCGTGTGTGCC-1	A
GTCCATCGTTAGAGAT-1	A
GTCCATCGTTCAGTAC-1	G
GTCCATCGTTCTTTGT-1	A
GTCCATCGTTTAGAAG-1	G
GTCCATCTCAAGTTGC-1	A
GTCCATCTCCATCATT-1	A
GTCCATCTCCCAATGA-1	G
GTCCATCTCCCTACCA-1	A
GTCCATCTCCTCCTGA-1	A
GTCCATCTCGTCGCAG-1	G
GTCGTAAAGAACCCGA-1	G
GTCGTAAAGACCTATC-1	A
GTCGTAAAGAGCTGTG-1	A
GTCGTAAAGCCTGTAT-1	A
GTCGTAACAACTGCGC-1	G
GTCGTAACAATTGTGC-1	A
GTCGTAACACGTTACA-1	G
GTCGTAAGTATCTAGC-1	A
GTCGTAATCATTCTTG-1	A
GTCGTAATCCCAATGA-1	G
GTCGTAATCGAGTTAC-1	G
GTCGTAATCTCGACAA-1	G
GTCGTAATCTGCTACC-1	A
GTCTACCAGAGAATTC-1	G
GTCTACCAGCCTATAC-1	A
GTCTACCAGCTCCGGT-1	G
GTCTACCAGGTCTTTG-1	A
GTCTACCCACGCTCAG-1	A
GTCTACCCACTCAAGT-1	A
GTCTACCCAGTAGGCA-1	G
GTCTACCCATAGCCAT-1	G
GTCTACCCATCCCTCA-1	A
GTCTACCCATGCCTTC-1	A
GTCTACCCATGGGAAC-1	A
GTCTACCGTACAAGCG-1	G
GTCTACCGTCTAAGAA-1	G
GTCTACCGTGCCCAGT-1	G
GTCTACCTCGCTTCAC-1	A
GTGACATAGCAGGAGG-1	A
GTGACATAGCGTCTGC-1	A
GTGACATAGGGAAGCG-1	A
GTGACATAGTCAGGAC-1	A
GTGACATGTAGAAAGG-1	A
GTGACATGTATGCTAC-1	A
GTGACATTCCTCCTGA-1	A
GTGACATTCGCGGCAT-1	G
GTGATCAAGTTCAGGG-1	G
GTGATCACAACTCCCT-1	G
GTGATCACAATGTAAG-1	A
GTGATCACATCCGTAA-1	G
GTGATCAGTCCCTTTG-1	A
GTGATCAGTCGAGGTA-1	A
GTGATCAGTGCCCAGT-1	G
GTGATCAGTTGGTAAA-1	G
GTGATCATCATGTTCT-1	G
GTGATCATCCAGTTAG-1	G
GTGCACGAGCAGAATT-1	A
GTGCACGCAGGTCTGC-1	G
GTGCACGCATTTAGGC-1	A
GTGCACGGTAGCCATT-1	A
GTGCACGGTCTCGGGT-1	A
GTGCACGGTTACCCAA-1	A
GTGCACGGTTCATTTC-1	G
GTGCACGTCCACGCTT-1	A
GTGCACGTCCGATTGA-1	A
GTGCACGTCGTGGTAT-1	A
GTGCCAGAGAGGAATG-1	A
GTGCCAGAGTCCTTCC-1	A
GTGCCAGCAACGGGTA-1	A
GTGCCAGCATGGGAAC-1	A
GTGCCAGGTAGACACG-1	G
GTGCCAGGTCCATTGA-1	G
GTGCCAGGTGGTAGAC-1	G
GTGCCAGGTGTACGCC-1	A
GTGCCAGTCAAACCCA-1	G
GTGCCAGTCAGAATGA-1	A
GTGCCAGTCCATCATT-1	A
GTGCCAGTCCCGTATC-1	A
GTGCCAGTCTTGTCGC-1	A
GTGCTGGAGCAGTAGC-1	G
GTGCTGGAGGAGTACC-1	A
GTGCTGGAGGCAGTAC-1	G
GTGCTGGAGGGAAATG-1	A
GTGCTGGAGGGTGTTG-1	G
GTGCTGGGTACCCACG-1	A
GTGCTGGGTACTTCAG-1	A
GTGCTGGGTGGTCGAA-1	A
GTGCTGGGTGTCGTCG-1	A
GTGCTGGGTTTGTACG-1	A
GTGCTGGTCCGCCTAT-1	G
GTGCTGGTCGCCGAAC-1	G
GTGCTGGTCTCGCGGA-1	A
GTGCTGGTCTTATCAC-1	A
GTGGATTAGAGCCTGA-1	A
GTGGATTCACGTTACA-1	A
GTGGATTCAGACTAAA-1	G
GTGGATTCAGATTAAG-1	A
GTGGATTCATAGCCAT-1	G
GTGGATTGTACAAATG-1	A
GTGGATTGTAGGTCTT-1	G
GTGGATTGTCTGTGTA-1	A
GTGGATTGTGTGACCC-1	A
GTGGATTGTTCTACCC-1	A
GTGGATTTCAAGAGGC-1	G
GTGGATTTCAAGTTGC-1	G
GTGGATTTCATCGCCT-1	G
GTGGATTTCGCATAAC-1	G
GTGGATTTCGCTCGGA-1	A
GTGGATTTCGGATAAA-1	G
GTGGCGTAGAGGAAGT-1	A
GTGGCGTCACAAGGGT-1	A
GTGGCGTCACTCCCAT-1	G
GTGGCGTCAGTAACTC-1	G
GTGGCGTCATCTGCAA-1	G
GTGGCGTGTAACGGCA-1	A
GTGGCGTTCAAACCAC-1	G
GTGGCGTTCATCGCAA-1	G
GTGGCGTTCCCACTAC-1	A
GTGGCGTTCTCTGTTA-1	A
GTGGCGTTCTTGCGCT-1	A
GTGTCAAAGAACCATA-1	G
GTGTCAAAGACAGTGC-1	A
GTGTCAAAGAGCGGTT-1	G
GTGTCAAAGTACCTCA-1	A
GTGTCAAAGTATCTGC-1	A
GTGTCAAAGTCATACC-1	G
GTGTCAACATTCGTCC-1	A
GTGTCAAGTGACGCAA-1	G
GTGTCAATCAATTCCT-1	G
GTGTCAATCCGATTGA-1	G
GTGTCAATCCGGGCAT-1	A
GTGTCCTAGACTTGAA-1	G
GTGTCCTAGAGGCCTA-1	G
GTGTCCTAGCACGTAG-1	A
GTGTCCTAGGCACCTC-1	A
GTGTCCTCAAGGGAGG-1	A
GTGTCCTCACGGTTAT-1	A
GTGTCCTCACTGGGCT-1	G
GTGTCCTCAGAACAGC-1	G
GTGTCCTCAGTTGGAG-1	G
GTGTCCTCATGTATCG-1	G
GTGTCCTGTACATGGG-1	A
GTGTCCTGTCCGCTTT-1	G
GTGTCCTTCACTAGCA-1	G
GTGTGATAGATATGTG-1	A
GTGTGATAGCCGCTGT-1	A
GTGTGATAGGATTAAC-1	A
GTGTGATAGGCCTCTG-1	A
GTGTGATAGTATAGTG-1	A
GTGTGATCAAGCGGTA-1	A
GTGTGATCACTCGTGG-1	A
GTGTGATCATGGCCTG-1	G
GTGTGATCATTGAACC-1	G
GTGTGATGTAACATAG-1	G
GTGTGATTCTACTTTG-1	A
GTTACGAAGCAGGAGG-1	A
GTTACGAAGCCATGGA-1	G
GTTACGAAGGCAAGCT-1	A
GTTACGAAGTGAGTTA-1	G
GTTACGAAGTTAGAGT-1	G
GTTACGACAACCTCCT-1	G
GTTACGACAACGAGGT-1	A
GTTACGACATGCGCTG-1	A
GTTACGAGTCGTCGCA-1	G
GTTACGAGTCTAACCA-1	G
GTTACGAGTTCCAATG-1	A
GTTACGATCCGCGATG-1	G
GTTACGATCGCAAACT-1	G
GTTACTTAGAGAAGCA-1	A
GTTACTTAGAGGTACC-1	G
GTTACTTAGGAGTCTG-1	A
GTTACTTAGGCGTCCT-1	G
GTTACTTCAAGATTAG-1	A
GTTACTTGTAGGGTCA-1	G
GTTACTTGTCCAAGAG-1	A
GTTACTTGTTACACTG-1	A
GTTACTTTCCGAATTG-1	G
GTTACTTTCGCGGCAT-1	G
GTTACTTTCGGGACAA-1	G
GTTATGGAGAAAGCAG-1	A
GTTATGGAGTCATACC-1	A
GTTATGGCAACGCAAG-1	A
GTTATGGCACTGATTG-1	G
GTTATGGCATGCCTTC-1	G
GTTATGGCATGGAGGT-1	G
GTTATGGGTACGTAAA-1	A
GTTATGGGTATTCTGG-1	G
GTTATGGGTGGTAGAC-1	A
GTTATGGGTTTGTCTT-1	G
GTTATGGTCAAAGTAG-1	G
GTTATGGTCAGCACGC-1	G
GTTATTCAGCCTGTAT-1	G
GTTATTCAGTGCTCGC-1	A
GTTATTCAGTGTCGCC-1	A
GTTATTCCAATTCAGC-1	A
GTTATTCCAGTTACAC-1	A
GTTATTCCATTTCACT-1	A
GTTATTCGTATACGCT-1	A
GTTATTCGTCCAAGAG-1	A
GTTATTCTCCTCCCAA-1	G
GTTATTCTCGCGATGC-1	G
GTTATTCTCGTGAGTT-1	A
GTTCAAGAGAGCACTG-1	A
GTTCAAGAGCAGGACT-1	A
GTTCAAGCAGGACTGA-1	A
GTTCAAGCATAGTCCA-1	A
GTTCAAGCATCACAAC-1	A
GTTCAAGGTTTAGACC-1	G
GTTCAAGGTTTAGGAA-1	G
GTTCAAGTCCATCATT-1	A
GTTCAAGTCGCAGATT-1	G
GTTCAAGTCGGGATCC-1	A
GTTGGGCAGATCGATA-1	A
GTTGGGCAGCTGAGGT-1	A
GTTGGGCAGGCAAGCT-1	G
GTTGGGCCAAACCCTA-1	G
GTTGGGCCACTAGCCG-1	A
GTTGGGCCACTCAAGT-1	G
GTTGGGCCAGAGTCGA-1	A
GTTGGGCCAGGCAAGT-1	G
GTTGGGCCATGGCCCA-1	A
GTTGGGCGTAACTCCA-1	A
GTTGGGCGTCTGAGCC-1	A
GTTGGGCTCACATCCC-1	G
GTTGGGCTCATTCTTG-1	G
GTTGGGCTCCATCGAA-1	G
GTTGGGCTCTTATCAC-1	A
GTTGGTAAGACAGTGC-1	G
GTTGGTAAGAGAGGTA-1	A
GTTGGTAAGCATTCCA-1	G
GTTGGTAAGCGTGTTT-1	A
GTTGGTAAGGGCTCTC-1	G
GTTGGTAAGGTTAGTA-1	G
GTTGGTACACCTCGTT-1	G
GTTGGTACAGCAACGA-1	G
GTTGGTAGTCAACTAC-1	A
GTTGGTAGTGTCTCGG-1	A
GTTGGTATCACATTCT-1	A
GTTGGTATCGCTGATA-1	A
GTTGGTATCGGTGATT-1	A
GTTGGTATCTACTGCC-1	A
TAAACCGAGAACAGGA-1	A
TAAACCGAGATTGACA-1	A
TAAACCGAGGATTTGA-1	G
TAAACCGAGTTCAGGG-1	A
TAAACCGCAAATGCTC-1	A
TAAACCGCAGTCAGCC-1	G
TAAACCGGTACTAGAA-1	G
TAAACCGGTCGCTAGC-1	A
TAAACCGGTTCAGTTG-1	A
TAAACCGGTTGCAGAG-1	G
TAAACCGTCAAGTTGC-1	A
TAAACCGTCTACATCT-1	A
TAACAGCAGATCACCT-1	A
TAACAGCAGCACACCC-1	A
TAACAGCAGCTGCCAC-1	G
TAACAGCAGGTAGGAA-1	A
TAACAGCAGTGAGTTA-1	A
TAACAGCCACTGATAC-1	A
TAACAGCCAGGCAAGT-1	G
TAACAGCCATTGAACC-1	A
TAACAGCGTACCAAGG-1	A
TAACAGCGTTAGGAGC-1	A
TAACAGCGTTTCGATG-1	G
TAACAGCTCAGGAATA-1	A
TAACAGCTCAGGTCTA-1	A
TAACAGCTCGGTTGTA-1	A
TAACAGCTCTGAAAGA-1	A
TAACGGTAGTAATGTG-1	A
TAACGGTCATCCTGGG-1	A
TAACGGTGTATCTAGC-1	A
TAACGGTGTATCTCAG-1	A
TAACGGTGTTCATTTC-1	A
TAACGGTTCCCTATTA-1	G
TAACGGTTCTTCCAGC-1	G
TAACTTCAGGCAAGGG-1	A
TAACTTCAGGTCTTTG-1	A
TAACTTCAGTTCGACT-1	G
TAACTTCCAACGTACT-1	G
TAACTTCCAAGCTTTG-1	G
TAACTTCCACGCGATC-1	A
TAACTTCCAGAGATGC-1	G
TAACTTCCATCACAGT-1	A
TAACTTCGTCGATAGG-1	G
TAACTTCGTTTAAGCC-1	G
TAACTTCTCCATTGTT-1	A
TAACTTCTCTATCCTA-1	A
TAAGCCAAGGGTTCCC-1	A
TAAGCCACAAGCACTT-1	G
TAAGCCACAAGTCCTA-1	G
TAAGCCACAATAGTGA-1	A
TAAGCCACACTACACA-1	G
TAAGCCAGTCTGTTGA-1	A
TAAGCCAGTTGAATAG-1	A
TAAGCCATCGCTAGTA-1	G
TAAGTGCAGATCGATA-1	A
TAAGTGCAGATGTTCC-1	A
TAAGTGCAGCTAGCAG-1	G
TAAGTGCAGCTCCGGT-1	A
TAAGTGCAGGATTGAT-1	A
TAAGTGCAGGGTCCCT-1	G
TAAGTGCAGGTTCTCA-1	G
TAAGTGCAGTTCGTTG-1	A
TAAGTGCCAATGGCTT-1	G
TAAGTGCCACGCGATC-1	A
TAAGTGCCACTGCTCT-1	G
TAAGTGCCACTGTTAG-1	G
TAAGTGCCAGCGTCGT-1	G
TAAGTGCGTGTCCCAG-1	A
TAAGTGCGTTTGGATC-1	A
TAAGTGCTCACGATTG-1	A
TAAGTGCTCAGTACAC-1	A
TAAGTGCTCGAGGTCC-1	A
TAAGTGCTCGGATGTT-1	A
TAAGTGCTCGTGGTAT-1	A
TAATCGGAGGATGTCG-1	A
TAATCGGAGGTGTCGA-1	G
TAATCGGAGTCTTAGC-1	G
TAATCGGCAAATGCTC-1	G
TAATCGGCAACGGACA-1	G
TAATCGGCATGGGAAC-1	A
TAATCGGGTAGGTCTT-1	A
TAATCGGGTTAGCTCA-1	G
TAATCGGTCCACTAGA-1	A
TAATCGGTCCATTGAG-1	G
TAATCGGTCCGTACGG-1	A
TAATCGGTCGTGGAAG-1	A
TAATTCCAGAAAGGGT-1	A
TAATTCCAGACAGTGC-1	A
TAATTCCAGAGCTGTG-1	G
TAATTCCAGCATTGGG-1	A
TAATTCCAGGCCAATG-1	G
TAATTCCAGGCCTAAG-1	G
TAATTCCCACTCGCAG-1	G
TAATTCCCATCAGAAA-1	A
TAATTCCCATGTATCG-1	G
TAATTCCGTAATGTAG-1	G
TAATTCCGTACGTATC-1	A
TAATTCCGTATTCGCA-1	A
TAATTCCGTCATAGAA-1	A
TAATTCCGTCTAACCA-1	G
TAATTCCGTGTTAGAA-1	A
TAATTCCGTTAACTCG-1	G
TAATTCCGTTGGCGAA-1	A
TAATTCCTCACAACAC-1	G
TAATTCCTCCTAAAGC-1	A
TAATTCCTCGAGAACG-1	A
TAATTCCTCGCAAACT-1	A
TAATTCCTCGCAACTA-1	G
TACAGCAAGTCTGCTA-1	G
TACAGCACAACTAGAA-1	A
TACAGCACACCCTTAC-1	G
TACAGCACACCGTCTT-1	A
TACAGCACAGAAAGAG-1	G
TACAGCACAGGATGTG-1	A
TACAGCACAGGTGTCC-1	A
TACAGCACATCAACTG-1	A
TACAGCAGTATCTCAG-1	A
TACAGCAGTGGTTCTA-1	G
TACAGCATCAGTCACA-1	A
TACAGCATCCTCCAGT-1	A
TACAGCATCGCCGAAC-1	A
TACAGCATCGGTTGTA-1	G
TACAGCATCTCGGCGA-1	A
TACATGGAGACTCTTG-1	G
TACATGGAGAGCGGTT-1	A
TACATGGAGCATACCT-1	G
TACATGGAGCTTCAAC-1	A
TACATGGCAAACAGTA-1	G
TACATGGCAATGGCAG-1	A
TACATGGGTAACTGAA-1	G
TACATGGGTACATGGG-1	A
TACATGGGTGGCGCTT-1	G
TACATGGGTTCAGTTG-1	A
TACATGGGTTTCTTAC-1	A
TACATGGTCACATTCT-1	A
TACATGGTCATTCTCA-1	A
TACATGGTCCATATCT-1	A
TACATGGTCCGATTGA-1	G
TACATGGTCGAAGCCC-1	A
TACATGGTCGCTATAG-1	A
TACATGGTCGGTCCGA-1	A
TACATTCAGAAACGCC-1	A
TACATTCAGAATCAAC-1	G
TACATTCAGGATGTCG-1	G
TACATTCAGGCGTCCT-1	G
TACATTCAGGGTATCG-1	A
TACATTCAGTACGACG-1	A
TACATTCAGTAGACCG-1	G
TACATTCCAGTAAGAT-1	A
TACATTCCATGGTAAA-1	A
TACATTCCATTCGTCC-1	A
TACATTCCATTTGTTC-1	A
TACATTCGTAACTCCA-1	A
TACATTCGTATCGCGC-1	A
TACATTCGTGGACGAT-1	A
TACATTCGTTAGTAGA-1	A
TACATTCTCCTGTGGG-1	G
TACATTCTCGATTACG-1	A
TACATTCTCGGCATAT-1	G
TACATTCTCGGGAAAC-1	G
TACCCTGAGATTAGAC-1	A
TACCCTGAGCAGTAGC-1	A
TACCCTGAGGATCCTT-1	A
TACCCTGAGTACCCAT-1	G
TACCCTGCAAGCCAGA-1	A
TACCCTGCACAGTTCA-1	A
TACCCTGGTTGGCTTA-1	G
TACCTATAGAACGTCG-1	G
TACCTATAGCTACGTT-1	A
TACCTATAGGACTTTC-1	G
TACCTATAGGTCGGTA-1	A
TACCTATAGTAATGTG-1	G
TACCTATAGTGCCCTG-1	A
TACCTATAGTTCAGGG-1	G
TACCTATCACATATCG-1	G
TACCTATCACCAAGGA-1	A
TACCTATCACGACGAA-1	A
TACCTATCACGTTAGT-1	G
TACCTATCAGAGCCAA-1	A
TACCTATGTGAGTCGA-1	A
TACCTATGTGCAAGCA-1	A
TACCTATGTTGGAGGT-1	A
TACCTATGTTTGCGAT-1	A
TACCTATTCAAGAGAT-1	A
TACCTATTCCGATGCG-1	A
TACCTATTCCGTCAAA-1	A
TACCTATTCGAGGCTC-1	A
TACCTATTCGATAGGG-1	A
TACCTATTCTACCCGT-1	A
TACCTATTCTGTCGGG-1	A
TACCTCGAGATGTTCC-1	A
TACCTCGAGGAAGAAC-1	A
TACCTCGCAACAAACA-1	G
TACCTCGCACCGTTGG-1	A
TACCTCGCAGGGCTTC-1	A
TACCTCGGTAACTCCA-1	G
TACCTCGGTAGGTCTT-1	A
TACCTCGGTCATAGCT-1	G
TACCTCGGTCGAGGTA-1	A
TACCTCGGTTCCCTTG-1	A
TACCTCGGTTCTTTGT-1	A
TACCTCGGTTGCAGCC-1	A
TACCTCGTCACTGATG-1	A
TACCTCGTCATTCGGA-1	A
TACCTCGTCCATAACG-1	A
TACCTCGTCCGGAAAG-1	A
TACCTCGTCGGTCGAC-1	A
TACCTCGTCTCAGATG-1	G
TACCTCGTCTTCCGTG-1	A
TACGCAAAGACTCGGA-1	A
TACGCAAAGATCCGAG-1	G
TACGCAAAGCAGAATT-1	A
TACGCAACAAACAGTA-1	A
TACGCAACAAGCGGTA-1	G
TACGCAACAATTCGTG-1	G
TACGCAACATCGGCCA-1	G
TACGCAAGTTTAGGAA-1	A
TACGCAATCGGCAATT-1	A
TACGCAATCTCCCTTT-1	A
TACGCCTAGTAGAAGG-1	A
TACGCCTCAACATAAG-1	G
TACGCCTCACCAAGGA-1	G
TACGCCTCACTCGGAC-1	G
TACGCCTCATAGGCGA-1	A
TACGCCTCATCGACCG-1	G
TACGCCTCATGCGCTG-1	A
TACGCCTCATTCGTCC-1	G
TACGCCTGTTCCGGCA-1	A
TACGCCTGTTTCACCC-1	A
TACGCCTTCACCCGGA-1	G
TACGCCTTCAGCCGGT-1	G
TACGCCTTCATTGCCC-1	G
TACGCCTTCTATCTTG-1	G
TACGGATAGAAGGGCG-1	A
TACGGATAGACAGTGC-1	G
TACGGATAGAGAAGCA-1	A
TACGGATAGCATTCCA-1	G
TACGGATAGCCTTTGA-1	A
TACGGATAGCTTACCA-1	A
TACGGATAGGTAGGCT-1	A
TACGGATAGGTTGTTC-1	G
TACGGATAGTCATACC-1	G
TACGGATCAAAGGCCA-1	G
TACGGATCAAGACTTC-1	A
TACGGATCACCTGAAT-1	A
TACGGATCATTGTGAC-1	A
TACGGATCATTGTTCT-1	A
TACGGATGTAGTGATA-1	A
TACGGATGTATTCTCT-1	A
TACGGATGTCAACTAC-1	G
TACGGATGTCCCTTTG-1	G
TACGGATGTGCCAAGA-1	A
TACGGATGTTTAGACC-1	A
TACGGATTCAACACGT-1	A
TACGGATTCCGCTCTA-1	A
TACGGATTCGCTCTAC-1	A
TACGGATTCGTCCCTA-1	G
TACGGATTCTCTGCGT-1	G
TACGGATTCTGAGTAC-1	G
TACTAGGAGAAACGCC-1	A
TACTAGGAGGGAAATG-1	A
TACTAGGAGGGAAGCG-1	A
TACTAGGAGGTCACTT-1	G
TACTAGGAGTAGACCG-1	G
TACTAGGAGTCTCGAT-1	A
TACTAGGCACAGCTTA-1	G
TACTAGGCAGAGATGC-1	G
TACTAGGCATATACGC-1	G
TACTAGGCATCCGTAA-1	A
TACTAGGCATTCTTTG-1	G
TACTAGGGTCTAAAGA-1	A
TACTAGGGTGGTAAGC-1	A
TACTAGGTCAAGGCCC-1	A
TACTAGGTCAAGTTGC-1	G
TACTAGGTCAATTGGC-1	G
TACTAGGTCAGTGGTT-1	A
TACTAGGTCCGGACTG-1	A
TACTAGGTCGCTAGTA-1	G
TACTAGGTCTAGCTGA-1	A
TACTCGCAGAAATGGG-1	A
TACTCGCCAATGTGCT-1	G
TACTCGCCACTCAGCG-1	A
TACTCGCCACTTACAG-1	G
TACTCGCGTCTGGGCT-1	A
TACTCGCGTGGTAGAC-1	G
TACTCGCTCAGTCAAC-1	A
TACTCGCTCGGGAATG-1	A
TACTGCCAGAAGGGCG-1	A
TACTGCCAGAGAGGTA-1	G
TACTGCCAGTAGTCGG-1	A
TACTGCCAGTGCAACG-1	A
TACTGCCCAAGGCTTT-1	G
TACTGCCCAATGTGCT-1	G
TACTGCCCACTCGTGG-1	A
TACTGCCGTGAATCGG-1	A
TACTGCCGTGGCCTTG-1	G
TACTGCCGTGTCCAGC-1	G
TACTGCCGTGTCTACA-1	G
TACTGCCGTTCCGCGA-1	G
TACTGCCGTTGTGACT-1	A
TACTGCCGTTGTGAGG-1	A
TACTGCCTCACCCGGA-1	G
TACTGCCTCAGGAAGC-1	G
TACTGCCTCGCAAACT-1	G
TACTGCCTCGCACCTT-1	G
TACTGCCTCGCGATGC-1	A
TACTGCCTCGCTCGGA-1	A
TACTGCCTCTCATCCG-1	G
TAGACTGAGGGTAATT-1	A
TAGACTGAGGTAAGTT-1	G
TAGACTGAGTGCTAGG-1	G
TAGACTGCAGTAACCT-1	G
TAGACTGCAGTAAGAT-1	G
TAGACTGGTATTCTCT-1	A
TAGACTGTCCTGAAAC-1	A
TAGACTGTCGACCCGA-1	A
TAGACTGTCTCGCGGA-1	A
TAGACTGTCTCTTCTC-1	G
TAGCACAAGCCAGAAC-1	A
TAGCACACAGCACATT-1	G
TAGCACACAGCTGATT-1	G
TAGCACACATAGATAG-1	G
TAGCACAGTATTGTCG-1	G
TAGCACAGTCAGCTTA-1	G
TAGCACAGTCCGGTAC-1	A
TAGCACAGTTCTGAGT-1	G
TAGCACATCAAACCCA-1	G
TAGCACATCAGAGTGG-1	G
TAGCACATCCAGGTCG-1	A
TAGCACATCTGTGTGA-1	A
TAGCATGAGAGCAGCT-1	G
TAGCATGAGGTCGGTA-1	G
TAGCATGCAGGATAGC-1	A
TAGCATGCAGTATCTG-1	A
TAGCATGGTAGTGATA-1	A
TAGCATGGTGCTTACA-1	A
TAGCATGGTTGTCGGC-1	G
TAGCATGTCCCAATAG-1	A
TAGCATGTCCCTAAAG-1	G
TAGCATGTCGTAGCGC-1	A
TAGCATGTCTAGCAAC-1	G
TAGCATGTCTATATCC-1	A
TAGCATGTCTCTGACC-1	G
TAGCCCTAGATGAGGA-1	G
TAGCCCTAGCACCATT-1	G
TAGCCCTAGTTCAGGG-1	A
TAGCCCTCACAACGGA-1	A
TAGCCCTCATATACGC-1	A
TAGCCCTGTTCTGAGT-1	G
TAGCCCTTCGGGAAAC-1	A
TAGCCCTTCGTCCCTA-1	G
TAGCCCTTCTGATCCC-1	A
TAGCCCTTCTTCATAC-1	G
TAGCCGGAGACTAGGC-1	A
TAGCCGGAGCGTTAGG-1	A
TAGCCGGAGGCCTCGT-1	G
TAGCCGGCACAGCTTA-1	A
TAGCCGGGTCCCTAAA-1	G
TAGCCGGGTTTCTACT-1	A
TAGCCGGTCGTGCTGG-1	A
TAGCGGCAGAACAGGA-1	A
TAGCGGCAGCAATGTA-1	A
TAGCGGCAGCAGAATT-1	A
TAGCGGCCAATTCAGC-1	A
TAGCGGCCACCACAGC-1	G
TAGCGGCCACTTACAG-1	A
TAGCGGCCAGGGAGTT-1	G
TAGCGGCCAGGTAGCA-1	G
TAGCGGCCAGGTCTGC-1	G
TAGCGGCCATCCTGGG-1	A
TAGCGGCGTAACTCCA-1	G
TAGCGGCGTCAGTGTT-1	A
TAGCGGCGTCATGAGG-1	A
TAGCGGCGTGGACAGT-1	A
TAGCGGCGTTCACGTA-1	A
TAGCGGCTCGGAAAGC-1	G
TAGCGGCTCTCGGCGA-1	G
TAGCTTTAGCAATGTA-1	G
TAGCTTTAGGCGTAGT-1	A
TAGCTTTAGGGATCCA-1	A
TAGCTTTAGGTTTCTG-1	G
TAGCTTTCAAGCGAAC-1	A
TAGCTTTCAATACTGC-1	A
TAGCTTTGTAAACGTA-1	G
TAGCTTTGTAGAACGC-1	G
TAGCTTTGTAGCGTTT-1	A
TAGCTTTTCCGTGCAG-1	G
TAGGAGGAGAACTAAC-1	G
TAGGAGGAGCGTGTTT-1	G
TAGGAGGAGGAAGACA-1	A
TAGGAGGAGTACTCTG-1	G
TAGGAGGCAACATAAG-1	G
TAGGAGGCACAGGAAC-1	G
TAGGAGGCACCCTTAC-1	G
TAGGAGGCACTCCTCA-1	A
TAGGAGGGTAAACGAT-1	A
TAGGAGGGTAAAGCTA-1	A
TAGGAGGGTACTAGAA-1	A
TAGGAGGGTCAGCTTA-1	G
TAGGAGGGTTCCGGCA-1	G
TAGGAGGGTTTAAGCC-1	G
TAGGAGGTCAGAGTGG-1	G
TAGGAGGTCCATAGGT-1	G
TAGGAGGTCCTGGGAC-1	A
TAGGAGGTCGGAGTTT-1	A
TAGGAGGTCTTCCAGC-1	A
TAGGTCAAGATCTAAG-1	A
TAGGTCAAGGAGTCTG-1	G
TAGGTCACAAGGGTAC-1	A
TAGGTCACAATTCAGC-1	G
TAGGTCACAGGGTAAC-1	G
TAGGTCACATATACGC-1	A
TAGGTCACATCTCACC-1	G
TAGGTCACATGGTTTG-1	A
TAGGTCAGTTACCCAA-1	A
TAGGTCATCAAGAGGC-1	G
TAGGTGTAGAGGCGGA-1	A
TAGGTGTAGCGCACAA-1	A
TAGGTGTCAATTCTCT-1	A
TAGGTGTCACGATTAC-1	G
TAGGTGTCACTGTAAC-1	G
TAGGTGTGTCCAGACC-1	A
TAGGTGTGTGCGTAGA-1	A
TAGGTGTGTGGACAGT-1	A
TAGGTGTGTTGTGACT-1	G
TAGGTGTGTTTCACCC-1	A
TAGGTGTTCAGGAATA-1	A
TAGTCCCAGAATCAGT-1	A
TAGTCCCAGACCGCAA-1	A
TAGTCCCAGCCGCTGT-1	A
TAGTCCCAGGTAGGAA-1	A
TAGTCCCAGTATACGA-1	G
TAGTCCCAGTCCCGCA-1	A
TAGTCCCAGTCTCGAT-1	G
TAGTCCCCAAGGTTCT-1	A
TAGTCCCCAATACTGC-1	A
TAGTCCCCAATCATCG-1	G
TAGTCCCCACACATGT-1	A
TAGTCCCGTAACTGAA-1	A
TAGTCCCGTCATAGAA-1	A
TAGTCCCGTCTTAGCA-1	G
TAGTCCCGTGTTTCTT-1	A
TAGTCCCGTTCTGAGT-1	A
TAGTCCCGTTTCCACC-1	A
TAGTCCCTCGATAGCT-1	A
TAGTCCCTCTGCGTCT-1	G
TATCGAGAGACCATAA-1	G
TATCGAGAGAGGTGGG-1	A
TATCGAGAGCCCATGC-1	G
TATCGAGAGTCGTATC-1	G
TATCGAGCAAACCTAC-1	A
TATCGAGCAATGCATC-1	A
TATCGAGCACGATTAC-1	A
TATCGAGGTATCCCTC-1	G
TATCGAGGTGCGTTTA-1	G
TATCGAGTCAGGAATA-1	A
TATCGAGTCATTGCCC-1	A
TATCGAGTCCCTATTA-1	A
TATCGAGTCGCCACTT-1	G
TATCGAGTCGCGCCAA-1	A
TATCGAGTCTGGTACA-1	A
TATCGAGTCTTCTTCC-1	G
TATCTGTAGCCATGGA-1	A
TATCTGTAGCGTTGCC-1	A
TATCTGTAGGAGTCTG-1	A
TATCTGTAGGCTTCGC-1	G
TATCTGTAGTGTCGGA-1	G
TATCTGTCAATTCGTG-1	A
TATCTGTCACAAACAA-1	A
TATCTGTCACCGTCTT-1	G
TATCTGTCACTCAAGT-1	A
TATCTGTCAGAACAGC-1	A
TATCTGTCAGTAGGCA-1	G
TATCTGTGTACTTCAG-1	A
TATCTGTGTGCTTACA-1	G
TATCTGTGTTAGCTCA-1	G
TATCTGTGTTGAATAG-1	A
TATCTGTTCAAGGCCC-1	G
TATCTGTTCCCACGGA-1	A
TATCTGTTCCCACTTG-1	G
TATCTGTTCCGTCAAA-1	A
TATCTGTTCGAGCGCT-1	G
TATCTGTTCGGTTGTA-1	A
TATGTGGAGATGTTGA-1	A
TATGTGGAGCCGCTGT-1	A
TATGTGGAGCCTATAC-1	G
TATGTGGAGTAATGTG-1	A
TATGTGGAGTTCTCCC-1	A
TATGTGGAGTTGACAA-1	A
TATGTGGAGTTTACGC-1	A
TATGTGGCAATTCGTG-1	A
TATGTGGCACATAAAG-1	A
TATGTGGCATTTGGCA-1	A
TATGTGGGTACGAGAC-1	G
TATGTGGGTAGTACAA-1	G
TATGTGGGTGCACTTA-1	A
TATGTGGGTTCGGGAA-1	A
TATGTGGGTTTGATCG-1	G
TATGTGGTCAGCACTA-1	G
TATGTGGTCCAATAGC-1	A
TATGTGGTCCCACGGA-1	A
TATGTGGTCGCAAACT-1	G
TATGTGGTCTTGGCCT-1	G
TATGTTCAGACCTATC-1	G
TATGTTCAGGCCTCGT-1	G
TATGTTCAGTACAGAT-1	A
TATGTTCAGTAGTGTA-1	G
TATGTTCAGTCCGTGC-1	A
TATGTTCAGTGCAACG-1	G
TATGTTCAGTGCTAGG-1	G
TATGTTCGTAAAGGCC-1	A
TATGTTCGTATCGCGC-1	G
TATGTTCGTCATCGTA-1	G
TATGTTCGTGGGTAGT-1	A
TATGTTCTCACTTACT-1	A
TATGTTCTCCATCATT-1	G
TATGTTCTCGTTGTTT-1	A
TATGTTCTCTTACTCA-1	G
TATGTTCTCTTAGTGG-1	G
TATTGCTAGGAATGGA-1	A
TATTGCTAGTGCAACG-1	G
TATTGCTAGTGTCGGA-1	A
TATTGCTCACTGATAC-1	A
TATTGCTCAGATTTGC-1	A
TATTGCTCAGGGTACA-1	A
TATTGCTCATGGATGG-1	A
TATTGCTCATTGATGC-1	A
TATTGCTGTGTGTGTT-1	A
TATTGCTTCCATAGGT-1	A
TATTGCTTCCATCATT-1	A
TCAAAGCAGACGTCAG-1	A
TCAAAGCAGCGCACAA-1	A
TCAAAGCAGGATTGAT-1	G
TCAAAGCCACCGATCG-1	G
TCAAAGCGTTCACGTA-1	A
TCAAAGCGTTTCACCC-1	G
TCAAAGCTCTTCCGTG-1	G
TCAAGACAGAACCCGA-1	G
TCAAGACAGACGCCCT-1	A
TCAAGACAGCGTAGCA-1	A
TCAAGACAGCGTATCT-1	G
TCAAGACAGTCTCCAA-1	G
TCAAGACCAAATTGAG-1	G
TCAAGACCACATCATG-1	G
TCAAGACCATGGCCTG-1	A
TCAAGACGTAATGCAA-1	A
TCAAGACGTAATGCCT-1	A
TCAAGACGTAGCGTTT-1	A
TCAAGACGTATGTCCA-1	A
TCAAGACGTCCACCAG-1	A
TCAAGACGTCCGTAGC-1	A
TCAAGACGTGAATCAA-1	A
TCAAGACGTTAGGAGC-1	G
TCAAGACTCACTGGTA-1	G
TCAAGCAAGACACTTC-1	A
TCAAGCAAGATGGGAA-1	G
TCAAGCAAGGAGTCTG-1	A
TCAAGCAAGGCAGATC-1	A
TCAAGCAAGTGCTAGG-1	A
TCAAGCACAAGCCCTG-1	G
TCAAGCACAGAATGCG-1	A
TCAAGCAGTTGCAGAG-1	A
TCAAGCAGTTTCACCC-1	A
TCAAGCATCAAGTTGC-1	A
TCAAGCATCAGGAAGC-1	A
TCAAGCATCGGGAATG-1	A
TCAAGCATCTTACGGA-1	A
TCAAGGTAGAAGGGCG-1	A
TCAAGGTAGACTTCCA-1	G
TCAAGGTAGGAATGGA-1	G
TCAAGGTAGTTGCCGC-1	G
TCAAGGTCAAATGCTC-1	A
TCAAGGTCAGATAAGT-1	G
TCAAGGTCAGGCAAGT-1	A
TCAAGGTCATCCATAG-1	G
TCAAGGTCATTCGTCC-1	A
TCAAGGTGTATTCTCT-1	A
TCAAGGTGTTAGGCTT-1	G
TCAAGGTTCCACTAGA-1	G
TCAAGGTTCCAGAGAG-1	A
TCAAGGTTCGCACCTT-1	A
TCAAGGTTCTATTTCG-1	A
TCAAGGTTCTCGCGGA-1	A
TCAATTCAGAAACGCC-1	A
TCAATTCAGCCTTTGA-1	A
TCAATTCAGGGAGTTC-1	A
TCAATTCAGGTGAACC-1	A
TCAATTCAGTACCACT-1	A
TCAATTCAGTCTGTGT-1	A
TCAATTCAGTGCTCGC-1	A
TCAATTCCAACGCAAG-1	A
TCAATTCCAAGTCTCA-1	A
TCAATTCCAGTAACTC-1	A
TCAATTCGTAACGGCA-1	G
TCAATTCGTAGTAACA-1	A
TCAATTCGTCAACGGA-1	A
TCAATTCGTCAACTAC-1	A
TCAATTCGTCAATCCA-1	A
TCAATTCTCAATCGTG-1	A
TCAATTCTCACTAGGT-1	G
TCAATTCTCGTCCCTA-1	A
TCAATTCTCTCGGCGA-1	G
TCACAAGAGACCATAA-1	G
TCACAAGAGCTATCGT-1	G
TCACAAGAGCTGCTCG-1	A
TCACAAGAGGCCTCGT-1	G
TCACAAGAGTTAGCAA-1	A
TCACAAGAGTTGCTTG-1	A
TCACAAGCAAACCTAC-1	G
TCACAAGGTAGCTGTT-1	G
TCACAAGTCAGTCACA-1	A
TCACAAGTCCCACTAC-1	A
TCACAAGTCCCAGTAA-1	A
TCACAAGTCCGCTCTA-1	G
TCACAAGTCCGGCGAT-1	G
TCACAAGTCCTCCAGT-1	A
TCACAAGTCTTCAGAG-1	G
TCACAGAAGAACGACC-1	G
TCACAGAAGGTTAGTA-1	G
TCACAGAAGTGAACCG-1	A
TCACAGAAGTGTCGCC-1	A
TCACAGACACAAACGG-1	A
TCACAGACAGAAAGAG-1	A
TCACAGACAGAGAGAA-1	A
TCACAGACAGCTATAC-1	G
TCACAGACAGGCTACC-1	A
TCACAGACATGCGACC-1	G
TCACAGACATGTAGAA-1	A
TCACAGAGTACATGGG-1	G
TCACAGAGTGAGGGTT-1	G
TCACAGAGTTAGGCTT-1	G
TCACAGATCGGTTCCT-1	A
TCACAGATCTATACCT-1	A
TCACCACAGAACCCGA-1	G
TCACCACAGAGAAGCA-1	A
TCACCACAGAGAGGTA-1	A
TCACCACAGCAATAAC-1	G
TCACCACAGTAACTCC-1	A
TCACCACAGTACAGAT-1	G
TCACCACAGTGTCGCC-1	G
TCACCACAGTTTGGAA-1	A
TCACCACCAACATAAG-1	A
TCACCACCACTCAAGT-1	G
TCACCACCATATACGC-1	G
TCACCACCATCCCGGA-1	G
TCACCACCATTTGGCA-1	G
TCACCACGTGCATTGT-1	G
TCACCACTCAAACCAC-1	A
TCACCACTCACAACAC-1	A
TCACCACTCACTCGGG-1	G
TCACCACTCAGATACC-1	G
TCACCACTCATTCTCA-1	A
TCACCACTCCCGAAGC-1	A
TCACCACTCGAGGCTC-1	A
TCACCACTCTCGTAGA-1	G
TCACCTGAGAATACTG-1	G
TCACCTGAGATCGCCC-1	A
TCACCTGCAATGATGA-1	G
TCACCTGCATACTGCA-1	G
TCACCTGGTACGAGAC-1	G
TCACCTGGTCACCCGA-1	A
TCACCTGGTCTGGATT-1	A
TCACCTGGTCTGTGTA-1	A
TCACCTGGTGCTTACA-1	A
TCACCTGTCAAGAGAT-1	A
TCACCTGTCCCAGTAA-1	A
TCACCTGTCGCAAACT-1	G
TCACCTGTCGGAGTTT-1	G
TCACTCGAGATATGTG-1	A
TCACTCGAGCTAACAA-1	G
TCACTCGAGGTCCTCG-1	G
TCACTCGCAATGATGA-1	G
TCACTCGCAGCGTGAA-1	A
TCACTCGCATCGCCTT-1	G
TCACTCGGTATCCTTT-1	A
TCACTCGGTCAGGCTC-1	G
TCACTCGGTCCGCTTT-1	A
TCACTCGGTCCTTATT-1	G
TCACTCGGTTGCCGCA-1	A
TCACTCGTCAGTACAC-1	G
TCACTCGTCATTCTCA-1	G
TCACTCGTCCCGATTC-1	A
TCAGCTCAGGCTTTAC-1	A
TCAGCTCAGGTTCGAG-1	G
TCAGCTCAGTCCCGCA-1	G
TCAGCTCCAACAACTC-1	A
TCAGCTCCAAGACTAA-1	A
TCAGCTCCAAGGATGC-1	G
TCAGCTCCAGCTATAC-1	A
TCAGCTCCATCCATAG-1	A
TCAGCTCGTAACAATG-1	A
TCAGCTCGTCGCGCTA-1	A
TCAGCTCGTGAATCGG-1	A
TCAGCTCGTGCTTACA-1	G
TCAGCTCGTTGCAGAG-1	G
TCAGCTCTCCATAACG-1	G
TCAGCTCTCGCTATAG-1	A
TCAGCTCTCGGATCGC-1	A
TCAGCTCTCTGATCCC-1	G
TCAGGGCAGACAGTGC-1	G
TCAGGGCAGCAGAAAG-1	A
TCAGGGCAGCTGAGGT-1	A
TCAGGGCAGTCCCGCA-1	A
TCAGGGCCACCAAGGA-1	G
TCAGGGCCAGCAATGG-1	A
TCAGGGCCAGGGTACA-1	G
TCAGGGCCAGTAACGG-1	A
TCAGGGCGTAAGTGCG-1	G
TCAGGGCGTCTGCGCA-1	A
TCAGGGCGTGGTAGAC-1	A
TCAGGGCTCACAAGCT-1	G
TCAGGGCTCAGATACC-1	A
TCAGGGCTCAGGCGCT-1	G
TCAGGGCTCCAAACCA-1	G
TCAGGGCTCGCTACCT-1	G
TCAGGGCTCGTGCTTC-1	A
TCAGGTAAGAATACTG-1	G
TCAGGTAAGGATTGAT-1	A
TCAGGTAAGTAGAAGG-1	G
TCAGGTAAGTGAGCAC-1	G
TCAGGTAAGTGATAAC-1	G
TCAGGTACAAGAGATT-1	G
TCAGGTACACCATTCC-1	G
TCAGGTACACTCAAGT-1	G
TCAGGTACAGTAACTC-1	A
TCAGGTACATCATCGA-1	G
TCAGGTACATGGTAAA-1	A
TCAGGTAGTCATAGCT-1	G
TCAGGTAGTGTTGTTG-1	A
TCAGGTAGTTTGTACG-1	A
TCAGGTATCACAAGCT-1	A
TCAGGTATCAGGTCTA-1	A
TCAGGTATCCACCTAC-1	A
TCAGGTATCGACTTAG-1	A
TCAGGTATCGAGCGCT-1	A
TCAGGTATCGATAGCT-1	A
TCAGGTATCGATAGGG-1	A
TCAGGTATCTTCTTCC-1	A
TCAGTCCAGCCTCGCA-1	A
TCAGTCCAGTATGGGC-1	G
TCAGTCCAGTTAGAGT-1	A
TCAGTCCCAACGTCGC-1	A
TCAGTCCCACATTGCA-1	A
TCAGTCCCATACCCGG-1	A
TCAGTCCCATCGGCCA-1	A
TCAGTCCGTTCTGATG-1	G
TCAGTCCGTTTGACCA-1	G
TCAGTCCGTTTGCATG-1	A
TCAGTCCTCCCAGCAG-1	A
TCAGTCCTCGCTTACC-1	G
TCAGTCCTCGGGATCC-1	A
TCAGTCCTCTACATCT-1	G
TCAGTCCTCTCATATC-1	G
TCAGTCCTCTTCCGTG-1	A
TCAGTCCTCTTGTCGC-1	A
TCAGTTTAGCAGAATT-1	G
TCAGTTTAGTATACCC-1	A
TCAGTTTAGTCGTACT-1	G
TCAGTTTCAAGACTTC-1	A
TCAGTTTGTGATAAGT-1	A
TCAGTTTGTTAAGGGC-1	G
TCAGTTTGTTCCAGTA-1	A
TCAGTTTGTTCCCGGA-1	A
TCAGTTTTCCGATGCG-1	G
TCAGTTTTCGTATAGC-1	G
TCCAGAAAGTATCTGC-1	A
TCCAGAAAGTCTGTGT-1	G
TCCAGAACAAGGGTAC-1	G
TCCAGAACACATTGCA-1	A
TCCAGAACACCAAGGA-1	G
TCCAGAACACTGCTTC-1	A
TCCAGAACAGGCATCC-1	G
TCCAGAACAGTCAGCC-1	A
TCCAGAAGTCACAGGA-1	A
TCCAGAAGTCGAGGAT-1	G
TCCAGAATCAAACCAC-1	A
TCCAGAATCCAGGTCG-1	A
TCCAGAATCTAGCTGA-1	A
TCCAGAATCTCCTTAA-1	A
TCCATCGAGAAGAGTG-1	G
TCCATCGAGATTCCGT-1	A
TCCATCGAGGATTGAT-1	A
TCCATCGAGGCTTTAC-1	A
TCCATCGAGGGCTTCC-1	A
TCCATCGAGTAGGTCG-1	G
TCCATCGAGTCGAGCA-1	G
TCCATCGAGTGATAAC-1	A
TCCATCGCAAGGTTCT-1	A
TCCATCGCACATTCTT-1	A
TCCATCGGTTCCAATG-1	G
TCCATCGGTTTGCGAT-1	A
TCCATCGTCAAGGCAG-1	A
TCCATCGTCATCGCAA-1	A
TCCATCGTCCTCTCTT-1	A
TCCATCGTCTACATCT-1	A
TCCATCGTCTCTATCA-1	A
TCCATCGTCTGTGTCC-1	A
TCCCACAAGAAAGGGT-1	A
TCCCACAAGACCTATC-1	A
TCCCACAAGGCATGCA-1	A
TCCCACAAGTCCGGAA-1	A
TCCCACACAAGCGTCC-1	A
TCCCACACAGTAACCT-1	A
TCCCACACAGTCCTGG-1	A
TCCCACAGTCGAGGAT-1	A
TCCCACAGTGATTCCA-1	G
TCCCACAGTTGGACGA-1	A
TCCCACAGTTTAGAAG-1	G
TCCCACATCATTCTTG-1	A
TCCCACATCCTAAAGC-1	A
TCCCACATCCTGTGGG-1	A
TCCCACATCGACGGAA-1	A
TCCCACATCGCAACTA-1	G
TCCCACATCGCACCTT-1	A
TCCCACATCGCCAGAC-1	A
TCCCACATCGTCTTAT-1	G
TCCCACATCTCGCGGA-1	G
TCCCACATCTTACTCA-1	G
TCCGACTAGCGTATCT-1	A
TCCGACTAGGATCCTT-1	G
TCCGACTCATTCACCC-1	A
TCCGACTGTACGACCC-1	A
TCCGACTGTATCCCTC-1	G
TCCGACTGTCACCCGA-1	A
TCCGACTGTGACCAGA-1	A
TCCGACTTCATGAACC-1	A
TCCGACTTCTACATCT-1	G
TCCGACTTCTCTTAAC-1	G
TCGAGCGAGAAATGGG-1	A
TCGAGCGAGAAATTCG-1	G
TCGAGCGAGACAACGC-1	A
TCGAGCGAGATACCAA-1	A
TCGAGCGCAAGACACG-1	A
TCGAGCGCAAGACTTC-1	A
TCGAGCGCAATGCATC-1	G
TCGAGCGCACAGAAGC-1	A
TCGAGCGCACGCTGTG-1	G
TCGAGCGCACTCAAGT-1	G
TCGAGCGCAGTAGTCT-1	A
TCGAGCGCATCGGCTG-1	G
TCGAGCGGTACTAGAA-1	G
TCGAGCGGTAGGGTTG-1	G
TCGAGCGGTCAAACAA-1	A
TCGAGCGGTCGTCGCA-1	A
TCGAGCGGTCTAAGAA-1	A
TCGAGCGGTGCCCAGT-1	A
TCGAGCGGTTGTGACT-1	A
TCGAGCGTCACGATTG-1	G
TCGAGCGTCGACGGAA-1	A
TCGATTTAGCACGTAG-1	A
TCGATTTCAACTACTG-1	G
TCGATTTGTCCTATTT-1	A
TCGATTTGTTTGACCA-1	G
TCGATTTTCGAGGTCC-1	A
TCGATTTTCGGTCCGA-1	G
TCGATTTTCTAGTCGA-1	A
TCGATTTTCTGTTGCC-1	A
TCGCAGGAGAAGCCTG-1	A
TCGCAGGAGACGAAAG-1	A
TCGCAGGAGCGTGTTT-1	A
TCGCAGGAGGCAGTAC-1	A
TCGCAGGAGTGCACAG-1	A
TCGCAGGCAACAACTC-1	G
TCGCAGGCAACCTCCT-1	G
TCGCAGGCAACGCAAG-1	A
TCGCAGGCAACGGACA-1	G
TCGCAGGCAATGGCAG-1	G
TCGCAGGCAGCGTACC-1	G
TCGCAGGCATCAGAAA-1	G
TCGCAGGGTCAGAAAT-1	G
TCGCAGGGTTTGCATG-1	A
TCGCAGGTCCCAATGA-1	A
TCGCAGGTCCCACGGA-1	A
TCGCAGGTCGCGTGAC-1	G
TCGCAGGTCGTTGTAG-1	G
TCGCCTAAGTTCGTTG-1	A
TCGCCTACACCGAAAG-1	G
TCGCCTACAGCGTAGA-1	A
TCGCCTACAGTATACC-1	G
TCGCCTAGTAGGGTCA-1	A
TCGCCTAGTATGGTTC-1	A
TCGCCTAGTCTAAGAA-1	A
TCGCCTAGTGATAAGT-1	A
TCGCCTAGTGCGCTCA-1	A
TCGCCTAGTGTCCTTC-1	G
TCGCCTATCTCTTCTC-1	G
TCGGGACAGATCGCCC-1	G
TCGGGACAGCTACGCC-1	G
TCGGGACAGCTATCCA-1	A
TCGGGACCAACGTAGG-1	A
TCGGGACCAAGGCTTT-1	A
TCGGGACCAGGCTACC-1	G
TCGGGACGTAACCGAG-1	A
TCGGGACGTACGAGAC-1	G
TCGGGACGTCCGTCGA-1	A
TCGGGACGTTTCGACA-1	G
TCGTTCGAGCACGTAG-1	G
TCGTTCGAGTGATATG-1	A
TCGTTCGCAATGGTCT-1	A
TCGTTCGCACATGATC-1	G
TCGTTCGCAGGACTGA-1	A
TCGTTCGCAGGATAGC-1	G
TCGTTCGCATGGCCCA-1	G
TCGTTCGGTAGGTGAC-1	G
TCGTTCGGTCCAAGAG-1	A
TCGTTCGGTGAATGGC-1	G
TCGTTCGGTTCTACGA-1	A
TCGTTCGTCAATGCAC-1	A
TCGTTCGTCAGGCCGT-1	A
TCGTTCGTCCTCCAGT-1	A
TCGTTCGTCGACTATG-1	A
TCGTTCGTCTTCAGAG-1	A
TCTAGTTAGAGCTGTG-1	G
TCTAGTTAGCAGTAGC-1	A
TCTAGTTAGCGGACAT-1	A
TCTAGTTCAAAGAGAG-1	A
TCTAGTTCACACATTG-1	G
TCTAGTTCAGTTCGGC-1	A
TCTAGTTCATCAGCTA-1	A
TCTAGTTCATTGCGAT-1	A
TCTAGTTGTCTAACCA-1	G
TCTAGTTGTTATCGAC-1	A
TCTAGTTTCAGGATCT-1	A
TCTAGTTTCCATGACA-1	G
TCTAGTTTCCGGACTG-1	G
TCTAGTTTCTCTGCAC-1	A
TCTAGTTTCTGCGTCT-1	A
TCTATTGCAGCAATGG-1	A
TCTATTGCATCAGAAA-1	A
TCTATTGCATCATGTG-1	A
TCTATTGCATCGGCCA-1	G
TCTATTGCATGCACTA-1	A
TCTATTGGTACCAAGG-1	A
TCTATTGGTATGCTAC-1	A
TCTATTGGTCACATTG-1	A
TCTATTGGTCACTCTC-1	G
TCTATTGGTGCATTGT-1	A
TCTATTGGTGCGTCCA-1	G
TCTATTGGTGGATTCT-1	A
TCTATTGGTTTCCTAT-1	A
TCTATTGTCCACCTAC-1	G
TCTATTGTCTTGGCCT-1	A
TCTCAGCAGTACGCGA-1	A
TCTCAGCCAACCTCTC-1	G
TCTCAGCCACTCGCAG-1	G
TCTCAGCGTTACACTG-1	A
TCTCAGCGTTGGCTAT-1	G
TCTCAGCTCGCAAGCC-1	G
TCTCTGGAGAACAGGA-1	G
TCTCTGGAGATGCGAC-1	A
TCTCTGGCAAACCCTA-1	G
TCTCTGGCATAGCCGC-1	A
TCTCTGGCATCCTCGT-1	A
TCTCTGGCATTTCTTG-1	G
TCTCTGGGTCGGCTGT-1	A
TCTCTGGGTGCATCAT-1	A
TCTCTGGTCAGCACTA-1	G
TCTCTGGTCAGTGTGT-1	G
TCTCTGGTCCGCCTAT-1	A
TCTCTGGTCGCACCGA-1	A
TCTCTGGTCGCGATGC-1	A
TCTCTGGTCTCTATTG-1	A
TGAATCGAGACCCTAT-1	A
TGAATCGAGTCAGCCC-1	A
TGAATCGCAAGAGATT-1	A
TGAATCGCAAGGATGC-1	G
TGAATCGCAATGGTAA-1	A
TGAATCGCAGCAGGTA-1	A
TGAATCGCATCCGTGG-1	A
TGAATCGGTAGGGTCA-1	A
TGAATCGGTATTCACG-1	A
TGAATCGGTTCAGAAA-1	G
TGAATCGTCCGGCTGA-1	A
TGAATCGTCGACTTAG-1	A
TGAATCGTCGATGCAT-1	G
TGAATCGTCGCGCTGA-1	A
TGAATCGTCGCTCGGA-1	A
TGAATCGTCTCGGCGA-1	A
TGACAACAGGTTTCTG-1	A
TGACAACAGTATACGA-1	G
TGACAACCAACGTACT-1	A
TGACAACCAACTCAAC-1	G
TGACAACCAACTGCGC-1	G
TGACAACCAGAACAGC-1	A
TGACAACGTGCAAAGC-1	A
TGACTCCAGGTTCTCA-1	A
TGACTCCAGTAACATG-1	A
TGACTCCAGTACCACT-1	G
TGACTCCCAACATAAG-1	G
TGACTCCCAGGACTGA-1	A
TGACTCCCAGTAACCT-1	G
TGACTCCGTCCAACCG-1	A
TGACTCCGTCTGATTG-1	G
TGACTCCGTTCCGGCA-1	A
TGACTCCTCACGTGTA-1	A
TGAGCCGAGCGCATTT-1	A
TGAGCCGCACCGATCG-1	A
TGAGCCGCATCCTCGT-1	A
TGAGCCGCATCTCTCG-1	A
TGAGCCGGTCTGGGCT-1	G
TGAGCCGGTGACGCAA-1	A
TGAGCCGGTTAAGGGC-1	A
TGAGCCGGTTTAAGCC-1	A
TGAGCCGGTTTGAAGA-1	G
TGAGCCGTCACTACCC-1	A
TGAGCCGTCCACGAGC-1	A
TGAGCCGTCGCGCTGA-1	A
TGAGCCGTCTCATATC-1	A
TGAGCCGTCTGGCCAG-1	G
TGAGTCAAGAATATCG-1	A
TGAGTCAAGCAACGGT-1	A
TGAGTCAAGCTCCATA-1	A
TGAGTCAAGGCTTCGC-1	G
TGAGTCAAGTACCACT-1	A
TGAGTCACAAGCGAAC-1	A
TGAGTCACAATTGTGC-1	A
TGAGTCACAGGTAGCA-1	G
TGAGTCACATACAACC-1	A
TGAGTCACATGGTATC-1	A
TGAGTCAGTCAGTGCC-1	G
TGAGTCAGTCTCAAAC-1	G
TGAGTCAGTTCTACGA-1	A
TGAGTCATCACACGTA-1	G
TGAGTCATCAGATACC-1	G
TGAGTCATCTCGTAGA-1	G
TGAGTCATCTTACCTA-1	A
TGATCAGAGCAATGTA-1	G
TGATCAGAGGGAGATA-1	G
TGATCAGAGGTAGGCT-1	G
TGATCAGAGGTGAACC-1	A
TGATCAGAGTCTAGAA-1	A
TGATCAGCAACGAGGT-1	G
TGATCAGCATGGATGG-1	A
TGATCAGCATTGCCTC-1	A
TGATCAGGTAACTCCA-1	G
TGATCAGGTCGCGCTA-1	A
TGATCAGGTTACTTTC-1	A
TGATCAGTCCCAATGA-1	A
TGATCAGTCGCCTTAC-1	A
TGATCAGTCTTCCAGC-1	G
TGATGCAAGAACAGGA-1	G
TGATGCAAGAGAATTC-1	G
TGATGCAAGAGGTACC-1	A
TGATGCAAGATCCGAG-1	G
TGATGCAAGGGAGTTC-1	G
TGATGCAAGGTTGTGG-1	A
TGATGCAAGTCTAGAA-1	A
TGATGCACACAGTTAC-1	G
TGATGCACACGATATC-1	G
TGATGCACATCAGCTA-1	A
TGATGCACATCTCACC-1	A
TGATGCAGTACGAGAC-1	A
TGATGCAGTCGCTACG-1	A
TGATGCATCAAGGCAG-1	A
TGATGCATCAGGGTTT-1	A
TGATGCATCCTAAAGC-1	A
TGATGCATCGCCAGAC-1	A
TGATGCATCTCGACCT-1	A
TGATTTCAGGTAAGCC-1	A
TGATTTCCATCCCTTG-1	G
TGATTTCCATGGAGGT-1	A
TGATTTCCATTGAACC-1	G
TGATTTCGTGCGTTTA-1	A
TGATTTCGTTGTCGGC-1	A
TGATTTCTCCTGGGAC-1	A
TGCACCTAGGATGTCG-1	G
TGCACCTAGTGCCCTG-1	G
TGCACCTAGTTGGAAT-1	A
TGCACCTCAAGGTCGA-1	A
TGCACCTCAATGGTCT-1	A
TGCACCTGTATGTCCA-1	A
TGCACCTGTCATGAGG-1	A
TGCACCTGTCCCTTTG-1	A
TGCACCTGTGCATTGT-1	G
TGCACCTGTGTCTCGG-1	A
TGCACCTGTTAGGAAT-1	G
TGCACCTGTTTCCACC-1	G
TGCACCTTCAGGAAGC-1	A
TGCACCTTCATTCATC-1	G
TGCACCTTCCGCCTAT-1	G
TGCACCTTCCGCTATC-1	G
TGCACCTTCGGTCTAA-1	A
TGCACCTTCTGTTGCC-1	G
TGCACCTTCTGTTTAC-1	G
TGCATGAAGGACTTTC-1	A
TGCATGACAATTAGGA-1	A
TGCATGACACTGATTG-1	A
TGCATGACAGTATCTG-1	A
TGCATGAGTAAGCCGA-1	A
TGCATGAGTACATGGG-1	A
TGCATGAGTAGCATGG-1	A
TGCATGAGTCCGGTAC-1	A
TGCATGAGTCTAAGAA-1	A
TGCATGAGTGATTCCA-1	G
TGCATGAGTGGACGAT-1	A
TGCATGATCAACTTGG-1	A
TGCATGATCAAGAGGC-1	A
TGCATGATCACTACCC-1	A
TGCATGATCCAGGCCA-1	G
TGCATGATCCATAACG-1	G
TGCATGATCGCAGATT-1	G
TGCATGATCGCTAGTA-1	G
TGCATTTAGCCATCAT-1	A
TGCATTTAGCTCCGGT-1	G
TGCATTTAGGTTCGTT-1	A
TGCATTTAGTGAAACT-1	A
TGCATTTCAATGGCTT-1	G
TGCATTTCAGAACGAC-1	G
TGCATTTGTACGACCC-1	A
TGCATTTGTCATAGAA-1	A
TGCATTTGTCGTCGCA-1	A
TGCATTTGTGGTACTT-1	A
TGCATTTTCACTGATG-1	A
TGCATTTTCCAGAGAG-1	A
TGCATTTTCCATAGGT-1	G
TGCATTTTCGAGAACG-1	A
TGCATTTTCTGGACAT-1	A
TGCCTCAAGCCAGAAC-1	G
TGCCTCAAGGTAAGTT-1	A
TGCCTCACAAGGCGTA-1	A
TGCCTCACACACATGT-1	A
TGCCTCACACTGCTTC-1	A
TGCCTCAGTGCTGGCT-1	A
TGCCTCATCACTCCCA-1	A
TGCCTCATCCTAGAGT-1	G
TGCCTCATCGTCGCAG-1	A
TGCCTCATCGTTGTAG-1	A
TGCCTCATCTATACCT-1	A
TGCCTCATCTTGCGCT-1	G
TGCCTGTAGCAGGACT-1	A
TGCCTGTAGTGAAGGA-1	G
TGCCTGTAGTGATATG-1	A
TGCCTGTCAACAACTC-1	A
TGCCTGTCACATTGCA-1	G
TGCCTGTCACCATTCC-1	G
TGCCTGTCACTAGGAG-1	A
TGCCTGTCAGTGGTCC-1	G
TGCCTGTCATGCACTA-1	A
TGCCTGTGTGGAAGCT-1	A
TGCCTGTGTTCTCGAA-1	A
TGCCTGTGTTTCACCC-1	A
TGCCTGTTCCTCCATG-1	A
TGCCTGTTCGGGTCCA-1	G
TGCGTAAAGACCCTAT-1	G
TGCGTAAAGAGAACCC-1	A
TGCGTAAAGAGTCCGA-1	G
TGCGTAAAGCCATTCA-1	A
TGCGTAAAGCGTGTTT-1	G
TGCGTAAAGGGAGATA-1	G
TGCGTAAAGGTAGGCT-1	A
TGCGTAAAGTGCCCTG-1	A
TGCGTAAAGTTAGCAA-1	A
TGCGTAACAATTGGCT-1	G
TGCGTAACACATAAAG-1	G
TGCGTAACACGCGTTG-1	A
TGCGTAACACTGTTAG-1	G
TGCGTAACATGTCCCT-1	G
TGCGTAAGTAGCAGCA-1	A
TGCGTAATCTATACCT-1	G
TGCTATTAGAAATACC-1	A
TGCTATTAGGATGCCA-1	A
TGCTATTAGTCCGTGC-1	A
TGCTATTCAAAGGAAG-1	G
TGCTATTCACCATTCC-1	G
TGCTATTCACGATATC-1	A
TGCTATTCAGTCAGCC-1	A
TGCTATTCATCCATAG-1	G
TGCTATTCATGTGAGG-1	A
TGCTATTGTCATAGAA-1	G
TGCTATTGTTCAGAAA-1	A
TGCTATTGTTTCCACC-1	A
TGCTATTTCAGAGTGG-1	G
TGCTCACAGAGAACCC-1	A
TGCTCACAGAGGCAGG-1	A
TGCTCACAGATCGAGC-1	A
TGCTCACAGCGTTAGG-1	G
TGCTCACAGTTGAATG-1	A
TGCTCACCAAAGAGAG-1	A
TGCTCACCAAGGAAGA-1	A
TGCTCACCAGGATAGC-1	A
TGCTCACCAGGTCCTG-1	A
TGCTCACCAGTAAGAT-1	G
TGCTCACCATCCCAAA-1	A
TGCTCACCATGTATCG-1	A
TGCTCACGTATCCCTC-1	A
TGCTCACGTTATGCAC-1	G
TGCTCACTCCATACCC-1	A
TGCTCACTCGTTCCGT-1	G
TGCTCACTCTATCTCA-1	G
TGCTCACTCTTGTCGC-1	G
TGCTCGTAGTATGGGC-1	G
TGCTCGTAGTCGACCC-1	G
TGCTCGTAGTTGCGCC-1	A
TGCTCGTCAAGGAACC-1	A
TGCTCGTCACATGATC-1	G
TGCTCGTGTCAAATCC-1	G
TGCTCGTGTCTGGGCT-1	G
TGCTCGTGTGTCCCAG-1	A
TGCTCGTGTGTGTGCC-1	G
TGCTCGTGTTGCCGCA-1	A
TGCTCGTTCCAACGCG-1	G
TGCTCGTTCGCTGATA-1	G
TGCTCGTTCTGTTTAC-1	G
TGCTTCGAGACACGGT-1	G
TGCTTCGAGAGGCGGA-1	G
TGCTTCGAGAGTTCGG-1	A
TGCTTCGAGGTTCTCA-1	G
TGCTTCGCACCACAGC-1	G
TGCTTCGCAGGTGGTA-1	G
TGCTTCGGTCCACCAG-1	A
TGCTTCGGTGCCGGTT-1	G
TGCTTCGGTTAGGAGC-1	A
TGCTTCGGTTTGAAGA-1	A
TGCTTCGTCGATTACG-1	A
TGCTTCGTCGCACAAT-1	A
TGCTTCGTCGCACCTT-1	G
TGCTTCGTCGCCGAAC-1	G
TGCTTCGTCGGACGAA-1	A
TGCTTCGTCTCCCTTT-1	G
TGCTTCGTCTGTGTGA-1	G
TGCTTTAAGAAACGCC-1	A
TGCTTTAAGAGAGGTA-1	A
TGCTTTAAGATACCAA-1	A
TGCTTTAAGCATGATA-1	A
TGCTTTACAATCAGGG-1	A
TGCTTTACACGATTAC-1	G
TGCTTTACAGCGCGTT-1	A
TGCTTTACATGTCCCT-1	A
TGCTTTAGTAGAAGCC-1	G
TGCTTTAGTATGTTCG-1	G
TGCTTTAGTCACTCTC-1	A
TGCTTTAGTCGATTAC-1	A
TGCTTTAGTGCCAAGA-1	G
TGCTTTAGTGGAAGCT-1	A
TGCTTTAGTTGCAGCC-1	G
TGCTTTAGTTTAAGCC-1	A
TGCTTTATCAAACCAC-1	A
TGCTTTATCAAATGGA-1	A
TGCTTTATCTAGTCGA-1	G
TGCTTTATCTGCTACC-1	A
TGGAAGGAGCTAACAA-1	G
TGGAAGGCAAACCGAG-1	G
TGGAAGGCACAGTTAC-1	G
TGGAAGGCAGTCAGCC-1	G
TGGAAGGGTGATGTGG-1	G
TGGAAGGTCAGTGTAC-1	A
TGGAAGGTCCACGAGC-1	A
TGGAAGGTCGATAGGG-1	A
TGGAAGGTCGTCTTAT-1	G
TGGAAGGTCGTGGTAT-1	A
TGGAAGGTCTTCCAGC-1	A
TGGACATAGGAAGAAC-1	A
TGGACATAGGCAGTGT-1	G
TGGACATAGGTTGTTC-1	A
TGGACATCACCTGAAT-1	G
TGGACATCATGGGACA-1	A
TGGACATCATTCCCGT-1	A
TGGACATGTAACCCAT-1	G
TGGACATTCAGTACAC-1	A
TGGACATTCCAGAATC-1	A
TGGACATTCGACCCGA-1	A
TGGACATTCGGATCGC-1	A
TGGCAATAGACGCCAA-1	G
TGGCAATAGATTACGA-1	A
TGGCAATAGGAATGGA-1	G
TGGCAATAGTACGCGA-1	G
TGGCAATCAAGGTCGA-1	A
TGGCAATCAATGGTCT-1	G
TGGCAATCACATGATC-1	A
TGGCAATCACCGAATT-1	A
TGGCAATCACGCTGTG-1	G
TGGCAATCACTCAGCG-1	G
TGGCAATCAGTATACC-1	A
TGGCAATGTGAATGTA-1	A
TGGCAATGTTTCGTTT-1	G
TGGCAATTCAGAATGA-1	A
TGGCCTTAGCGATACG-1	A
TGGCCTTCACGCGACT-1	A
TGGCCTTCAGTTGGAG-1	G
TGGCCTTCATTGCGAT-1	G
TGGCCTTGTATGGATA-1	A
TGGCCTTGTCCCTTTG-1	G
TGGCCTTGTGAATCGG-1	A
TGGCCTTGTTCCAATG-1	A
TGGCCTTGTTCCGGCA-1	G
TGGCCTTGTTTCAGCA-1	G
TGGCCTTTCACATCCC-1	A
TGGCCTTTCCTTACGC-1	A
TGGCCTTTCGTTCAGA-1	A
TGGCCTTTCTACCCGT-1	G
TGGCCTTTCTGGAAGG-1	G
TGGCGCAAGCTTCAAC-1	A
TGGCGCAAGTTCAAGA-1	G
TGGCGCACATGTGAGG-1	G
TGGCGCAGTAGCTGTT-1	A
TGGCGCAGTGCTTCCT-1	G
TGGCGCATCAGTTGAC-1	A
TGGCGCATCTTGCGCT-1	A
TGGGTGCAGAGGTCCA-1	G
TGGGTGCAGGTACTCT-1	A
TGGGTGCCAAGAGCGT-1	A
TGGGTGCCAAGGATGC-1	A
TGGGTGCCAGTAGTCT-1	A
TGGGTGCGTATGGATA-1	G
TGGGTGCGTGCCCAGT-1	A
TGGGTGCTCAAGAGGC-1	G
TGGGTGCTCGGTCCGA-1	A
TGGGTGCTCTTCACTA-1	A
TGGGTTAAGAGCCTGA-1	G
TGGGTTAAGCGCGTTC-1	G
TGGGTTAAGGCGCTTC-1	A
TGGGTTAAGGTAAGCC-1	A
TGGGTTAAGTGTCCCG-1	G
TGGGTTAAGTTCGACT-1	G
TGGGTTACAATGTGCT-1	G
TGGGTTACACAAGTGG-1	G
TGGGTTACATGCGCTG-1	G
TGGGTTAGTAAAGCTA-1	G
TGGGTTAGTAACCATC-1	G
TGGGTTAGTATGTTCG-1	A
TGGGTTAGTGAATGGC-1	A
TGGGTTAGTGATTCCA-1	A
TGGGTTATCATTCTTG-1	A
TGGGTTATCCCAATGA-1	A
TGGGTTATCGCTATAG-1	A
TGGGTTATCGGTCCGA-1	G
TGGTCAAAGAACTCCT-1	A
TGGTCAAAGAGAGGTA-1	G
TGGTCAAAGAGCGAAA-1	G
TGGTCAAAGATATGAC-1	A
TGGTCAAAGTGAAGGA-1	G
TGGTCAACAAGGGAGG-1	A
TGGTCAACAATGGCAG-1	G
TGGTCAAGTCAGACGA-1	A
TGGTCAAGTCCCTTTG-1	A
TGGTCAAGTGCAACAG-1	G
TGGTCAAGTTCTGATG-1	G
TGGTCAAGTTGAATAG-1	A
TGGTCAATCCACGGCA-1	A
TGGTCAATCCCTACGT-1	G
TGGTCAATCGCACCTT-1	A
TGGTCCTAGAACGTTA-1	G
TGGTCCTCATATAGAG-1	A
TGGTCCTCATGATTGC-1	G
TGGTCCTGTATCTCAG-1	A
TGGTCCTGTATGTTCG-1	A
TGGTCCTGTATTTGCG-1	A
TGGTCCTGTTTGCCAA-1	A
TGGTCCTTCAATTCCT-1	A
TGGTCCTTCCTATCCG-1	A
TGGTCCTTCGTCCCTA-1	G
TGTAAGCAGAATCAGT-1	G
TGTAAGCAGGTAAGTT-1	A
TGTAAGCAGTCAGGAC-1	A
TGTAAGCAGTTGCGCC-1	G
TGTAAGCCAAATGCTC-1	A
TGTAAGCCACATAAAG-1	G
TGTAAGCCAGATGGCA-1	A
TGTAAGCCAGTTACAC-1	G
TGTAAGCCATACTGCA-1	A
TGTAAGCCATTCACGA-1	G
TGTAAGCGTGATGCTT-1	G
TGTAAGCTCACCGCGA-1	G
TGTAAGCTCATCATGG-1	A
TGTAAGCTCTGAAAGA-1	A
TGTAAGCTCTTCCGTG-1	A
TGTACAGAGAACCATA-1	G
TGTACAGAGAACTAAC-1	G
TGTACAGAGATTACGA-1	A
TGTACAGAGGAGAACA-1	G
TGTACAGAGTCTAGAA-1	A
TGTACAGCAAAGAGAG-1	G
TGTACAGCAAGCAGGT-1	A
TGTACAGCAATAGCGG-1	A
TGTACAGCAGGGAGTT-1	A
TGTACAGGTTCAGTTG-1	A
TGTACAGGTTGGAGGT-1	G
TGTACAGTCAAGGCCC-1	G
TGTACAGTCACAGGGA-1	G
TGTACAGTCGAACACT-1	G
TGTACAGTCGGAGTTT-1	A
TGTACGAAGCGCAATG-1	A
TGTACGAAGTCTTAGC-1	A
TGTACGACAAACCGAG-1	G
TGTACGACACTAAACC-1	G
TGTACGACATGTATCG-1	G
TGTACGACATTGAACC-1	A
TGTACGACATTTGGTG-1	G
TGTACGAGTAACGGCA-1	G
TGTACGAGTGCAAGCA-1	G
TGTACGAGTTAGGAAT-1	A
TGTACGAGTTCACGTA-1	G
TGTACGAGTTTCCGGG-1	A
TGTACGATCCAGGTCG-1	G
TGTACGATCCCTATTA-1	A
TGTACGATCCGATTGA-1	G
TGTACGATCGATGTAC-1	G
TGTACGATCGCTTCAC-1	A
TGTACGATCGTTCTAT-1	A
TGTACGATCTCTCAAT-1	A
TGTAGCAAGGGAAATG-1	A
TGTAGCACACAGTAGG-1	G
TGTAGCACACGCGTTG-1	A
TGTAGCACACGTGAAG-1	G
TGTAGCACAGAGATGC-1	A
TGTAGCACATATAGAG-1	A
TGTAGCAGTGGACTGA-1	A
TGTAGCAGTTCCCAAA-1	A
TGTAGCATCATTCGGA-1	A
TGTAGCATCCCTACGT-1	G
TGTAGCATCGTGAGTT-1	A
TGTAGCATCTAAACGC-1	G
TGTGACAAGAACGCCA-1	G
TGTGACAAGAAGACTT-1	A
TGTGACAAGATGCGCA-1	A
TGTGACAAGCTACGCC-1	A
TGTGACAAGTACGACG-1	A
TGTGACACAAAGAGAG-1	A
TGTGACACAACGTCCG-1	G
TGTGACACAGGTTATC-1	A
TGTGACAGTAGTAACA-1	A
TGTGACAGTCAACGGA-1	A
TGTGACAGTCAGCAAG-1	A
TGTGACAGTCGTAATC-1	A
TGTGACAGTGCAAGAC-1	G
TGTGACAGTGCACTTA-1	G
TGTGACAGTGCATTGT-1	G
TGTGACATCAGGCGCT-1	G
TGTGACATCAGTCAAC-1	A
TGTGACATCCGTGCGA-1	G
TGTGACATCGTTGTAG-1	A
TGTGACATCTGCGTCT-1	A
TGTGGCGAGATACCAA-1	A
TGTGGCGAGGCTGGAT-1	G
TGTGGCGAGTGCAACG-1	G
TGTGGCGAGTTCGACT-1	A
TGTGGCGCACTAGCCG-1	A
TGTGGCGCAGCTGATT-1	G
TGTGGCGCATGCACTA-1	G
TGTGGCGGTGCATTGT-1	G
TGTGGCGGTTCCGCGA-1	A
TGTGGCGGTTTAAGGA-1	A
TGTGGCGTCTACATCT-1	G
TGTGTCCAGAAAGCAG-1	A
TGTGTCCAGACAGCTG-1	A
TGTGTCCAGATGGCAC-1	G
TGTGTCCAGTTGGAAT-1	G
TGTGTCCCAACGGACA-1	A
TGTGTCCCATGCCCTT-1	A
TGTGTCCGTATCATGC-1	A
TGTGTCCGTATTCGAC-1	G
TGTGTCCGTCTGGTTA-1	G
TGTGTCCGTGTTGGTT-1	G
TGTGTCCGTTCAGTTG-1	A
TGTGTCCTCACTGATG-1	G
TGTGTCCTCCAAGAGG-1	A
TGTGTCCTCGGGAATG-1	G
TGTGTCCTCTACTGCC-1	G
TGTTAGGAGAAATCTG-1	G
TGTTAGGAGAGGTACC-1	A
TGTTAGGAGGATTAAC-1	A
TGTTAGGCAACGGACA-1	G
TGTTAGGCAATGCCAT-1	A
TGTTAGGGTAATGCCT-1	A
TGTTAGGGTAGATGAT-1	A
TGTTAGGGTCATTGCA-1	A
TGTTAGGGTGCTGAAG-1	G
TGTTAGGTCCCATAGA-1	A
TGTTAGGTCGATCGCG-1	A
TGTTAGGTCGGAGTTT-1	A
TTAACGGAGCCTATAC-1	G
TTAACGGAGGCAATTA-1	A
TTAACGGAGGCGTAGT-1	G
TTAACGGCAAAGGTCG-1	A
TTAACGGCAGGTAGGT-1	A
TTAACGGCATTGCACA-1	A
TTAACGGGTATCTGCA-1	A
TTAACGGGTCGAGGTA-1	G
TTAACGGGTTCTTATC-1	A
TTAACGGGTTTGTCTT-1	G
TTAACGGTCGCTATTT-1	G
TTACCCGAGACTAATG-1	A
TTACCCGCACGGTTAT-1	A
TTACCCGCAGTTAAAG-1	A
TTACCCGGTATCTGCA-1	A
TTACCCGGTCCCTTTG-1	A
TTACCCGGTCGATAGG-1	A
TTACCCGGTGATAAGT-1	A
TTACCCGGTGCCGGTT-1	G
TTACCCGGTTCTGAAC-1	A
TTACCCGTCCAACGCG-1	A
TTACCGCAGAATATCG-1	A
TTACCGCAGAGCGGTT-1	G
TTACCGCAGGAAGGTA-1	A
TTACCGCAGGGAAATG-1	A
TTACCGCAGGGAGTTC-1	G
TTACCGCAGGTACTCT-1	A
TTACCGCAGGTCTTGT-1	A
TTACCGCAGTGAGCAC-1	G
TTACCGCCAAGGTTCT-1	G
TTACCGCCACAGGAAC-1	G
TTACCGCCACAGGTAG-1	G
TTACCGCGTAAGGTCG-1	A
TTACCGCGTGAATGTA-1	A
TTACCGCGTGATGCGA-1	A
TTACCGCTCACTCGGG-1	A
TTACCGCTCAGGGTTT-1	A
TTACCGCTCCCAGCGA-1	A
TTACGGAAGATGCGCA-1	A
TTACGGAAGCAGAATT-1	A
TTACGGAAGGCAAGGG-1	A
TTACGGAAGGGAGTTC-1	G
TTACGGAAGTCTTAGC-1	A
TTACGGACAAGGTCGA-1	A
TTACGGACAGTAGTCT-1	G
TTACGGACATATTGGC-1	G
TTACGGAGTCAAACAA-1	A
TTACGGAGTGCTAGTT-1	A
TTACGGAGTTCTACCC-1	A
TTACGGAGTTGCAGAG-1	G
TTACGGAGTTTCGATG-1	A
TTACGGATCCATGACA-1	A
TTACGGATCGGTTGTA-1	G
TTACGGATCTTCCACG-1	A
TTACGGATCTTGTGCC-1	G
TTACGTTAGAAGCCTG-1	G
TTACGTTAGAGGAACA-1	A
TTACGTTAGCAGGACT-1	A
TTACGTTAGGTTCTCA-1	A
TTACGTTAGTCTCGAT-1	A
TTACGTTAGTCTGGGA-1	A
TTACGTTAGTTCAAGA-1	A
TTACGTTCAACTGCGC-1	A
TTACGTTCAAGTTCGT-1	A
TTACGTTCAGATAAGT-1	A
TTACGTTGTATGCTAC-1	A
TTACGTTGTATTCACG-1	A
TTACGTTGTCGTCGCA-1	A
TTACGTTGTGGTCGAA-1	A
TTACGTTGTTGGACGA-1	G
TTACGTTGTTTCCACC-1	G
TTACGTTTCCCAATGA-1	G
TTACGTTTCGCACCTT-1	G
TTACTCAAGAAAGCAG-1	G
TTACTCAAGAACGACC-1	G
TTACTCAAGAACGTTA-1	G
TTACTCAAGATGGGAA-1	A
TTACTCAAGGTTGTTC-1	A
TTACTCACAAAGACGC-1	A
TTACTCACAAGTTGCT-1	G
TTACTCACAGCAACAG-1	A
TTACTCACAGCACATT-1	A
TTACTCACAGGTAACG-1	A
TTACTCAGTAGCGAGT-1	G
TTACTCAGTCTAAAGA-1	A
TTACTCAGTGGCCTCA-1	A
TTACTCAGTTCTTAGG-1	A
TTACTCATCCCAGTAA-1	G
TTACTCATCGGCAATT-1	G
TTACTTGAGAAATACC-1	A
TTACTTGAGACGACTG-1	A
TTACTTGAGAGAGGTA-1	A
TTACTTGAGGGACGTT-1	A
TTACTTGAGGGTAATT-1	G
TTACTTGAGTAGGAAG-1	A
TTACTTGCAAGGGTAC-1	A
TTACTTGCAATGGTAA-1	G
TTACTTGCACAGGTAG-1	G
TTACTTGCACCGAATT-1	G
TTACTTGCACCGTCTT-1	A
TTACTTGCAGAACTTC-1	A
TTACTTGCAGATACAA-1	G
TTACTTGCAGGTAGCA-1	A
TTACTTGCAGTAGTTC-1	G
TTACTTGCATGGGACA-1	A
TTACTTGGTATTCTTC-1	A
TTACTTGGTCACCCGA-1	A
TTACTTGGTTGCCGCA-1	A
TTACTTGTCATTGCCC-1	A
TTACTTGTCCATACGA-1	G
TTACTTGTCCTGACCT-1	G
TTACTTGTCTTTATCG-1	A
TTAGCGAAGCCGCAAA-1	A
TTAGCGAAGCTTCAAC-1	A
TTAGCGAAGGCAAGCT-1	G
TTAGCGAAGTGAGCTG-1	G
TTAGCGAAGTTATGAG-1	G
TTAGCGACAAAGAGAG-1	A
TTAGCGACAATTAGGA-1	A
TTAGCGACACAGGAAC-1	A
TTAGCGACACCGTTGG-1	G
TTAGCGACAGACTAAA-1	A
TTAGCGACATAGGCGA-1	A
TTAGCGACATTCTTTG-1	G
TTAGCGAGTAACTGAA-1	G
TTAGCGAGTCGCTAGC-1	A
TTAGCGAGTGGAAAGA-1	A
TTAGCGATCACACGTA-1	G
TTAGCGATCGAAGCCC-1	G
TTAGCGATCGTTCCGT-1	A
TTAGCGATCTGACATG-1	A
TTAGCTTAGAAGCCGT-1	A
TTAGCTTCAAATTGAG-1	A
TTAGCTTCAATGTGCT-1	G
TTAGCTTCACCAAGGA-1	G
TTAGCTTCAGGATGTG-1	A
TTAGCTTGTACAAGCG-1	G
TTAGCTTGTGCAAAGC-1	G
TTAGCTTGTGCCAAGA-1	G
TTAGCTTTCAGGGTTT-1	G
TTAGCTTTCCACTAGA-1	A
TTAGCTTTCCATTGAG-1	G
TTAGCTTTCTTAATCC-1	A
TTAGGTGAGACCCATT-1	A
TTAGGTGAGGCGATTG-1	A
TTAGGTGAGTAGGTCG-1	G
TTAGGTGCATCAACTG-1	A
TTAGGTGGTACGGAGT-1	A
TTAGGTGTCGATGTAC-1	A
TTAGGTGTCGTGCTTC-1	G
TTAGGTGTCTATTTCG-1	A
TTAGGTGTCTGGCTAA-1	G
TTAGGTGTCTTCAGAG-1	G
TTATGTCAGATCGCCC-1	A
TTATGTCAGGAAACTT-1	A
TTATGTCAGTTAGAGT-1	G
TTATGTCCAGCAATGG-1	A
TTATGTCCATAGACGG-1	A
TTATGTCGTACGACCC-1	A
TTATGTCGTGCTTACA-1	G
TTATGTCGTTTAGAAG-1	A
TTATGTCTCACCACAA-1	A
TTATGTCTCTCTATTG-1	A
TTCAACTAGTACGCGA-1	A
TTCAACTAGTATAGTG-1	G
TTCAACTCAACGGGTA-1	G
TTCAACTCAATAGTGA-1	G
TTCAACTCAATCCATG-1	G
TTCAACTGTCAACTGT-1	G
TTCAACTGTGAAACAT-1	G
TTCAACTTCACAGGGA-1	G
TTCAACTTCAGCACTA-1	A
TTCAACTTCAGGAAGC-1	G
TTCAACTTCCCAATGA-1	A
TTCAACTTCCTCCCAA-1	G
TTCAACTTCTATCTTG-1	G
TTCAACTTCTCCACTG-1	A
TTCATCAAGGGCATTG-1	A
TTCATCAAGTCCCGCA-1	A
TTCATCAAGTTCGCGC-1	G
TTCATCACAACTCCCT-1	A
TTCATCACAAGTGGCA-1	G
TTCATCACAGCGTCGT-1	G
TTCATCAGTAACTCCA-1	A
TTCATCAGTAACTGAA-1	A
TTCATCAGTAATGCCT-1	G
TTCATCAGTACTTCGA-1	G
TTCATCATCTCGGCGA-1	G
TTCATTGAGCCTATAC-1	G
TTCATTGAGGAGAACA-1	G
TTCATTGAGGGTGTTG-1	G
TTCATTGAGTAACATG-1	A
TTCATTGCAAACGACG-1	A
TTCATTGCAAGAAACT-1	A
TTCATTGCAAGGTCGA-1	A
TTCATTGCAGTTCGGC-1	G
TTCATTGCATCGTGAT-1	A
TTCATTGGTAAACGGC-1	G
TTCATTGGTAACCGAG-1	A
TTCATTGGTATCCCTC-1	G
TTCATTGGTATTGTGC-1	G
TTCATTGGTCTGATTG-1	G
TTCATTGGTTTCTTAC-1	A
TTCGATTAGACCAATA-1	A
TTCGATTAGCATACCT-1	A
TTCGATTAGGAGTCTG-1	A
TTCGATTCACGTTGTA-1	G
TTCGATTCACTGATAC-1	G
TTCGATTCAGGTCTGC-1	A
TTCGATTCATAGGCGA-1	A
TTCGATTCATTCACCC-1	A
TTCGATTTCAGCCGAC-1	G
TTCGATTTCCACTAGA-1	A
TTCGATTTCCTATCCG-1	A
TTCGATTTCGGCAATT-1	G
TTCGATTTCTCTGCGT-1	A
TTCGATTTCTGCGTCT-1	A
TTCGCGTAGACTTGAA-1	A
TTCGCGTAGGCAGTAC-1	G
TTCGCGTAGGTTAGTA-1	G
TTCGCGTAGTCCGATT-1	A
TTCGCGTAGTGTCACT-1	A
TTCGCGTCAATCACTG-1	G
TTCGCGTCAGTGCGAA-1	A
TTCGCGTCATGTAGAA-1	G
TTCGCGTGTAACGGCA-1	A
TTCGCGTGTAGCATGG-1	G
TTCGCGTGTCTGGGAA-1	A
TTCGCGTGTTATCGAC-1	A
TTCGCGTGTTGGCGAA-1	G
TTCGCGTTCTGTGTCC-1	A
TTCGGTCAGCTTCAAC-1	G
TTCGGTCAGGATGCCA-1	A
TTCGGTCAGTGATTAG-1	A
TTCGGTCCAACTAGAA-1	G
TTCGGTCCACATATCG-1	A
TTCGGTCCAGCTTACA-1	G
TTCGGTCGTCCCTAAA-1	A
TTCGGTCGTCTGTGTA-1	A
TTCGGTCGTGCTAGTT-1	A
TTCGGTCGTTACGAAA-1	G
TTCGGTCTCACTTACT-1	A
TTCGGTCTCGCTTACC-1	G
TTCGTTAAGAACGTTA-1	G
TTCGTTAAGGGAGATA-1	A
TTCGTTACAAGGTTCT-1	A
TTCGTTAGTAGACGCA-1	G
TTCGTTAGTCATAAGA-1	A
TTCGTTAGTTCATTTC-1	A
TTCGTTATCGGATCGC-1	G
TTCTAACAGCTGATTC-1	A
TTCTAACAGTTTGGAA-1	A
TTCTAACCAAGTTCGT-1	G
TTCTAACCAATGCCAT-1	G
TTCTAACCATGACTGT-1	A
TTCTAACCATTCCCGT-1	A
TTCTAACGTACGTAAA-1	A
TTCTAACGTTAGGAGC-1	G
TTCTAACGTTGGACGA-1	A
TTCTAACGTTTCGTTT-1	G
TTCTAACTCATTCGGA-1	G
TTCTAACTCCAGGCCA-1	G
TTCTAACTCCATATCT-1	A
TTCTAACTCGAGGTAG-1	G
TTCTAACTCGCGTTCT-1	A
TTCTAACTCGGTAGGA-1	A
TTCTAACTCTACCCGT-1	G
TTCTAACTCTGTTGCC-1	G
TTCTGTAAGACCCATT-1	G
TTCTGTAAGACTTGAA-1	A
TTCTGTAAGCCTGTAT-1	G
TTCTGTAAGGTCGGTA-1	A
TTCTGTAAGTTACACC-1	A
TTCTGTACACTCGTGG-1	G
TTCTGTACATGCGACC-1	A
TTCTGTAGTAGTATCC-1	A
TTCTGTAGTCATAAGA-1	A
TTCTGTAGTGCCGGTT-1	G
TTCTGTATCACTAGGT-1	A
TTCTGTATCAGGGTTT-1	G
TTCTGTATCCATAACG-1	A
TTCTGTATCCTTCGAC-1	G
TTCTGTATCGCGGCAT-1	A
TTGACGAAGATGCGAC-1	A
TTGACGAAGTTGCTTG-1	G
TTGACGACAATACTGC-1	A
TTGACGACAATGGCAG-1	G
TTGACGACACAGGTAG-1	G
TTGACGACAGTAGGCA-1	G
TTGACGACATTTGTTC-1	A
TTGACGAGTAGATGAT-1	G
TTGACGAGTATCCTTT-1	A
TTGACGAGTCATCAAC-1	A
TTGACGAGTCCATTGA-1	A
TTGACGAGTCTGTTGA-1	A
TTGACGAGTGTGACCC-1	A
TTGACGATCCGAGAGA-1	A
TTGACGATCGTCTAGA-1	G
TTGACGATCGTGGCGT-1	A
TTGACGATCGTTCTAT-1	G
TTGAGCAAGGAGTACC-1	A
TTGAGCAAGTAATCAG-1	A
TTGAGCACAACCTCTC-1	A
TTGAGCACAAGACTTC-1	A
TTGAGCACACAGGAAC-1	A
TTGAGCACACTGATTG-1	G
TTGAGCACAGAATGCG-1	A
TTGAGCACAGTCAGCC-1	A
TTGAGCAGTCGTAGTT-1	G
TTGAGCAGTGGACCAA-1	A
TTGAGCAGTGGGTAGT-1	G
TTGAGCAGTTCTGATG-1	A
TTGAGCAGTTTGAAGA-1	G
TTGAGCATCACAGGGA-1	A
TTGAGCATCACTAGGT-1	G
TTGAGCATCTGATCCC-1	G
TTGAGTGAGAATGCTA-1	G
TTGAGTGAGCGTCTGC-1	A
TTGAGTGAGCGTTAGG-1	G
TTGAGTGAGCTGGAGT-1	A
TTGAGTGAGGATTTGA-1	A
TTGAGTGAGGCGATTG-1	G
TTGAGTGAGTGTTCCA-1	A
TTGAGTGCAAGGCGTA-1	A
TTGAGTGCATTCCCGT-1	A
TTGAGTGCATTCGTCC-1	G
TTGAGTGGTAAGTCTC-1	A
TTGAGTGGTCACAGGA-1	A
TTGAGTGGTGCGCTCA-1	A
TTGAGTGTCGCTATAG-1	A
TTGAGTGTCGCTATTT-1	A
TTGAGTGTCTATAGGC-1	A
TTGCACCAGCAGAAAG-1	A
TTGCACCAGCAGAATT-1	G
TTGCACCAGGGAAATG-1	A
TTGCACCCACCTATTT-1	A
TTGCACCCATATAGAG-1	A
TTGCACCCATTATGGC-1	G
TTGCACCCATTTGTTC-1	G
TTGCACCGTAGCTGTT-1	G
TTGCACCGTGCGTTTA-1	A
TTGCACCGTGCTGTCG-1	G
TTGCACCTCCATACGA-1	G
TTGCACCTCCTTTGCG-1	A
TTGCACCTCGATGAAA-1	G
TTGCAGAAGAACGTTA-1	G
TTGCAGAAGCACGTAG-1	A
TTGCAGAAGGCGATTG-1	A
TTGCAGAAGTAGGAAG-1	A
TTGCAGAAGTGGGACT-1	G
TTGCAGACATTACTTC-1	A
TTGCAGAGTATCTCAG-1	A
TTGCAGAGTATTGTGC-1	G
TTGCAGAGTCCCGTGA-1	A
TTGCAGAGTCGAGGAT-1	A
TTGCAGAGTTTCGTTT-1	G
TTGCAGATCCGATGCG-1	A
TTGCCCAAGCGCATTT-1	G
TTGCCCAAGGCTAAAT-1	A
TTGCCCAAGGGTTCCC-1	A
TTGCCCAAGGTTTCTG-1	A
TTGCCCAAGTCTGCTA-1	G
TTGCCCAAGTCTGTGT-1	A
TTGCCCAAGTGAGTTA-1	A
TTGCCCACAAAGGCCA-1	A
TTGCCCACAAATAGTG-1	A
TTGCCCACAAATGCTC-1	G
TTGCCCACACAATAAG-1	A
TTGCCCACATTAGCAC-1	A
TTGCCCAGTAACACTC-1	A
TTGCCCAGTCACATTG-1	A
TTGCCCAGTCAGCAAG-1	A
TTGCCCAGTGACCAGA-1	G
TTGCCCAGTGAGTCGA-1	A
TTGCCCATCAACTTGG-1	G
TTGCCCATCCAACGCG-1	G
TTGCCCATCCCTATTA-1	A
TTGCCCATCCTATCCG-1	G
TTGCCCATCGCAAACT-1	A
TTGCCCATCGTCCCAT-1	G
TTGCCCATCTTGTACT-1	G
TTGCGAAAGGTCTTTG-1	G
TTGCGAACAAACAGTA-1	A
TTGCGAACAAGCACTT-1	G
TTGCGAACACTCAGCG-1	G
TTGCGAACACTCCACT-1	A
TTGCGAAGTTCCGGCA-1	A
TTGCGAAGTTCTGATG-1	G
TTGCGAATCAACTTGG-1	A
TTGCGAATCCGCCTAT-1	G
TTGCGAATCCTATCAT-1	G
TTGCGAATCCTATCCG-1	A
TTGCGAATCGCACCTT-1	A
TTGCGAATCGCGATGC-1	A
TTGCGAATCGCTTCAC-1	G
TTGCGAATCGGTCCGA-1	A
TTGCGGGAGCTGATTC-1	G
TTGCGGGCACTCGGAC-1	A
TTGCGGGCATATTGGC-1	A
TTGCGGGCATCCTGGG-1	A
TTGCGGGCATGGGTGA-1	A
TTGCGGGCATTGAACC-1	A
TTGCGGGGTAACGTAA-1	A
TTGCGGGGTGGAAGCT-1	A
TTGCGGGGTTTGATCG-1	G
TTGCGGGTCAAATGGA-1	A
TTGCGGGTCCTGGGAC-1	A
TTGCGGGTCGATGTAC-1	G
TTGCGGGTCTATACCT-1	A
TTGCGGGTCTCATATC-1	G
TTGCTATAGAAATGGG-1	G
TTGCTATAGACGACTG-1	G
TTGCTATCAACTCGTA-1	A
TTGCTATCAGAGTCGA-1	G
TTGCTATCAGATACAA-1	A
TTGCTATCAGCGCGTT-1	G
TTGCTATCAGGACCTC-1	A
TTGCTATGTATACGCT-1	A
TTGCTATGTCCGTAGC-1	A
TTGCTATGTCCTCAGG-1	G
TTGCTATGTCTAACCA-1	G
TTGCTATGTTCCGCGA-1	G
TTGCTATGTTTGTACG-1	A
TTGCTATTCCAGCACG-1	G
TTGCTATTCGCGATGC-1	A
TTGCTTAAGAGCTACG-1	A
TTGCTTAAGCCAGAAC-1	A
TTGCTTACAATTGGCT-1	A
TTGCTTACACCGATCG-1	G
TTGCTTACAGAGAGAA-1	A
TTGCTTACATCGTACA-1	A
TTGCTTAGTACAACGG-1	A
TTGCTTAGTGAATACA-1	A
TTGCTTAGTGCTGAAG-1	A
TTGCTTAGTGGAAGCT-1	A
TTGCTTATCAGGTTTG-1	A
TTGCTTATCTACCCGT-1	A
TTGCTTATCTCTATCA-1	A
TTGGTCCAGCATTGGG-1	G
TTGGTCCAGCGTATCT-1	A
TTGGTCCAGCTGAGGT-1	G
TTGGTCCCAAGACACG-1	G
TTGGTCCCAATAGCGG-1	G
TTGGTCCCACGCTGTG-1	A
TTGGTCCCAGACTAAA-1	G
TTGGTCCCAGTATCTG-1	G
TTGGTCCCATTCCCGT-1	A
TTGGTCCGTAACGTAA-1	A
TTGGTCCGTAGAATAC-1	A
TTGGTCCGTAGTCTGT-1	A
TTGGTCCGTGGAGTGT-1	G
TTGGTCCGTGTGACCC-1	A
TTGGTCCTCGCTCGGA-1	A
TTGGTCCTCTGAAAGA-1	G
TTGTCTAAGACCATAA-1	A
TTGTCTAAGACTAATG-1	A
TTGTCTAAGATCGATA-1	A
TTGTCTAAGCGCACAA-1	G
TTGTCTAAGTCGTGAG-1	A
TTGTCTACAAACTACC-1	A
TTGTCTACAATCCATG-1	A
TTGTCTACAATGGCTT-1	A
TTGTCTACACAGTTCA-1	A
TTGTCTACACGCTAAT-1	A
TTGTCTACATCGACCG-1	G
TTGTCTAGTCTGGATT-1	A
TTGTCTAGTGCAACAG-1	A
TTGTCTAGTTATCGAC-1	G
TTGTCTAGTTCTACCC-1	A
TTGTCTAGTTTGACCA-1	A
TTGTCTATCACGTGTA-1	G
TTGTCTATCCCAGTAA-1	A
TTGTCTATCCGTGCAG-1	G
TTGTCTATCCTGGGAC-1	A
TTGTTCAAGACGCCCT-1	A
TTGTTCAAGAGAGTTT-1	A
TTGTTCAAGCTATCCA-1	A
TTGTTCAAGTCGGGAT-1	G
TTGTTCAAGTGTCACT-1	A
TTGTTCACAACGTACT-1	A
TTGTTCACACGCTAAT-1	G
TTGTTCACATGATTGC-1	G
TTGTTCACATGCGACC-1	A
TTGTTCACATGGGTGA-1	A
TTGTTCAGTAGGGTTG-1	A
TTGTTCAGTTCTTTCA-1	A
TTGTTCAGTTGGCTTA-1	A
TTGTTCATCCAGAGAG-1	A
TTGTTCATCCTAAAGC-1	A
TTGTTCATCGCATAAC-1	G
TTGTTCATCGCGTGAC-1	G
TTGTTCATCGCTCGGA-1	G
TTGTTCATCGTGCTGG-1	G
TTGTTGTAGACCCATT-1	G
TTGTTGTAGGTCACTT-1	G
TTGTTGTAGTTCGACT-1	G
TTGTTGTCAACTCCCT-1	G
TTGTTGTCACCGAATT-1	G
TTGTTGTCAGAATGCG-1	G
TTGTTGTCAGTGCGAA-1	A
TTGTTGTCATTACTCT-1	G
TTGTTGTGTCCTTATT-1	A
TTGTTGTGTGTCTCGG-1	A
TTGTTGTGTTCTACCC-1	G
TTGTTGTTCAAGTTGC-1	A
TTGTTGTTCCTCATTA-1	G
TTGTTGTTCGGATAAA-1	G
TTGTTGTTCGGCAATT-1	A
TTTACGTAGATTACGA-1	G
TTTACGTAGCGAGCTA-1	A
TTTACGTAGGGATCCA-1	A
TTTACGTAGTCTGCTA-1	A
TTTACGTCAGTAACTC-1	G
TTTACGTGTCTCGGGT-1	A
TTTACGTGTGTTGGTT-1	G
TTTACGTGTTCGGGAA-1	G
TTTACGTGTTGGTAAA-1	A
TTTACGTTCGAACCGC-1	G
TTTACGTTCGGGAATG-1	A
TTTACGTTCGGTGATT-1	A
TTTACGTTCTTAAGCG-1	G
TTTGAGGAGAAAGGGT-1	A
TTTGAGGAGACTTGAA-1	A
TTTGAGGAGAGCCACA-1	A
TTTGAGGAGGCATGCA-1	A
TTTGAGGAGTTACCAC-1	G
TTTGAGGCAAAGAAGG-1	A
TTTGAGGCAAATTGAG-1	G
TTTGAGGCAAGGTTCT-1	A
TTTGAGGCACTTTGGA-1	A
TTTGAGGCATTTGTTC-1	A
TTTGAGGGTTTCCGGG-1	A
TTTGAGGGTTTCGACA-1	A
TTTGAGGTCGGTCTAA-1	G
TTTGAGGTCTGGACAT-1	G
TTTGCGCAGCCTGTAT-1	A
TTTGCGCAGCGTTAGG-1	A
TTTGCGCAGGCTAAAT-1	G
TTTGCGCCAACATAAG-1	A
TTTGCGCCACAAACGG-1	A
TTTGCGCCACTCAGCG-1	G
TTTGCGCGTCTGTCCT-1	A
TTTGCGCGTTACGAAA-1	A
TTTGCGCGTTCTACGA-1	G
TTTGCGCTCACTGATG-1	A
TTTGCGCTCCTGTGGG-1	G
TTTGCGCTCTCCTTAA-1	G
TTTGGCCAGAAGCCTG-1	G
TTTGGCCAGAATGCTA-1	G
TTTGGCCAGACGCCAA-1	G
TTTGGCCAGATGCGCA-1	A
TTTGGCCAGCAGGAGG-1	G
TTTGGCCAGTCGGGAT-1	A
TTTGGCCAGTGAAACT-1	G
TTTGGCCAGTGCAACG-1	G
TTTGGCCCACCGAAAG-1	A
TTTGGCCCACGTTACA-1	A
TTTGGCCCAGGGTAAC-1	A
TTTGGCCCATACCCGG-1	G
TTTGGCCGTAGCAGCA-1	G
TTTGGCCGTATTTGCG-1	G
TTTGGCCTCGCTTGAA-1	G
TTTGGCCTCGTGCTTC-1	G
TTTGGTTAGAACAGGA-1	A
TTTGGTTAGGGCGAAG-1	A
TTTGGTTAGTACTCTG-1	A
TTTGGTTCACTACACA-1	A
TTTGGTTCATTAAGGA-1	A
TTTGGTTGTAATGCAA-1	G
TTTGGTTGTAGAACGC-1	G
TTTGGTTGTGTTAGAA-1	A
TTTGGTTGTTTAGAAG-1	G
TTTGGTTGTTTGTGAC-1	G
TTTGGTTTCCACTAGA-1	G
TTTGGTTTCCGCTCTA-1	A
TTTGGTTTCTTAACGG-1	A
TTTGTGTAGAGGAACA-1	A
TTTGTGTAGCTTTCCC-1	G
TTTGTGTAGGTGATGC-1	A
TTTGTGTAGTTGTCCA-1	A
TTTGTGTCAACGCAAG-1	G
TTTGTGTCAGGGTAAC-1	A
TTTGTGTCATAGTCCA-1	G
TTTGTGTCATTCACGA-1	A
TTTGTGTGTATTCTGG-1	G
TTTGTGTGTCGTAGTT-1	G
TTTGTGTGTCTGGTTA-1	G
TTTGTGTGTGCAACAG-1	A
TTTGTGTGTTGTCGGC-1	G
TTTGTGTGTTTGATCG-1	A
TTTGTGTTCCCGCAAG-1	A
