"AAACGAAAGAGGAATG-1"	"A"
"AAACGAACATACAACC-1"	"G"
"AAACGAACATCGGCTG-1"	"G"
"AAACGAAGTAGAATAC-1"	"A"
"AAACGAAGTCGAGAAC-1"	"A"
"AAACGAAGTGCTTGAT-1"	"A"
"AAACGAAGTTATGCAC-1"	"A"
"AAACGAAGTTCACGTA-1"	"A"
"AAACGAATCCAAGAGG-1"	"A"
"AAACGAATCGATGTGT-1"	"A"
"AAACTCGAGGATTGCG-1"	"G"
"AAACTCGAGTCGACCC-1"	"A"
"AAACTCGAGTTCAACC-1"	"A"
"AAACTCGCAAAGGAAG-1"	"G"
"AAACTCGCAGTAACGG-1"	"A"
"AAACTCGCATGGCCTG-1"	"A"
"AAACTCGGTATGCTAC-1"	"A"
"AAACTCGGTTGGTAAA-1"	"A"
"AAACTCGTCGCGCTGA-1"	"G"
"AAACTGCAGAGCCACA-1"	"A"
"AAACTGCAGCCTCGCA-1"	"A"
"AAACTGCAGGAGTCTG-1"	"A"
"AAACTGCCAACATAAG-1"	"G"
"AAACTGCCAGCGTAGA-1"	"A"
"AAACTGCCATGTGGGA-1"	"A"
"AAACTGCGTCGGCTGT-1"	"A"
"AAACTGCGTGGTCGAA-1"	"A"
"AAACTGCGTGTCCCAG-1"	"A"
"AAACTGCTCCTCCAGT-1"	"A"
"AAACTGCTCGCACAAT-1"	"G"
"AAAGATGAGCGGACAT-1"	"A"
"AAAGATGAGGCCTCTG-1"	"G"
"AAAGATGAGTATCTGC-1"	"G"
"AAAGATGCAATTGGCT-1"	"A"
"AAAGATGCACGACGAA-1"	"G"
"AAAGATGCAGCGTAGA-1"	"G"
"AAAGATGCAGGTAGGT-1"	"G"
"AAAGATGGTCATAGCT-1"	"G"
"AAAGATGTCAGTCACA-1"	"G"
"AAAGATGTCATCGCTC-1"	"G"
"AAAGATGTCCTCATTA-1"	"G"
"AAAGGATAGAGGAACA-1"	"G"
"AAAGGATAGGGCTCTC-1"	"G"
"AAAGGATAGTTTACGC-1"	"G"
"AAAGGATGTAGTATCC-1"	"A"
"AAAGGATGTATTCGCA-1"	"G"
"AAAGGATGTTCTTTGT-1"	"A"
"AAAGGATTCAGGCCGT-1"	"G"
"AAAGGATTCCAAACCA-1"	"G"
"AAAGGATTCCACACCT-1"	"A"
"AAAGGATTCCAGAATC-1"	"G"
"AAAGGATTCCAGTACA-1"	"G"
"AAAGGGCAGAGCTACG-1"	"A"
"AAAGGGCAGCGTTGCC-1"	"A"
"AAAGGGCAGGAGTAGA-1"	"A"
"AAAGGGCAGTGTCCCG-1"	"A"
"AAAGGGCCACATAAAG-1"	"G"
"AAAGGGCCAGTTGCAT-1"	"G"
"AAAGGGCCATACAACC-1"	"A"
"AAAGGGCGTACCCACG-1"	"A"
"AAAGGGCGTTGGCGAA-1"	"G"
"AAAGGGCTCGCTGATA-1"	"A"
"AAAGGGCTCTCTGTTA-1"	"A"
"AAAGGGCTCTGCGTCT-1"	"A"
"AAAGGGCTCTGTGTCC-1"	"A"
"AAAGGGCTCTGTGTGA-1"	"G"
"AAATGAGAGAAAGGGT-1"	"A"
"AAATGAGAGACTTGAA-1"	"A"
"AAATGAGAGGCGCTTC-1"	"A"
"AAATGAGCAACACGGA-1"	"A"
"AAATGAGCATTTAGGC-1"	"A"
"AAATGAGGTAGCGAGT-1"	"A"
"AAATGAGGTTGGACGA-1"	"A"
"AAATGAGTCACGATTG-1"	"G"
"AAATGAGTCAGTACAC-1"	"G"
"AAATGAGTCCATCATT-1"	"G"
"AAATGAGTCGTCTTAT-1"	"A"
"AAATGAGTCGTGCTTC-1"	"A"
"AAATGAGTCTTACCTA-1"	"G"
"AAATGCCAGGCGCTTC-1"	"G"
"AAATGCCCAAGCTTTG-1"	"G"
"AAATGCCCAATGCACT-1"	"A"
"AAATGCCCATAAAGTG-1"	"A"
"AAATGCCCATCGCCTT-1"	"G"
"AAATGCCGTCAAATCC-1"	"A"
"AAATGCCGTCGATTAC-1"	"A"
"AAATGCCGTCTGGATT-1"	"A"
"AAATGCCGTGCCGGTT-1"	"A"
"AAATGCCGTGGACAGT-1"	"A"
"AAATGCCGTTTGTGAC-1"	"A"
"AAATGCCTCCATCGAA-1"	"A"
"AAATGCCTCTCGTAGA-1"	"G"
"AACAAAGAGAGAATTC-1"	"G"
"AACAAAGAGCTCCGGT-1"	"G"
"AACAAAGAGCTTACCA-1"	"A"
"AACAAAGAGTATAGTG-1"	"A"
"AACAAAGAGTCATACC-1"	"A"
"AACAAAGAGTCCCTCT-1"	"A"
"AACAAAGAGTGGACGT-1"	"G"
"AACAAAGCAAAGCTGG-1"	"G"
"AACAAAGCAATCACTG-1"	"G"
"AACAAAGCAGAGATGC-1"	"G"
"AACAAAGCATAGCCAT-1"	"A"
"AACAAAGCATGCCCTT-1"	"G"
"AACAAAGCATTTCACT-1"	"A"
"AACAAAGGTAGTAACA-1"	"G"
"AACAAAGGTCAGCAAG-1"	"G"
"AACAAAGGTCCAGACC-1"	"G"
"AACAAAGGTCGATAGG-1"	"A"
"AACAAAGGTGGAAAGA-1"	"G"
"AACAAAGGTTTCACCC-1"	"A"
"AACAAAGTCATTCATC-1"	"A"
"AACAAAGTCATTCTTG-1"	"A"
"AACAAAGTCGGCAATT-1"	"A"
"AACAAAGTCTCTGTTA-1"	"G"
"AACAAAGTCTGGAAGG-1"	"A"
"AACAAAGTCTTAATCC-1"	"A"
"AACAGTCAGACGCCAA-1"	"A"
"AACAGTCCAAAGAGAG-1"	"A"
"AACAGTCCACCTGAAT-1"	"G"
"AACAGTCCAGACCTGC-1"	"G"
"AACAGTCGTTGAATAG-1"	"A"
"AACAGTCTCATACTTC-1"	"A"
"AACAGTCTCCGAGGAA-1"	"G"
"AACAGTCTCTGAGTCA-1"	"A"
"AACATCGAGAGAGGTA-1"	"A"
"AACATCGAGAGGCCTA-1"	"G"
"AACATCGAGCAGAAAG-1"	"A"
"AACATCGAGTAGCAAT-1"	"G"
"AACATCGCAACGAGGT-1"	"A"
"AACATCGCAAGGGTAC-1"	"A"
"AACATCGCAGTGCGAA-1"	"A"
"AACATCGCAGTTACAC-1"	"A"
"AACATCGCATTCTCGC-1"	"A"
"AACATCGGTACCGGCT-1"	"A"
"AACATCGGTCTAAGAA-1"	"A"
"AACATCGGTCTCAAAC-1"	"G"
"AACATCGTCCAGAGAG-1"	"A"
"AACATCGTCCGGCTGA-1"	"A"
"AACATCGTCCGTTTCG-1"	"A"
"AACATCGTCGCACAAT-1"	"G"
"AACATCGTCGTAGCGC-1"	"G"
"AACATCGTCTAGTCGA-1"	"G"
"AACCAACAGAATGCTA-1"	"G"
"AACCAACAGGCCAATG-1"	"A"
"AACCAACAGGGACGTT-1"	"A"
"AACCAACAGGTTTCTG-1"	"G"
"AACCAACCAATGGCTT-1"	"A"
"AACCAACCACTCCCAT-1"	"A"
"AACCAACCATGTGGGA-1"	"A"
"AACCAACGTAACGTAA-1"	"A"
"AACCAACGTAGTCTGT-1"	"A"
"AACCAACGTGAATCGG-1"	"G"
"AACCAACGTGGCATAG-1"	"G"
"AACCAACTCAGTCTTT-1"	"A"
"AACCAACTCGTGTGCG-1"	"G"
"AACCAACTCTATATCC-1"	"A"
"AACCAACTCTTTATCG-1"	"A"
"AACCGATAGAGAAGCA-1"	"G"
"AACCGATCAACTAGAA-1"	"A"
"AACCGATCAGAGTCGA-1"	"G"
"AACCGATCAGCAACCC-1"	"A"
"AACCGATGTATTCGCA-1"	"A"
"AACCGATGTCGACTGC-1"	"A"
"AACCGATGTTTCAGCA-1"	"A"
"AACCGATGTTTCGTTT-1"	"A"
"AACCGATTCAAATGGA-1"	"A"
"AACCGATTCATACTTC-1"	"G"
"AACCGATTCTATCCTA-1"	"G"
"AACCGATTCTTCACTA-1"	"G"
"AACCTGAAGAACTCCT-1"	"A"
"AACCTGAAGAGGTGGG-1"	"G"
"AACCTGAAGAGTAAGG-1"	"A"
"AACCTGACACGCTAAT-1"	"A"
"AACCTGACAGCTTACA-1"	"A"
"AACCTGACATTACTTC-1"	"A"
"AACCTGAGTGGAGTGT-1"	"G"
"AACCTGATCCAGAATC-1"	"G"
"AACCTGATCCTTCGAC-1"	"A"
"AACCTGATCTGGCTAA-1"	"A"
"AACCTGATCTTTATCG-1"	"A"
"AACCTTTAGAACGACC-1"	"A"
"AACCTTTAGAGAAGCA-1"	"G"
"AACCTTTAGATCACCT-1"	"G"
"AACCTTTAGCCTTTGA-1"	"G"
"AACCTTTAGTATGGGC-1"	"A"
"AACCTTTAGTCTTAGC-1"	"A"
"AACCTTTCAACTTGGT-1"	"A"
"AACCTTTCATCCATAG-1"	"G"
"AACCTTTCATTGCGAT-1"	"G"
"AACCTTTGTATGCTAC-1"	"G"
"AACCTTTGTATGTCCA-1"	"G"
"AACCTTTGTCAAATCC-1"	"A"
"AACCTTTTCGATGCAT-1"	"G"
"AACCTTTTCTCAGATG-1"	"G"
"AACGAGGAGTACAGAT-1"	"G"
"AACGAGGAGTCCGGAA-1"	"G"
"AACGAGGAGTTGCTTG-1"	"A"
"AACGAGGCAAACCGAG-1"	"A"
"AACGAGGGTCCGGTAC-1"	"A"
"AACGAGGGTGTTAGAA-1"	"G"
"AACGAGGTCTTCCAGC-1"	"G"
"AACGGGAAGGAAGACA-1"	"G"
"AACGGGACACAAGTGG-1"	"A"
"AACGGGACAGGCTACC-1"	"G"
"AACGGGACATCCCGGA-1"	"G"
"AACGGGAGTAACTCCA-1"	"A"
"AACGGGAGTCATCGTA-1"	"A"
"AACGGGAGTGATGCGA-1"	"G"
"AACGGGAGTGGCCTCA-1"	"A"
"AACGGGAGTTGTGACT-1"	"A"
"AACGGGATCAAGAGGC-1"	"A"
"AACGGGATCCATATCT-1"	"A"
"AACGGGATCCCAGCAG-1"	"A"
"AACGGGATCGATTACG-1"	"A"
"AACGTACAGGAAACTT-1"	"A"
"AACGTACAGGGCATTG-1"	"G"
"AACGTACAGTATGCTC-1"	"G"
"AACGTACCAATGTGCT-1"	"A"
"AACGTACCACACATGT-1"	"G"
"AACGTACCACGCGTTG-1"	"A"
"AACGTACCAGTCAGCC-1"	"A"
"AACGTACCATCACAAC-1"	"A"
"AACGTACCATCGACCG-1"	"G"
"AACGTACCATGATTGC-1"	"G"
"AACGTACCATGGATGG-1"	"A"
"AACGTACCATTATGGC-1"	"A"
"AACGTACGTAAAGCTA-1"	"G"
"AACGTACGTAGAATAC-1"	"A"
"AACGTACGTAGCTGTT-1"	"A"
"AACGTACGTCAGAAGC-1"	"A"
"AACGTACGTGATGCGA-1"	"A"
"AACGTACGTGCCAAGA-1"	"A"
"AACGTACGTGGTCGAA-1"	"G"
"AACTGGTCAAGGCGTA-1"	"A"
"AACTGGTCACTGTAAC-1"	"G"
"AACTGGTCAGCTGATT-1"	"A"
"AACTGGTGTAGCTGTT-1"	"G"
"AACTGGTGTCAGCAAG-1"	"G"
"AACTGGTGTGGCATAG-1"	"G"
"AACTGGTTCAGTGGTT-1"	"A"
"AACTGGTTCCGCGATG-1"	"A"
"AACTGGTTCGACTGGC-1"	"G"
"AACTGGTTCGCAAACT-1"	"G"
"AACTGGTTCGTTCAGA-1"	"G"
"AACTGGTTCTCCCTTT-1"	"G"
"AACTGGTTCTTACCTA-1"	"A"
"AACTGGTTCTTCAGAG-1"	"G"
"AACTGTGAGGACTAGC-1"	"A"
"AACTGTGAGGGTGTTG-1"	"G"
"AACTGTGAGGTAAGCC-1"	"A"
"AACTGTGAGTCTCTAG-1"	"G"
"AACTGTGCAATTAGGA-1"	"A"
"AACTGTGCAATTGTGC-1"	"G"
"AACTGTGCATTACACG-1"	"A"
"AACTGTGCATTTGGTG-1"	"A"
"AACTGTGGTATATGGA-1"	"G"
"AACTGTGGTCAATACC-1"	"A"
"AACTGTGGTGAAACAT-1"	"G"
"AACTGTGGTTACTTTC-1"	"G"
"AACTGTGGTTGGTAAA-1"	"G"
"AACTGTGTCGCATACA-1"	"A"
"AACTTGGAGATCACCT-1"	"A"
"AACTTGGAGGAGACTC-1"	"A"
"AACTTGGCAACTCCCT-1"	"A"
"AACTTGGCATCGTACA-1"	"A"
"AACTTGGTCTATCTCA-1"	"A"
"AAGATAGAGGGCATTG-1"	"G"
"AAGATAGGTAAACGAT-1"	"A"
"AAGATAGGTATCTGCA-1"	"A"
"AAGATAGGTCTCTGGG-1"	"G"
"AAGATAGGTGAGTCGA-1"	"A"
"AAGATAGGTGCTTTGA-1"	"A"
"AAGATAGGTGGCCTTG-1"	"G"
"AAGATAGTCAGTCACA-1"	"G"
"AAGATAGTCCAACGCG-1"	"G"
"AAGATAGTCCGAGAGA-1"	"A"
"AAGATAGTCCTGTGGG-1"	"A"
"AAGATAGTCGGATAAA-1"	"G"
"AAGATAGTCTCGACCT-1"	"G"
"AAGGAGCAGCAACGGT-1"	"G"
"AAGGAGCCACCTGGTG-1"	"A"
"AAGGAGCGTAACGGTG-1"	"G"
"AAGGAGCGTGAGCTAG-1"	"A"
"AAGGAGCGTTCCGGCA-1"	"G"
"AAGGAGCGTTTGCGAT-1"	"G"
"AAGGTTCAGGTTGACG-1"	"A"
"AAGGTTCCATTACTCT-1"	"A"
"AAGGTTCGTAACGTAA-1"	"A"
"AAGGTTCGTATCTGCA-1"	"G"
"AAGGTTCGTATTCTCT-1"	"A"
"AAGGTTCGTATTGTGC-1"	"A"
"AAGGTTCGTTCCCTTG-1"	"G"
"AAGGTTCTCGCGTGAC-1"	"G"
"AAGGTTCTCTTAGTGG-1"	"A"
"AAGGTTCTCTTGCGCT-1"	"A"
"AATACGCAGGTAGGCT-1"	"A"
"AATACGCCAAGGATGC-1"	"A"
"AATACGCCAATGACTC-1"	"A"
"AATACGCCAGCAGGTA-1"	"G"
"AATACGCCAGGTAACG-1"	"G"
"AATACGCCATCCGTGG-1"	"G"
"AATACGCTCACCCTTG-1"	"G"
"AATACGCTCAGGCGCT-1"	"A"
"AATACGCTCCCAGCGA-1"	"A"
"AATACGCTCCCATAGA-1"	"A"
"AATACGCTCGATATGC-1"	"A"
"AATGCCAAGATCACCT-1"	"A"
"AATGCCAAGATCGAGC-1"	"G"
"AATGCCAAGCTAGCAG-1"	"A"
"AATGCCAAGGTCGGTA-1"	"A"
"AATGCCACAAACCCTA-1"	"A"
"AATGCCACACTGTCAA-1"	"A"
"AATGCCAGTGCCAAGA-1"	"A"
"AATGCCATCCCAATAG-1"	"G"
"AATGGAAAGAACGTCG-1"	"A"
"AATGGAAAGACAGCTG-1"	"G"
"AATGGAAAGATCTCAC-1"	"A"
"AATGGAAAGTCAGCCC-1"	"G"
"AATGGAACATCGGCTG-1"	"G"
"AATGGAAGTAAGTCTC-1"	"A"
"AATGGAAGTTTGCATG-1"	"A"
"AATGGAATCCTCAAGA-1"	"G"
"AATGGAATCTCCACTG-1"	"A"
"AATGGAATCTCCCTTT-1"	"A"
"AATGGCTAGACTCGGA-1"	"G"
"AATGGCTAGAGGCAGG-1"	"A"
"AATGGCTAGATCTCAC-1"	"A"
"AATGGCTAGTCGATAA-1"	"A"
"AATGGCTCAATTGCCA-1"	"G"
"AATGGCTCATGTAGAA-1"	"G"
"AATGGCTCATTTCACT-1"	"A"
"AATGGCTGTAGGGTCA-1"	"A"
"AATGGCTGTGAATGGC-1"	"A"
"AATGGCTGTTATCGAC-1"	"A"
"AATGGCTTCCCACTTG-1"	"G"
"AATGGCTTCCTGGAAT-1"	"G"
"AATGGCTTCGAACCGC-1"	"A"
"AATGGCTTCTGGTACA-1"	"G"
"AATGTCGAGTGATAAC-1"	"G"
"AATGTCGAGTTCCAGT-1"	"A"
"AATGTCGCAATGCATC-1"	"A"
"AATGTCGGTCGTCGCA-1"	"G"
"AATGTCGGTGTGTGCC-1"	"G"
"AATGTCGGTTCAGTAC-1"	"A"
"AATGTCGTCAGATACC-1"	"G"
"AATGTCGTCAGGAATA-1"	"A"
"AATGTCGTCGAAGCCC-1"	"A"
"AATGTCGTCGACCCGA-1"	"G"
"AATGTCGTCGCTACCT-1"	"A"
"AATGTCGTCGGAAAGC-1"	"G"
"AATGTCGTCTATACCT-1"	"G"
"AATGTCGTCTTGCGCT-1"	"A"
"ACAAACCAGAACGTCG-1"	"G"
"ACAAACCAGAGCCTGA-1"	"G"
"ACAAACCAGAGGTACC-1"	"G"
"ACAAACCAGAGTTCGG-1"	"A"
"ACAAACCAGTGATATG-1"	"A"
"ACAAACCAGTGATTAG-1"	"G"
"ACAAACCCAACATAAG-1"	"A"
"ACAAACCCAATTAGGA-1"	"G"
"ACAAACCCACGCGACT-1"	"G"
"ACAAACCCACTCCTCA-1"	"A"
"ACAAACCCAGATACAA-1"	"A"
"ACAAACCGTAACGGTG-1"	"G"
"ACAAACCGTAACTGAA-1"	"G"
"ACAAACCGTAGCGAGT-1"	"A"
"ACAAACCGTGCGCATC-1"	"A"
"ACAAACCGTTTGAAGA-1"	"G"
"ACAAACCGTTTGTACG-1"	"G"
"ACAAACCTCCAATAGC-1"	"A"
"ACAAACCTCGCAAACT-1"	"G"
"ACAAACCTCGGATAGG-1"	"G"
"ACAAACCTCTAGCTGA-1"	"G"
"ACAAACCTCTATCTAC-1"	"A"
"ACAAACCTCTCTTAAC-1"	"G"
"ACAAACCTCTTGTGCC-1"	"A"
"ACAAAGAAGCGAATAT-1"	"A"
"ACAAAGAAGCTGAGGT-1"	"A"
"ACAAAGAAGTAACATG-1"	"G"
"ACAAAGACAAGTTCGT-1"	"A"
"ACAAAGACACTTACAG-1"	"A"
"ACAAAGACATAGAATG-1"	"G"
"ACAAAGACATTAAGGA-1"	"A"
"ACAAAGAGTAAGTGCG-1"	"A"
"ACAAAGAGTCCAAGTT-1"	"G"
"ACAAAGAGTCCGTGCA-1"	"A"
"ACAAAGAGTTACGGAG-1"	"A"
"ACAAAGAGTTCTTATC-1"	"G"
"ACAAAGATCCAACCTC-1"	"A"
"ACAAAGATCCTGTGGG-1"	"G"
"ACAAAGATCGAGAAGC-1"	"G"
"ACAAAGATCGTTCCGT-1"	"G"
"ACAAGCTAGGCGCTTC-1"	"G"
"ACAAGCTAGTCAACTC-1"	"A"
"ACAAGCTCAAAGGCCA-1"	"A"
"ACAAGCTCACAAGGGT-1"	"A"
"ACAAGCTCACCTATTT-1"	"G"
"ACAAGCTCAGCAACGA-1"	"A"
"ACAAGCTCATGTATCG-1"	"G"
"ACAAGCTGTATTCGCA-1"	"A"
"ACAAGCTGTGAATACA-1"	"G"
"ACAAGCTGTGTGACCC-1"	"A"
"ACAAGCTGTTTCACCC-1"	"A"
"ACAAGCTTCCACGAGC-1"	"A"
"ACAAGCTTCCGTGCAG-1"	"G"
"ACAAGCTTCTCTGAGA-1"	"A"
"ACAAGCTTCTGGAAGG-1"	"A"
"ACAAGCTTCTTTGCAT-1"	"A"
"ACAATCGAGTAGTCGG-1"	"G"
"ACAATCGCAAAGCATA-1"	"G"
"ACAATCGCAACGACAG-1"	"A"
"ACAATCGCACGCCGAT-1"	"A"
"ACAATCGCAGGTAGGT-1"	"G"
"ACAATCGCATCCCGGA-1"	"A"
"ACAATCGGTCTGCACG-1"	"G"
"ACAGAAAAGACACAAT-1"	"A"
"ACAGAAAAGGCCAGTA-1"	"G"
"ACAGAAAAGGTACACG-1"	"A"
"ACAGAAAAGTCGATAA-1"	"G"
"ACAGAAACAAGGAACC-1"	"G"
"ACAGAAACACTCCACT-1"	"G"
"ACAGAAACAGTCAGAG-1"	"A"
"ACAGAAAGTGCTAGTT-1"	"G"
"ACAGAAAGTTTGAAGA-1"	"G"
"ACAGAAATCACTACCC-1"	"G"
"ACAGAAATCACTTACT-1"	"G"
"ACAGAAATCTTGGCCT-1"	"A"
"ACAGACTAGAGTGGAA-1"	"G"
"ACAGACTAGGAAGAAC-1"	"G"
"ACAGACTAGGTGATGC-1"	"G"
"ACAGACTCATGCGTTA-1"	"A"
"ACAGACTGTCCATTGA-1"	"A"
"ACAGACTTCGATGAAA-1"	"A"
"ACAGACTTCTGGTACA-1"	"A"
"ACAGACTTCTTCCGTG-1"	"G"
"ACAGCGCAGATAGGTT-1"	"A"
"ACAGCGCAGTAGGTCG-1"	"G"
"ACAGCGCCACGATATC-1"	"G"
"ACAGCGCCACTCCCAT-1"	"G"
"ACAGCGCGTATCACAC-1"	"A"
"ACAGCGCGTGCTGTCG-1"	"G"
"ACAGCGCTCCACGCTT-1"	"G"
"ACAGGCCAGCGTATCT-1"	"A"
"ACAGGCCAGGTACACG-1"	"G"
"ACAGGCCAGTACCACT-1"	"G"
"ACAGGCCCACTTGCGG-1"	"A"
"ACAGGCCGTAACCGAG-1"	"A"
"ACAGGCCGTATTCTCT-1"	"A"
"ACAGGCCTCCATTGAG-1"	"A"
"ACATGCAAGAGGTCCA-1"	"A"
"ACATGCACAATGATGA-1"	"A"
"ACATGCACACAGTTCA-1"	"G"
"ACATGCACATCAACTG-1"	"A"
"ACATGCAGTACGAGAC-1"	"A"
"ACATGCAGTCCAAGAG-1"	"A"
"ACATGCAGTGCTTGAT-1"	"A"
"ACATGCAGTGGCGCTT-1"	"A"
"ACATGCAGTTTGTACG-1"	"A"
"ACATGCATCCAATCCC-1"	"G"
"ACATGCATCCGAATTG-1"	"G"
"ACATGCATCCGCTCTA-1"	"G"
"ACATGCATCGGTCTAA-1"	"G"
"ACATGGTAGCCAGAAC-1"	"A"
"ACATGGTAGGCTAAAT-1"	"A"
"ACATGGTAGTCCGATT-1"	"G"
"ACATGGTAGTCGTGAG-1"	"G"
"ACATGGTGTAATGCCT-1"	"G"
"ACATGGTGTGCTGAAG-1"	"G"
"ACATGGTTCCCAATAG-1"	"A"
"ACCAAACAGAGAGTAG-1"	"A"
"ACCAAACAGAGATTAC-1"	"A"
"ACCAAACAGCATGTGG-1"	"G"
"ACCAAACAGTTCCAGT-1"	"G"
"ACCAAACTCCACCTAC-1"	"G"
"ACCAAACTCCACGAGC-1"	"A"
"ACCAAACTCGAGGTCC-1"	"A"
"ACCATCCAGACACAAT-1"	"A"
"ACCATCCAGATCCGAG-1"	"A"
"ACCATCCAGCGCATTT-1"	"A"
"ACCATCCAGGCTTTAC-1"	"G"
"ACCATCCAGTTGCCGC-1"	"A"
"ACCATCCAGTTTGGAA-1"	"A"
"ACCATCCCACAATAAG-1"	"A"
"ACCATCCCACCGATCG-1"	"G"
"ACCATCCCAGCGTGAA-1"	"A"
"ACCATCCCAGGCAGAT-1"	"G"
"ACCATCCCATTAAGGA-1"	"A"
"ACCATCCCATTACCTT-1"	"A"
"ACCATCCCATTTCTTG-1"	"G"
"ACCATCCGTAAACGAT-1"	"G"
"ACCATCCGTACAAGCG-1"	"A"
"ACCATCCGTAGACACG-1"	"G"
"ACCATCCGTGAGCTAG-1"	"A"
"ACCATCCTCAATTGGC-1"	"G"
"ACCATCCTCAGTCAAC-1"	"A"
"ACCATCCTCGGATAGG-1"	"A"
"ACCATCCTCGTAGCGC-1"	"G"
"ACCATCCTCGTTCTAT-1"	"G"
"ACCCAAAAGGAAACTT-1"	"A"
"ACCCAAAAGGTGTCGA-1"	"A"
"ACCCAAACATGGGTGA-1"	"G"
"ACCCAAACATTCCCGT-1"	"A"
"ACCCAAACATTGCCTC-1"	"A"
"ACCCAAAGTATCGCGC-1"	"A"
"ACCCAAAGTCTGCGCA-1"	"G"
"ACCCAAAGTGAATCGG-1"	"A"
"ACCCAAATCCAGTACA-1"	"A"
"ACCGAATAGTCAACTC-1"	"G"
"ACCGAATAGTCGTATC-1"	"G"
"ACCGAATCACACACCG-1"	"G"
"ACCGAATCACGTACAT-1"	"A"
"ACCGAATCACGTTACA-1"	"G"
"ACCGAATCACTCCACT-1"	"A"
"ACCGAATCATCCGTAA-1"	"G"
"ACCGAATGTATCTAGC-1"	"A"
"ACCGAATGTCACAGTT-1"	"A"
"ACCGAATGTGGACCAA-1"	"A"
"ACCGAATGTGTGCTTA-1"	"G"
"ACCGAATTCGAGAAGC-1"	"G"
"ACCGAATTCTAGCTGA-1"	"G"
"ACCGCAGAGAAATCTG-1"	"A"
"ACCGCAGAGACCATAA-1"	"A"
"ACCGCAGAGTAGGTCG-1"	"A"
"ACCGCAGCACCCATCT-1"	"A"
"ACCGCAGCACGCGCAT-1"	"A"
"ACCGCAGCAGTAACGG-1"	"G"
"ACCGCAGGTTATAGAG-1"	"A"
"ACCGCAGTCAAAGTAG-1"	"G"
"ACCGGGTAGCATGTGG-1"	"A"
"ACCGGGTAGCGCATTT-1"	"G"
"ACCGGGTAGTTGCCGC-1"	"A"
"ACCGGGTCACGGTTAT-1"	"G"
"ACCGGGTCAGTATCTG-1"	"A"
"ACCGGGTCATTCCCGT-1"	"A"
"ACCGGGTGTAATGCAA-1"	"A"
"ACCGGGTGTAGTCTGT-1"	"A"
"ACCGGGTGTATTCTGG-1"	"A"
"ACCGGGTGTTAAGGGC-1"	"G"
"ACCGGGTTCTTGGCCT-1"	"A"
"ACCTGCTAGAATATCG-1"	"A"
"ACCTGCTAGTAGAAGG-1"	"G"
"ACCTGCTCAGGGCTTC-1"	"G"
"ACCTGCTCAGGTAGGT-1"	"G"
"ACCTGCTGTAATGCAA-1"	"G"
"ACCTGCTGTCCCGAGT-1"	"A"
"ACCTGCTGTCTGGGCT-1"	"G"
"ACCTGCTGTTCTCGAA-1"	"A"
"ACCTGCTTCGCTATTT-1"	"A"
"ACGGATTAGGGATCCA-1"	"A"
"ACGGATTAGTAGTGTA-1"	"A"
"ACGGATTCACAAGTGG-1"	"A"
"ACGGATTCATACAACC-1"	"A"
"ACGGATTCATGGGACA-1"	"A"
"ACGGATTGTAGAGAGA-1"	"G"
"ACGGATTGTATGTTCG-1"	"A"
"ACGGATTGTGATAACA-1"	"A"
"ACGGATTGTGGCATAG-1"	"G"
"ACGGATTGTTACTTTC-1"	"G"
"ACGGATTTCAGCCGGT-1"	"G"
"ACGGATTTCCCGCAAG-1"	"G"
"ACGGATTTCTCTTAAC-1"	"G"
"ACGTGGCAGCTTCAAC-1"	"A"
"ACGTGGCCAAAGCTGG-1"	"A"
"ACGTGGCCAACGTCCG-1"	"G"
"ACGTGGCCAATCACTG-1"	"G"
"ACGTGGCCAGAGATGC-1"	"A"
"ACGTGGCCATAAAGTG-1"	"G"
"ACGTGGCGTAACCATC-1"	"G"
"ACGTGGCGTACCAAGG-1"	"G"
"ACGTGGCGTGAGTCGA-1"	"G"
"ACGTGGCGTGTGTGTT-1"	"A"
"ACGTGGCTCTGGCACG-1"	"A"
"ACGTTAGCAAAGAAGG-1"	"G"
"ACGTTAGCAAAGCTTC-1"	"G"
"ACGTTAGCAAGAGCGT-1"	"G"
"ACGTTAGCAATGGTCT-1"	"A"
"ACGTTAGCAGCGTACC-1"	"A"
"ACGTTAGCAGCGTAGA-1"	"A"
"ACGTTAGCAGGTAGCA-1"	"A"
"ACGTTAGCATTTCTTG-1"	"G"
"ACGTTAGGTACCAAGG-1"	"G"
"ACGTTAGTCACCCGGA-1"	"G"
"ACGTTAGTCCACGGCA-1"	"G"
"ACGTTAGTCCGCCTAT-1"	"G"
"ACTAACGAGGCACCTC-1"	"A"
"ACTAACGAGTCATCTG-1"	"G"
"ACTAACGCAAGACTAA-1"	"A"
"ACTAACGCAAGTGGCA-1"	"A"
"ACTAACGCACATTGCA-1"	"G"
"ACTAACGCAGAGCCAA-1"	"G"
"ACTAACGGTCAATACC-1"	"A"
"ACTAACGGTCAGGCTC-1"	"G"
"ACTAACGGTCATCAAC-1"	"A"
"ACTAACGGTTGGCGAA-1"	"G"
"ACTAACGTCAGGGTTT-1"	"A"
"ACTAACGTCCTCAAGA-1"	"A"
"ACTAACGTCTACTTTG-1"	"G"
"ACTACCCAGAATATCG-1"	"G"
"ACTACCCAGGAGGCGA-1"	"G"
"ACTACCCGTGCGACCT-1"	"A"
"ACTACCCGTTCAGAAA-1"	"A"
"ACTACCCTCAACGTGT-1"	"A"
"ACTACCCTCAGTGGTT-1"	"A"
"ACTACCCTCCAGGTAT-1"	"A"
"ACTACCCTCGCACAAT-1"	"G"
"ACTACCCTCTCTCAAT-1"	"A"
"ACTACCCTCTTTCGAT-1"	"A"
"ACTACGAAGACTAATG-1"	"A"
"ACTACGAAGCAATGTA-1"	"G"
"ACTACGACACTGATTG-1"	"A"
"ACTACGAGTAAAGGCC-1"	"G"
"ACTACGAGTACCTATG-1"	"A"
"ACTACGAGTCGAGAAC-1"	"A"
"ACTACGAGTTCTGAAC-1"	"A"
"ACTACGAGTTTGTACG-1"	"A"
"ACTACGATCGGAAAGC-1"	"A"
"ACTACGATCTGCGTCT-1"	"A"
"ACTAGGTAGATATGAC-1"	"G"
"ACTAGGTAGGCCAGTA-1"	"G"
"ACTAGGTAGTTAGCAA-1"	"G"
"ACTAGGTCAAGAGCGT-1"	"A"
"ACTAGGTCACTCCTCA-1"	"A"
"ACTAGGTGTCGATTAC-1"	"A"
"ACTAGGTGTGAATGGC-1"	"A"
"ACTAGGTTCAGAGTGG-1"	"A"
"ACTAGGTTCAGGAATA-1"	"G"
"ACTAGGTTCGATGAAA-1"	"G"
"ACTAGGTTCTTCCAGC-1"	"G"
"ACTATTCAGAACCCGA-1"	"A"
"ACTATTCAGAGTTCGG-1"	"G"
"ACTATTCCAGCAACCC-1"	"A"
"ACTATTCCAGTAGTCT-1"	"A"
"ACTATTCGTCGTAATC-1"	"A"
"ACTATTCTCAGATACC-1"	"G"
"ACTATTCTCAGCCGGT-1"	"A"
"ACTATTCTCATTCATC-1"	"A"
"ACTATTCTCATTCTCA-1"	"G"
"ACTATTCTCGCCTTAC-1"	"A"
"ACTATTCTCTATACCT-1"	"G"
"ACTCGGGAGAGCTCCC-1"	"A"
"ACTCGGGAGCTATCGT-1"	"A"
"ACTCGGGAGGTTCGAG-1"	"A"
"ACTCGGGAGGTTGACG-1"	"A"
"ACTCGGGAGTAATGTG-1"	"G"
"ACTCGGGAGTAGAAGG-1"	"G"
"ACTCGGGAGTTCAAGA-1"	"G"
"ACTCGGGCACGCGATC-1"	"A"
"ACTCGGGCATATTGGC-1"	"G"
"ACTCGGGCATCTCTCG-1"	"A"
"ACTCGGGGTCTTAGCA-1"	"G"
"ACTCGGGGTTCTTATC-1"	"A"
"ACTCGGGTCAGCACGC-1"	"A"
"ACTCGGGTCCACGCTT-1"	"G"
"ACTCGGGTCGATATGC-1"	"A"
"ACTCGGGTCGCGGCAT-1"	"G"
"ACTCGGGTCTGACATG-1"	"A"
"ACTGCAAAGCAGGACT-1"	"G"
"ACTGCAACAAGTAATG-1"	"G"
"ACTGCAACATACAACC-1"	"A"
"ACTGCAACATCGACCG-1"	"G"
"ACTGCAACATCGCTAA-1"	"G"
"ACTGCAAGTAGTACAA-1"	"A"
"ACTGCAAGTTCCTATT-1"	"G"
"ACTGCAAGTTTCTTAC-1"	"G"
"ACTGCAATCGAGGCTC-1"	"A"
"ACTGCAATCGCCCTTA-1"	"A"
"ACTGCGGAGGTAAGTT-1"	"A"
"ACTGCGGAGGTCCTCG-1"	"G"
"ACTGCGGCACAGGTAG-1"	"G"
"ACTGCGGCACTAAACC-1"	"G"
"ACTGCGGGTAGACGCA-1"	"G"
"ACTGCGGGTAGCTGTT-1"	"G"
"ACTGCGGGTTCATTTC-1"	"G"
"ACTGCGGTCGGTTCCT-1"	"G"
"ACTGCGGTCTCTGACC-1"	"G"
"ACTGCGGTCTTCTTCC-1"	"A"
"ACTGTCCAGGAGTCTG-1"	"A"
"ACTGTCCAGGCGTAGT-1"	"A"
"ACTGTCCCACGTTAGT-1"	"A"
"ACTGTCCCAGACTAAA-1"	"G"
"ACTGTCCCATCCCAAA-1"	"G"
"ACTGTCCGTGAATGTA-1"	"G"
"ACTGTCCGTGCACTTA-1"	"G"
"ACTGTCCGTGGTCGAA-1"	"A"
"ACTGTCCTCAACTTGG-1"	"A"
"ACTGTCCTCAGTGTGT-1"	"A"
"ACTGTCCTCCCGGGTA-1"	"G"
"ACTGTCCTCCTCTCTT-1"	"G"
"ACTGTCCTCGCCAGAC-1"	"G"
"ACTTCCGAGAATACTG-1"	"A"
"ACTTCCGAGCACCATT-1"	"A"
"ACTTCCGAGGAAGAAC-1"	"A"
"ACTTCCGCACAGTAGG-1"	"A"
"ACTTCCGCAGGTTATC-1"	"A"
"ACTTCCGCATACAACC-1"	"A"
"ACTTCCGGTGGTAAGC-1"	"A"
"ACTTCCGTCCCACTAC-1"	"G"
"ACTTCCGTCCTAAGTG-1"	"A"
"ACTTCCGTCGGGATCC-1"	"G"
"ACTTTCAAGCGCATTT-1"	"A"
"ACTTTCAAGCTAACAA-1"	"G"
"ACTTTCAAGCTCCGGT-1"	"G"
"ACTTTCAAGTATCTGC-1"	"A"
"ACTTTCACACATTGCA-1"	"A"
"ACTTTCACATTCACCC-1"	"A"
"ACTTTCAGTAGTACAA-1"	"G"
"ACTTTCAGTTCCAATG-1"	"A"
"ACTTTCATCAAGAGGC-1"	"A"
"ACTTTCATCGCCAGAC-1"	"A"
"ACTTTCATCGCTTACC-1"	"A"
"ACTTTCATCGTCCCAT-1"	"G"
"AGACAAAAGAAGCCGT-1"	"A"
"AGACAAAAGATTCCGT-1"	"A"
"AGACAAAAGGTTCTCA-1"	"A"
"AGACAAAAGGTTTCTG-1"	"A"
"AGACAAAGTAGAACGC-1"	"A"
"AGACAAAGTATCATGC-1"	"G"
"AGACAAAGTCCTATTT-1"	"A"
"AGACAAAGTTCTACGA-1"	"G"
"AGACAAAGTTTCAGCA-1"	"G"
"AGATAGAAGAAGAGTG-1"	"A"
"AGATAGAAGATCGATA-1"	"G"
"AGATAGAAGCGTTAGG-1"	"G"
"AGATAGAAGCTCGTTA-1"	"A"
"AGATAGAAGGAGTCTG-1"	"A"
"AGATAGAAGTTGTCCA-1"	"A"
"AGATAGACAAGCTTTG-1"	"A"
"AGATAGAGTCGAGAAC-1"	"A"
"AGATAGATCCACCTAC-1"	"G"
"AGATAGATCCTCCAGT-1"	"A"
"AGATAGATCGGTCGAC-1"	"G"
"AGATTCGAGATCGCCC-1"	"G"
"AGATTCGAGCCTATAC-1"	"G"
"AGATTCGAGCGTAGCA-1"	"A"
"AGATTCGAGGTTCTCA-1"	"A"
"AGATTCGCACATAAAG-1"	"G"
"AGATTCGCACGTTAGT-1"	"A"
"AGATTCGCAGGGCTTC-1"	"A"
"AGATTCGGTCATAGCT-1"	"G"
"AGATTCGGTGTCTACA-1"	"G"
"AGATTCGGTGTTGGTT-1"	"A"
"AGATTCGGTTATAGAG-1"	"G"
"AGATTCGTCTCAGATG-1"	"G"
"AGATTCGTCTCTGAGA-1"	"A"
"AGATTCGTCTGATCTT-1"	"A"
"AGCCAGCAGAGCTACG-1"	"G"
"AGCCAGCAGCAACGGT-1"	"G"
"AGCCAGCAGCGCGTTC-1"	"G"
"AGCCAGCAGTGTTCCA-1"	"G"
"AGCCAGCAGTTCAACC-1"	"A"
"AGCCAGCCACAAGGGT-1"	"A"
"AGCCAGCCACAGCTTA-1"	"A"
"AGCCAGCCACAGGTAG-1"	"G"
"AGCCAGCCATATAGAG-1"	"A"
"AGCCAGCGTGTAGGAC-1"	"A"
"AGCCAGCGTTGGCTAT-1"	"A"
"AGCCAGCTCGCTAGTA-1"	"A"
"AGCCCGAAGACTCTTG-1"	"A"
"AGCCCGAAGGTTACAA-1"	"G"
"AGCCCGACAATGACTC-1"	"G"
"AGCCCGACAATTCGTG-1"	"G"
"AGCCCGACAGCAACGA-1"	"A"
"AGCCCGAGTGCTTGAT-1"	"A"
"AGCCCGATCCAACCTC-1"	"A"
"AGCCCGATCGATAGGG-1"	"A"
"AGCCCGATCGCCGAAC-1"	"A"
"AGCCGCACACAGAAGC-1"	"G"
"AGCCGCAGTACGACCC-1"	"A"
"AGCCGCAGTACGTAAA-1"	"A"
"AGCCGCAGTGAGGTCA-1"	"A"
"AGCCGCAGTGCAAGAC-1"	"A"
"AGCCGCAGTGCCAAGA-1"	"G"
"AGCCGCAGTGCTGTGC-1"	"A"
"AGCCGCAGTGCTTTGA-1"	"G"
"AGCCGCAGTGTGAGGT-1"	"G"
"AGCCGCATCGAGGTAG-1"	"G"
"AGCCGCATCGATTACG-1"	"G"
"AGCCTCTAGAACTAAC-1"	"A"
"AGCCTCTAGACCTATC-1"	"A"
"AGCCTCTAGCGTTGCC-1"	"G"
"AGCCTCTAGGCAAGCT-1"	"G"
"AGCCTCTAGGCGATTG-1"	"A"
"AGCCTCTAGGGAAATG-1"	"A"
"AGCCTCTAGTGTCCCG-1"	"G"
"AGCCTCTCAACTACTG-1"	"A"
"AGCCTCTCACCAAGGA-1"	"G"
"AGCCTCTCAGGTAGGT-1"	"A"
"AGCCTCTGTAGAAAGG-1"	"G"
"AGCCTCTGTTCCATCC-1"	"A"
"AGCCTCTTCCAGGCCA-1"	"G"
"AGCCTCTTCGGGACAA-1"	"G"
"AGCCTCTTCTGCGTCT-1"	"G"
"AGCCTGGAGATCTCAC-1"	"G"
"AGCCTGGCAACAACTC-1"	"A"
"AGCCTGGCACTGCTTC-1"	"G"
"AGCCTGGCAGAGTCGA-1"	"G"
"AGCCTGGCAGGCATTT-1"	"G"
"AGCCTGGCATACTGCA-1"	"G"
"AGCCTGGGTTTAGAAG-1"	"A"
"AGCCTGGGTTTCGTTT-1"	"G"
"AGCCTGGTCATTGCCC-1"	"A"
"AGCCTGGTCCACGGCA-1"	"G"
"AGCCTGGTCCATTGTT-1"	"A"
"AGCCTGGTCCGTCAAA-1"	"G"
"AGCCTGGTCGCAAACT-1"	"A"
"AGCCTGGTCTCTGCAC-1"	"A"
"AGCCTTCAGATATGAC-1"	"G"
"AGCCTTCAGATTACGA-1"	"G"
"AGCCTTCAGGCCTCGT-1"	"G"
"AGCCTTCAGGTCGGTA-1"	"G"
"AGCCTTCAGGTGTTGG-1"	"A"
"AGCCTTCCAACTAGAA-1"	"G"
"AGCCTTCCAATGACTC-1"	"G"
"AGCCTTCCAATTCAGC-1"	"A"
"AGCCTTCCAGTTACAC-1"	"A"
"AGCCTTCGTACGGATG-1"	"A"
"AGCCTTCGTATTCTGG-1"	"A"
"AGCCTTCGTCGAGAAC-1"	"G"
"AGCCTTCGTGAAACAT-1"	"A"
"AGCCTTCGTTGTGACT-1"	"A"
"AGCCTTCTCCGGACTG-1"	"G"
"AGCCTTCTCGTCAACA-1"	"A"
"AGCCTTCTCTTTATCG-1"	"A"
"AGCGATTAGACACAAT-1"	"G"
"AGCGATTAGATGCGAC-1"	"G"
"AGCGATTAGTCACACT-1"	"G"
"AGCGATTAGTCTCGAT-1"	"G"
"AGCGATTAGTTAGAGT-1"	"A"
"AGCGATTCAATTGTGC-1"	"A"
"AGCGATTCAGCAACAG-1"	"A"
"AGCGATTCATGGTATC-1"	"G"
"AGCGATTGTACTAGAA-1"	"A"
"AGCGATTGTCTCTGCT-1"	"A"
"AGCGATTGTGAGGTCA-1"	"G"
"AGCGATTGTGTCTACA-1"	"G"
"AGCGATTTCCATGTTT-1"	"A"
"AGCGATTTCCCTATTA-1"	"G"
"AGCGATTTCCTGAAAC-1"	"A"
"AGCGATTTCTCTCAAT-1"	"A"
"AGCGTATAGACCCTAT-1"	"A"
"AGCGTATAGAGGTCCA-1"	"G"
"AGCGTATAGGTGTCGA-1"	"A"
"AGCGTATAGTCTTAGC-1"	"A"
"AGCGTATCAAACTACC-1"	"G"
"AGCGTATCAAAGCTTC-1"	"A"
"AGCGTATCACATTCTT-1"	"A"
"AGCGTATCAGCAAACG-1"	"G"
"AGCGTATCAGTAGGCA-1"	"G"
"AGCGTATGTAATGCAA-1"	"A"
"AGCGTATGTGTTTCTT-1"	"A"
"AGCGTATTCAAGGCCC-1"	"G"
"AGCGTATTCCCAATAG-1"	"G"
"AGCGTATTCCCGATTC-1"	"G"
"AGCGTATTCGCAACTA-1"	"G"
"AGCGTGCAGATCTCAC-1"	"A"
"AGCGTGCAGCCTGTAT-1"	"A"
"AGCGTGCAGCGAGAAA-1"	"G"
"AGCGTGCAGCTTTCCC-1"	"A"
"AGCGTGCAGGTCACTT-1"	"A"
"AGCGTGCAGTGATTAG-1"	"A"
"AGCGTGCCAGTCAGCC-1"	"G"
"AGCGTGCGTCGATTAC-1"	"A"
"AGCGTGCGTGACAAGC-1"	"G"
"AGCGTGCTCCGTGCAG-1"	"G"
"AGCTATGAGCTAGCAG-1"	"A"
"AGCTATGAGTGTCCCG-1"	"A"
"AGCTATGAGTTAGAGT-1"	"A"
"AGCTATGCAAAGGAAG-1"	"A"
"AGCTATGCAATGGTCT-1"	"A"
"AGCTATGCAGGTTATC-1"	"G"
"AGCTATGCATACTGCA-1"	"G"
"AGCTATGCATCGACGC-1"	"A"
"AGCTATGCATTTAGGC-1"	"A"
"AGCTATGGTATCTAGC-1"	"G"
"AGCTATGTCATTCTTG-1"	"G"
"AGCTATGTCCTCTCTT-1"	"G"
"AGCTATGTCGCCTTAC-1"	"A"
"AGCTATGTCTATTTCG-1"	"A"
"AGCTATGTCTCTGCGT-1"	"A"
"AGCTGATAGAACGCCA-1"	"A"
"AGCTGATCAACATAAG-1"	"G"
"AGCTGATCAAGGATGC-1"	"G"
"AGCTGATCAGCAACAG-1"	"G"
"AGCTGATCAGTCAGCC-1"	"A"
"AGCTGATGTCAGGTGA-1"	"A"
"AGCTGATGTCCAACCG-1"	"A"
"AGCTGATGTCTGTCCT-1"	"A"
"AGCTGATGTGGACGAT-1"	"A"
"AGCTGATGTTCTTTCA-1"	"A"
"AGCTGATTCACACGTA-1"	"A"
"AGCTGATTCTTCATAC-1"	"G"
"AGCTGGCAGAGGTCCA-1"	"G"
"AGCTGGCAGGTAGGCT-1"	"A"
"AGCTGGCAGGTGTTGG-1"	"G"
"AGCTGGCAGGTTCGTT-1"	"A"
"AGCTGGCCAACTGCGC-1"	"G"
"AGCTGGCCAAGGCGTA-1"	"G"
"AGCTGGCCAGGGAGTT-1"	"G"
"AGCTGGCCAGTCCTGG-1"	"G"
"AGCTGGCCATCCCTTG-1"	"G"
"AGCTGGCCATTGCCTC-1"	"G"
"AGCTGGCCATTTCTTG-1"	"A"
"AGCTGGCGTCTGTGTA-1"	"A"
"AGCTGGCTCAAAGTAG-1"	"A"
"AGCTGTACACGATTAC-1"	"A"
"AGCTGTACATTGCCTC-1"	"G"
"AGCTGTATCCTTCGAC-1"	"A"
"AGGACGAAGAGTGGTC-1"	"A"
"AGGACGAAGGCCTCTG-1"	"G"
"AGGACGACAAGATTAG-1"	"A"
"AGGACGACAGACTAAA-1"	"A"
"AGGACGAGTCACCCGA-1"	"A"
"AGGACGATCCTGGGAC-1"	"A"
"AGGACGATCGGAGTTT-1"	"A"
"AGGACGATCGGCATAT-1"	"A"
"AGGACGATCTTGTCGC-1"	"A"
"AGGCCCAAGATTAGAC-1"	"A"
"AGGCCCAAGCATGTGG-1"	"A"
"AGGCCCAAGGATTGAT-1"	"G"
"AGGCCCAAGGGCGAAG-1"	"A"
"AGGCCCACACACACAT-1"	"G"
"AGGCCCACAGAACAGC-1"	"A"
"AGGCCCACAGGCAAGT-1"	"A"
"AGGCCCACAGTTGGAG-1"	"A"
"AGGCCCAGTCAGACGA-1"	"A"
"AGGCCCAGTCGATAGG-1"	"A"
"AGGCCCAGTTAGCTCA-1"	"G"
"AGGCCCAGTTGTGAGG-1"	"G"
"AGGCCCATCTTGTCAT-1"	"G"
"AGGCCTGAGTCTGCTA-1"	"A"
"AGGCCTGAGTTAGCAA-1"	"A"
"AGGCCTGCAAATGTCC-1"	"A"
"AGGCCTGCATTCCCGT-1"	"A"
"AGGCCTGGTATTCGAC-1"	"A"
"AGGCCTGGTCTCTAAG-1"	"A"
"AGGCCTGGTGCACCCA-1"	"G"
"AGGCCTGTCCCAATGA-1"	"G"
"AGGCGAAAGCAGAAAG-1"	"G"
"AGGCGAAAGTTCAGGG-1"	"A"
"AGGCGAACACAAACGG-1"	"G"
"AGGCGAACATCAGCTA-1"	"A"
"AGGCGAACATGTCCCT-1"	"A"
"AGGCGAAGTCCATTGA-1"	"A"
"AGGCGAAGTGCAAGCA-1"	"A"
"AGGCGAATCGAGCGCT-1"	"A"
"AGGCGAATCGTCCCTA-1"	"A"
"AGGCGAATCGTGGTAT-1"	"A"
"AGGCGAATCTCGACAA-1"	"G"
"AGGCGAATCTTCGTTA-1"	"G"
"AGGCGTCAGAGAAGCA-1"	"A"
"AGGCGTCAGCGTAGCA-1"	"A"
"AGGCGTCAGCTGAATA-1"	"G"
"AGGCGTCAGGAACCGT-1"	"A"
"AGGCGTCAGGTTGACG-1"	"A"
"AGGCGTCAGGTTGTTC-1"	"G"
"AGGCGTCAGTGAATAC-1"	"G"
"AGGCGTCCAAGCCAGA-1"	"A"
"AGGCGTCCAGAGATGC-1"	"A"
"AGGCGTCCATGGCCCA-1"	"G"
"AGGCGTCGTATGGTTC-1"	"G"
"AGGCGTCGTCATTGGT-1"	"A"
"AGGCGTCTCGGTTGTA-1"	"A"
"AGGCGTCTCGTTGTAG-1"	"A"
"AGGCGTCTCTGGCCAG-1"	"G"
"AGTCAACAGACGCCAA-1"	"A"
"AGTCAACAGACGTCAG-1"	"A"
"AGTCAACAGAGACTCG-1"	"A"
"AGTCAACAGCAATGTA-1"	"G"
"AGTCAACAGGGTGTTG-1"	"A"
"AGTCAACAGTATCTGC-1"	"G"
"AGTCAACTCCCGTAGG-1"	"A"
"AGTCCGGAGAAATTCG-1"	"G"
"AGTCCGGAGAGCCTGA-1"	"G"
"AGTCCGGAGGGCTTCC-1"	"A"
"AGTCCGGAGGGTCTGA-1"	"G"
"AGTCCGGAGTTAGCAA-1"	"A"
"AGTCCGGCACCTATTT-1"	"A"
"AGTCCGGCACGACGAA-1"	"G"
"AGTCCGGCACTTACAG-1"	"A"
"AGTCCGGCAGGGTACA-1"	"A"
"AGTCCGGGTAGTCCAT-1"	"A"
"AGTCCGGGTCCTCAGG-1"	"G"
"AGTCCGGGTCTTAGCA-1"	"A"
"AGTCCGGGTTACTACG-1"	"A"
"AGTCCGGGTTGGTAAA-1"	"G"
"AGTCCGGTCCCGCAAG-1"	"G"
"AGTCCGGTCGTGATAC-1"	"A"
"AGTCCGGTCTATAGGC-1"	"G"
"AGTCCGGTCTTCACTA-1"	"G"
"AGTGCCGAGTCCCTCT-1"	"A"
"AGTGCCGCAACGAGGT-1"	"A"
"AGTGCCGCATGCCTTC-1"	"G"
"AGTGCCGGTCAGGCTC-1"	"G"
"AGTGCCGGTTCCGGCA-1"	"A"
"AGTGCCGTCTCCAACC-1"	"A"
"AGTGCGCAGCCATCAT-1"	"G"
"AGTGCGCAGGATATCA-1"	"A"
"AGTGCGCAGGATTGAT-1"	"A"
"AGTGCGCAGGCAGTGT-1"	"G"
"AGTGCGCAGGTAGGCT-1"	"A"
"AGTGCGCAGTAGACCG-1"	"A"
"AGTGCGCAGTAGGTCG-1"	"A"
"AGTGCGCAGTATCTGC-1"	"G"
"AGTGCGCAGTGAAGGA-1"	"G"
"AGTGCGCCAACGCAAG-1"	"G"
"AGTGCGCCAAGCCAGA-1"	"A"
"AGTGCGCCACGCCGAT-1"	"A"
"AGTGCGCGTATCTCAG-1"	"A"
"AGTGCGCGTATTCACG-1"	"G"
"AGTGCGCGTGCTGAAG-1"	"A"
"AGTGCGCTCGTCTAGA-1"	"G"
"AGTGTACAGAGGCGGA-1"	"G"
"AGTGTACAGCGTCAAG-1"	"G"
"AGTGTACAGCGTTAGG-1"	"A"
"AGTGTACAGGATATCA-1"	"A"
"AGTGTACAGTCTCGAT-1"	"A"
"AGTGTACAGTCTGGGA-1"	"A"
"AGTGTACCACACTAGT-1"	"G"
"AGTGTACGTAATGTAG-1"	"A"
"AGTGTACGTTACGCTA-1"	"G"
"AGTGTACGTTCATTTC-1"	"A"
"AGTGTACGTTGCAGAG-1"	"G"
"AGTGTACGTTGGAGGT-1"	"G"
"AGTGTACTCCAGGTCG-1"	"G"
"AGTGTACTCCCTACGT-1"	"A"
"AGTGTACTCGAAGCCC-1"	"G"
"AGTGTACTCGTCAACA-1"	"A"
"AGTTACGAGAACGCCA-1"	"G"
"AGTTACGAGGTACATA-1"	"A"
"AGTTACGAGTCACGCC-1"	"A"
"AGTTACGAGTCTCTAG-1"	"A"
"AGTTACGAGTTCAACC-1"	"A"
"AGTTACGCAAGGAGGG-1"	"G"
"AGTTACGCAGCGTGAA-1"	"A"
"AGTTACGGTAGAGAGA-1"	"G"
"AGTTACGGTATGAAGT-1"	"A"
"AGTTACGGTATTTGCG-1"	"A"
"AGTTACGGTCATCAAC-1"	"A"
"AGTTACGGTCTGTTGA-1"	"G"
"AGTTACGGTGATGCGA-1"	"G"
"AGTTACGGTTCTGAAC-1"	"G"
"AGTTTGGAGCCATGGA-1"	"G"
"AGTTTGGCAAACCGAG-1"	"A"
"AGTTTGGCAACGTAGG-1"	"A"
"AGTTTGGCACCGTTGG-1"	"A"
"AGTTTGGCAGAACTTC-1"	"G"
"AGTTTGGCAGACTAAA-1"	"G"
"AGTTTGGCAGTTAAAG-1"	"G"
"AGTTTGGGTGCAGACA-1"	"A"
"AGTTTGGGTTTGCCCT-1"	"A"
"AGTTTGGTCCAAACCA-1"	"G"
"AGTTTGGTCTCGACCT-1"	"G"
"AGTTTGGTCTCGCGTT-1"	"A"
"ATAGGCTAGATGTTGA-1"	"G"
"ATAGGCTCAAAGGCCA-1"	"A"
"ATAGGCTCAAGGGTAC-1"	"A"
"ATAGGCTCAATGGCAG-1"	"A"
"ATAGGCTCACGTGAAG-1"	"A"
"ATAGGCTCATTGCGAT-1"	"A"
"ATAGGCTGTCCTCAGG-1"	"G"
"ATAGGCTGTCTGGATT-1"	"G"
"ATAGGCTGTGAGTAAT-1"	"A"
"ATAGGCTGTGCAGACA-1"	"G"
"ATAGGCTTCCAGGGAA-1"	"A"
"ATAGTCGAGGACTAGC-1"	"G"
"ATAGTCGAGGTAAGTT-1"	"A"
"ATAGTCGAGGTGTTGG-1"	"A"
"ATAGTCGCAACTGCGC-1"	"G"
"ATAGTCGCAAGTCTCA-1"	"A"
"ATAGTCGCACAATAAG-1"	"A"
"ATAGTCGCACAGGTAG-1"	"A"
"ATAGTCGCATAGACGG-1"	"A"
"ATAGTCGGTACAACGG-1"	"A"
"ATAGTCGGTAGGTAAT-1"	"G"
"ATAGTCGGTAGTCCAT-1"	"A"
"ATAGTCGGTTAAGTCC-1"	"A"
"ATAGTCGGTTTCCGGG-1"	"A"
"ATAGTCGTCCGTCAAA-1"	"G"
"ATAGTCGTCGCTACCT-1"	"A"
"ATAGTCGTCGGCATAT-1"	"A"
"ATATTCCAGCGAGCTA-1"	"A"
"ATATTCCAGCGTATCT-1"	"A"
"ATATTCCAGGTACACG-1"	"A"
"ATATTCCCACCACCAG-1"	"G"
"ATATTCCGTAAACGGC-1"	"G"
"ATATTCCGTATACGCT-1"	"G"
"ATATTCCGTCAAGACG-1"	"A"
"ATATTCCGTCGCTACG-1"	"A"
"ATATTCCGTCTGTCCT-1"	"G"
"ATATTCCGTGGAGTGT-1"	"A"
"ATATTCCTCAGGAATA-1"	"G"
"ATATTCCTCCACGAGC-1"	"A"
"ATATTCCTCTCTCAAT-1"	"G"
"ATATTCCTCTTCCACG-1"	"A"
"ATCCAGAAGAACGCCA-1"	"A"
"ATCCAGAAGAGGTGGG-1"	"G"
"ATCCAGAAGATGGCAC-1"	"A"
"ATCCAGAAGGTTCGAG-1"	"G"
"ATCCAGAAGTCCAGAG-1"	"A"
"ATCCAGAAGTTAGCAA-1"	"G"
"ATCCAGACAAATGCTC-1"	"A"
"ATCCAGACATCCTGGG-1"	"A"
"ATCCAGACATTGTTCT-1"	"G"
"ATCCAGAGTAAGCCGA-1"	"A"
"ATCCAGAGTGCAACAG-1"	"G"
"ATCCAGAGTTTGCCAA-1"	"G"
"ATCCAGATCGATTACG-1"	"A"
"ATCCAGATCGGTGATT-1"	"G"
"ATCCAGATCTAGTCGA-1"	"A"
"ATCCCTGAGACTTCCA-1"	"A"
"ATCCCTGAGAGCAGCT-1"	"A"
"ATCCCTGAGCGTATCT-1"	"G"
"ATCCCTGAGGCAATTA-1"	"A"
"ATCCCTGAGGGCATTG-1"	"A"
"ATCCCTGCAACCTCTC-1"	"A"
"ATCCCTGCAAGCAGGT-1"	"A"
"ATCCCTGCAGGATAGC-1"	"A"
"ATCCCTGCATCGCCTT-1"	"G"
"ATCCCTGGTACCTATG-1"	"G"
"ATCCCTGGTCCCTAAA-1"	"G"
"ATCCCTGGTCTGGTCG-1"	"G"
"ATCCCTGGTTCTACGA-1"	"A"
"ATCCCTGTCTCTATTG-1"	"A"
"ATCCCTGTCTTGTCAT-1"	"A"
"ATCCTCGAGAAGACTT-1"	"G"
"ATCCTCGAGTACTCTG-1"	"A"
"ATCCTCGAGTCGATAA-1"	"G"
"ATCCTCGAGTCGTATC-1"	"G"
"ATCCTCGCACATGATC-1"	"G"
"ATCCTCGCACTTATGG-1"	"G"
"ATCCTCGGTAGCAGGT-1"	"G"
"ATCCTCGGTGGACCAA-1"	"G"
"ATCCTCGTCCGGAAAG-1"	"A"
"ATCCTGCAGTACCACT-1"	"A"
"ATCCTGCCAAGAAACT-1"	"A"
"ATCCTGCCACCTGAAT-1"	"G"
"ATCCTGCGTAGTTTGC-1"	"A"
"ATCCTGCGTTGGACGA-1"	"A"
"ATCCTGCTCGATTACG-1"	"A"
"ATCGAGTAGTATACCC-1"	"A"
"ATCGAGTCAAAGCTTC-1"	"G"
"ATCGAGTCAATCCATG-1"	"G"
"ATCGAGTCACGACGAA-1"	"G"
"ATCGAGTCAGAGATGC-1"	"G"
"ATCGAGTGTAAACCCT-1"	"G"
"ATCGAGTGTACGCAAG-1"	"A"
"ATCGAGTGTTTAGACC-1"	"G"
"ATCGAGTTCCCGAAGC-1"	"A"
"ATCGAGTTCTGCTACC-1"	"A"
"ATGCATGAGAGTCCGA-1"	"A"
"ATGCATGAGCAGAATT-1"	"G"
"ATGCATGAGCTCGGCT-1"	"G"
"ATGCATGAGGAAGACA-1"	"A"
"ATGCATGAGGGCTCTC-1"	"G"
"ATGCATGAGTGTTCCA-1"	"A"
"ATGCATGCACTAAACC-1"	"A"
"ATGCATGCATGGCCCA-1"	"A"
"ATGCATGGTAACGGCA-1"	"A"
"ATGCATGGTAACTGAA-1"	"A"
"ATGCATGGTCAAACAA-1"	"G"
"ATGCATGGTGAATGTA-1"	"G"
"ATGCATGGTTCTACCC-1"	"G"
"ATGCATGGTTTCGATG-1"	"A"
"ATGCATGTCGCGATGC-1"	"G"
"ATGGATCAGCGTTAGG-1"	"G"
"ATGGATCCACTGCTTC-1"	"A"
"ATGGATCCATCCTGGG-1"	"A"
"ATGGATCGTACGTAGG-1"	"G"
"ATGGATCGTAGCAGCA-1"	"G"
"ATGGATCGTATTTGCG-1"	"G"
"ATGGATCGTCATCGTA-1"	"A"
"ATGGATCGTCGAGAAC-1"	"G"
"ATGGATCGTTCCAATG-1"	"G"
"ATGGATCGTTTCCTAT-1"	"A"
"ATGGATCTCACTCGGG-1"	"G"
"ATGTACGAGCACACCC-1"	"G"
"ATGTACGAGCGGACTA-1"	"A"
"ATGTACGAGCTGCCAC-1"	"A"
"ATGTACGAGTCTCCAA-1"	"G"
"ATGTACGAGTTCCCGG-1"	"G"
"ATGTACGCAAACCCTA-1"	"G"
"ATGTACGCAAAGAGAG-1"	"G"
"ATGTACGCAGAAGTGC-1"	"A"
"ATGTACGCAGGCATTT-1"	"A"
"ATGTACGCATCTCACC-1"	"A"
"ATGTACGGTCTGCACG-1"	"A"
"ATGTACGGTCTGGTTA-1"	"A"
"ATGTACGGTGCGTTTA-1"	"A"
"ATGTACGGTGGCCTTG-1"	"A"
"ATGTACGGTTAAGTCC-1"	"A"
"ATGTACGGTTTCACCC-1"	"A"
"ATGTACGTCCCGAAGC-1"	"A"
"ATGTCGAAGATGTTCC-1"	"A"
"ATGTCGAAGGTCACTT-1"	"A"
"ATGTCGAAGGTCCTCG-1"	"A"
"ATGTCGAAGGTTGACG-1"	"A"
"ATGTCGACAAGATTAG-1"	"G"
"ATGTCGACACAGTTCA-1"	"A"
"ATGTCGACAGAACGAC-1"	"A"
"ATGTCGACATGTCCCT-1"	"G"
"ATGTCGAGTAAACGAT-1"	"G"
"ATGTCGAGTATGCTAC-1"	"A"
"ATGTCGAGTGAGGTCA-1"	"A"
"ATGTCGAGTGATTCCA-1"	"A"
"ATGTCGAGTGCATTCA-1"	"A"
"ATGTCGATCCGGGCAT-1"	"A"
"ATGTCGATCCTGACCT-1"	"A"
"ATGTCTTAGCGCGTTC-1"	"G"
"ATGTCTTAGTCGGGAT-1"	"A"
"ATGTCTTAGTCGTGAG-1"	"G"
"ATGTCTTAGTGATAAC-1"	"G"
"ATGTCTTAGTTGGAAT-1"	"A"
"ATGTCTTCACGGTTAT-1"	"A"
"ATGTCTTCACTCGCAG-1"	"A"
"ATGTCTTCATGGGAAC-1"	"G"
"ATGTCTTCATTCACGA-1"	"G"
"ATGTCTTGTATGTTCG-1"	"G"
"ATGTCTTGTCCCGTGA-1"	"G"
"ATGTCTTGTTAAGTCC-1"	"A"
"ATGTCTTTCAGGCCGT-1"	"G"
"ATGTCTTTCGGACGAA-1"	"G"
"ATGTCTTTCTTACGGA-1"	"A"
"ATGTTTCAGAAATGGG-1"	"A"
"ATGTTTCAGTAGCAAT-1"	"G"
"ATGTTTCAGTGTTCCA-1"	"A"
"ATGTTTCCAGGATAGC-1"	"A"
"ATGTTTCCAGTCCTGG-1"	"G"
"ATGTTTCGTAATGTGA-1"	"G"
"ATGTTTCGTACCTATG-1"	"G"
"ATGTTTCGTTACGCTA-1"	"A"
"ATGTTTCTCCTCCATG-1"	"G"
"ATGTTTCTCGAACCGC-1"	"A"
"ATTACCTCACCGATCG-1"	"G"
"ATTACCTCACGCTGTG-1"	"A"
"ATTACCTCACGGCCAT-1"	"G"
"ATTACCTCAGTTCGGC-1"	"G"
"ATTACCTCATGGTTTG-1"	"A"
"ATTACCTTCGACCCGA-1"	"A"
"ATTACCTTCGGGATCC-1"	"A"
"ATTACCTTCTCTTCTC-1"	"G"
"ATTACTCAGACCCATT-1"	"A"
"ATTACTCAGATTGACA-1"	"G"
"ATTACTCAGGGTCTGA-1"	"G"
"ATTACTCAGGTACATA-1"	"G"
"ATTACTCAGTGTGTAA-1"	"A"
"ATTACTCCAGGCATTT-1"	"A"
"ATTACTCCATGGAGGT-1"	"A"
"ATTACTCGTACGCCCA-1"	"G"
"ATTACTCGTGAATGGC-1"	"A"
"ATTACTCGTTTGCCAA-1"	"G"
"ATTACTCTCAAGAGAT-1"	"G"
"ATTCGTTAGAGGTGGG-1"	"G"
"ATTCGTTAGGAAACTT-1"	"A"
"ATTCGTTAGTAGGAAG-1"	"A"
"ATTCGTTAGTGGTGTG-1"	"A"
"ATTCGTTAGTTGCTTG-1"	"G"
"ATTCGTTCAATCATCG-1"	"G"
"ATTCGTTCAATGCCAT-1"	"G"
"ATTCGTTCACCGTTGG-1"	"A"
"ATTCGTTCAGGCATCC-1"	"A"
"ATTCGTTCAGGGTACA-1"	"A"
"ATTCGTTCAGTATACC-1"	"G"
"ATTCGTTCATGACTGT-1"	"G"
"ATTCGTTGTACTAGAA-1"	"A"
"ATTCGTTGTCCTATTT-1"	"G"
"ATTCGTTGTCTCTGGG-1"	"G"
"ATTCGTTGTGCACATT-1"	"A"
"ATTCGTTTCCCTATTA-1"	"G"
"ATTCGTTTCGACTGGC-1"	"A"
"ATTCGTTTCGCTGATA-1"	"G"
"ATTCGTTTCGGTGATT-1"	"A"
"ATTGTCTAGGTTGTTC-1"	"A"
"ATTGTCTCAAGTAATG-1"	"A"
"ATTGTCTCACCTCGTT-1"	"G"
"ATTGTCTCACGATTAC-1"	"A"
"ATTGTCTCACTTGCGG-1"	"A"
"ATTGTCTCAGGTCTGC-1"	"A"
"ATTGTCTCATGCGTTA-1"	"A"
"ATTGTCTCATGGGAAC-1"	"G"
"ATTGTCTGTACGGAGT-1"	"G"
"ATTGTCTGTCTGCACG-1"	"A"
"ATTGTCTGTGGAAAGA-1"	"A"
"ATTGTCTGTTAGGAAT-1"	"A"
"ATTGTCTTCAACTTGG-1"	"G"
"ATTGTCTTCGCATAAC-1"	"A"
"ATTGTGGAGGTAGGAA-1"	"G"
"ATTGTGGCAGCAAACG-1"	"G"
"ATTGTGGCAGCAACCC-1"	"G"
"ATTGTGGCATGCACTA-1"	"A"
"ATTGTGGCATGTGGGA-1"	"A"
"ATTGTGGGTCGTCGCA-1"	"G"
"ATTGTGGGTGATGCGA-1"	"G"
"ATTGTGGTCCATTGAG-1"	"A"
"ATTGTGGTCGACCCGA-1"	"G"
"ATTTGTCAGATCACCT-1"	"G"
"ATTTGTCAGCTGAAAT-1"	"A"
"ATTTGTCAGGATTTGA-1"	"A"
"ATTTGTCCACCGATCG-1"	"A"
"ATTTGTCCAGCGCGTT-1"	"G"
"ATTTGTCCATTCGTCC-1"	"G"
"ATTTGTCGTGAGTAAT-1"	"G"
"ATTTGTCTCACGTCAA-1"	"G"
"ATTTGTCTCGCGTGAC-1"	"G"
"ATTTGTCTCGTTCCGT-1"	"A"
"ATTTGTCTCTCGTAGA-1"	"A"
"CAAAGCTAGAGAGTAG-1"	"A"
"CAAAGCTAGGTAAGCC-1"	"G"
"CAAAGCTCAAACTACC-1"	"A"
"CAAAGCTCAACTCGTA-1"	"A"
"CAAAGCTCAAGCGAAC-1"	"A"
"CAAAGCTCAATGGCAG-1"	"G"
"CAAAGCTCATCCTGGG-1"	"A"
"CAAAGCTGTCCCGAGT-1"	"A"
"CAAAGCTGTGGATTCT-1"	"A"
"CAAAGCTTCAAATGGA-1"	"G"
"CAAAGCTTCACGTCAA-1"	"G"
"CAAAGCTTCGCGTTCT-1"	"A"
"CAACCAAAGTGCTAGG-1"	"A"
"CAACCAACAGAACTTC-1"	"A"
"CAACCAACATCGGCCA-1"	"G"
"CAACCAAGTAACGGTG-1"	"A"
"CAACCAAGTCATGAGG-1"	"G"
"CAACCAAGTTACTTTC-1"	"A"
"CAACCAATCGTAGCGC-1"	"A"
"CAACGGCAGAGGTCCA-1"	"G"
"CAACGGCAGATTAGAC-1"	"G"
"CAACGGCAGTGAAGGA-1"	"A"
"CAACGGCCAACTCGAT-1"	"G"
"CAACGGCCACCACGAC-1"	"G"
"CAACGGCCACTACACA-1"	"A"
"CAACGGCGTAAGTGCG-1"	"A"
"CAACGGCGTAGCCATT-1"	"G"
"CAACGGCGTGCATTCA-1"	"G"
"CAACGGCTCAAGTTGC-1"	"A"
"CAACGGCTCCAACCTC-1"	"G"
"CAACGGCTCGCGCTGA-1"	"G"
"CAACGGCTCTGATCTT-1"	"G"
"CAACGTAAGAGGTCCA-1"	"G"
"CAACGTAAGATCGCCC-1"	"A"
"CAACGTAAGCGTCAAG-1"	"A"
"CAACGTAAGTACAGAT-1"	"G"
"CAACGTAAGTCTAGAA-1"	"G"
"CAACGTACAGATTTGC-1"	"A"
"CAACGTAGTCGAGGAT-1"	"G"
"CAACGTAGTGGTAAGC-1"	"G"
"CAACGTAGTTACCACA-1"	"G"
"CAACGTATCAGAACGG-1"	"G"
"CAACGTATCCAGGTAT-1"	"G"
"CAACGTATCCCGTATC-1"	"G"
"CAACGTATCGATGCAT-1"	"A"
"CAACGTATCTCCACTG-1"	"A"
"CAAGAAAAGGGTCCCT-1"	"A"
"CAAGAAAAGTCAGCCC-1"	"G"
"CAAGAAAAGTGGACGT-1"	"A"
"CAAGAAACAGCAAACG-1"	"G"
"CAAGAAAGTCCGCTTT-1"	"G"
"CAAGAAAGTCTGATTG-1"	"G"
"CAAGAAAGTGCGTCCA-1"	"A"
"CAAGAAATCGATTACG-1"	"A"
"CAAGCTAAGAGGTACC-1"	"G"
"CAAGCTAAGGCGCTTC-1"	"A"
"CAAGCTACACAGAAGC-1"	"G"
"CAAGCTACACTGTAAC-1"	"G"
"CAAGCTACATATTGGC-1"	"G"
"CAAGCTAGTAACGGTG-1"	"A"
"CAAGCTAGTAGATTAG-1"	"A"
"CAAGCTATCGCTATTT-1"	"A"
"CAAGCTATCTAAACGC-1"	"G"
"CAAGCTATCTTAGTGG-1"	"A"
"CAAGGCCAGACGACTG-1"	"A"
"CAAGGCCAGGAGTACC-1"	"G"
"CAAGGCCAGGGAGATA-1"	"G"
"CAAGGCCCAAGACACG-1"	"G"
"CAAGGCCCACCACAGC-1"	"G"
"CAAGGCCCAGTTCGGC-1"	"G"
"CAAGGCCCATAGATAG-1"	"A"
"CAAGGCCCATGCTATG-1"	"G"
"CAAGGCCGTATCTCAG-1"	"G"
"CAAGGCCGTGAAACAT-1"	"G"
"CAAGGCCGTTTCGATG-1"	"A"
"CAAGGCCTCCACGAGC-1"	"G"
"CAAGGCCTCCAGGTAT-1"	"A"
"CAATCCCAGCGAGCTA-1"	"G"
"CAATCCCAGTCAGCCC-1"	"G"
"CAATCCCCAACGTACT-1"	"G"
"CAATCCCCAGTGCGAA-1"	"G"
"CAATCCCCATCGTGAT-1"	"G"
"CAATCCCCATTTGGCA-1"	"A"
"CAATCCCGTCATCAAC-1"	"G"
"CAATCCCGTGGCGCTT-1"	"A"
"CAATCCCGTTAGCTCA-1"	"A"
"CAATCCCTCAAGGCAG-1"	"G"
"CAATCCCTCACTCCCA-1"	"G"
"CAATCCCTCAGATACC-1"	"A"
"CAATCCCTCAGGTTTG-1"	"G"
"CAATCCCTCATCGCAA-1"	"G"
"CAATCCCTCATGTTCT-1"	"G"
"CAATCCCTCGCCGAAC-1"	"A"
"CACAACAAGAAACGCC-1"	"A"
"CACAACAAGCGGACAT-1"	"G"
"CACAACAAGCTGCCAC-1"	"G"
"CACAACAAGTCCAGAG-1"	"G"
"CACAACAAGTGTCGGA-1"	"G"
"CACAACACAAAGCTTC-1"	"A"
"CACAACACAACAAACA-1"	"A"
"CACAACACAAGTAACA-1"	"G"
"CACAACACACGCGACT-1"	"G"
"CACAACACACTACACA-1"	"G"
"CACAACACATAGCCAT-1"	"A"
"CACAACACATGGGAAC-1"	"A"
"CACAACACATTGTGAC-1"	"G"
"CACAACAGTAACCATC-1"	"A"
"CACAACAGTCTGGGCT-1"	"A"
"CACAACAGTCTTAGCA-1"	"A"
"CACAACAGTGAATGGC-1"	"G"
"CACAACATCACCGCGA-1"	"A"
"CACAACATCCAGGGAA-1"	"G"
"CACAACATCCATCATT-1"	"A"
"CACAACATCTCATATC-1"	"G"
"CACAGATAGAAGACTT-1"	"G"
"CACAGATAGAGGCGGA-1"	"A"
"CACAGATAGGATGTCG-1"	"G"
"CACAGATAGTATGCTC-1"	"G"
"CACAGATAGTCCCTCT-1"	"A"
"CACAGATCAACTCCCT-1"	"A"
"CACAGATCAAGCGTCC-1"	"A"
"CACAGATCATTCGTCC-1"	"A"
"CACAGATGTACTTCAG-1"	"A"
"CACAGATGTATGCTAC-1"	"A"
"CACAGATGTCATTGGT-1"	"G"
"CACAGATGTCTGGTTA-1"	"G"
"CACAGATGTGCATCAT-1"	"G"
"CACAGATGTTGTGAGG-1"	"G"
"CACAGATGTTTGTGAC-1"	"G"
"CACAGATTCAGTTGAC-1"	"A"
"CACAGATTCCTCCCAA-1"	"A"
"CACAGATTCGTATAGC-1"	"G"
"CACAGATTCTCTGACC-1"	"G"
"CACAGATTCTGCCGAG-1"	"A"
"CACAGATTCTGTTTAC-1"	"G"
"CACAGATTCTTCACTA-1"	"A"
"CACATGAAGACTAGCG-1"	"A"
"CACATGAAGAGTTTGA-1"	"G"
"CACATGAAGTGTGTAA-1"	"A"
"CACATGACAATAGCGG-1"	"G"
"CACATGACAATTCGTG-1"	"G"
"CACATGAGTAAACCCT-1"	"G"
"CACATGAGTGCCGGTT-1"	"G"
"CACATGATCAATCGTG-1"	"G"
"CACATGATCATCGCAA-1"	"A"
"CACATGATCTTGTCAT-1"	"G"
"CACCACTAGAGAGGTA-1"	"A"
"CACCACTAGTACCACT-1"	"A"
"CACCACTCAAGTTGCT-1"	"G"
"CACCACTCAGAGCCAA-1"	"G"
"CACCACTGTCACTCTC-1"	"A"
"CACCACTGTTTAGACC-1"	"A"
"CACCACTTCAATGCAC-1"	"A"
"CACCACTTCCACGGCA-1"	"A"
"CACCACTTCCATATCT-1"	"G"
"CACCACTTCTCCACTG-1"	"G"
"CACCACTTCTTCAGAG-1"	"A"
"CACCACTTCTTGTCAT-1"	"G"
"CACCTGTAGCAATAAC-1"	"G"
"CACCTGTAGTGCAACG-1"	"A"
"CACCTGTCACGCGCAT-1"	"G"
"CACCTGTCAGAGAGAA-1"	"A"
"CACCTGTGTACGCCCA-1"	"A"
"CACCTGTGTCAGTGCC-1"	"G"
"CACCTGTGTGATGTGG-1"	"A"
"CACCTGTGTTTGAAGA-1"	"G"
"CACCTGTTCCAATCCC-1"	"A"
"CACCTGTTCCTTGACC-1"	"G"
"CACCTGTTCGAGTGTT-1"	"A"
"CACCTTGAGACTTGAA-1"	"G"
"CACCTTGAGGGTATCG-1"	"A"
"CACCTTGAGTCTGTGT-1"	"G"
"CACCTTGAGTGAGCAC-1"	"A"
"CACCTTGCACAGGAAC-1"	"A"
"CACCTTGCACCTGGTG-1"	"G"
"CACCTTGCACTCCCAT-1"	"G"
"CACCTTGCAGGGAGTT-1"	"A"
"CACCTTGGTAGTATCC-1"	"G"
"CACCTTGGTATGGTTC-1"	"G"
"CACCTTGGTCAGGCTC-1"	"A"
"CACCTTGGTCGACTGC-1"	"G"
"CACCTTGGTGATGCTT-1"	"A"
"CACCTTGGTTACCCAA-1"	"G"
"CACCTTGGTTCTGAGT-1"	"A"
"CACCTTGTCCGAATTG-1"	"A"
"CACCTTGTCCTTCGAC-1"	"A"
"CACCTTGTCGGGAATG-1"	"G"
"CACCTTGTCGGGCTCA-1"	"G"
"CACGTTCAGAGGAAGT-1"	"G"
"CACGTTCAGCAATGTA-1"	"A"
"CACGTTCAGGCGCTTC-1"	"A"
"CACGTTCAGGTTGACG-1"	"G"
"CACGTTCAGTTTACGC-1"	"G"
"CACGTTCCACAACGGA-1"	"G"
"CACGTTCCACAGTTCA-1"	"A"
"CACGTTCCACGACGAA-1"	"G"
"CACGTTCCAGCAGGTA-1"	"A"
"CACGTTCGTAGTTTGC-1"	"A"
"CACGTTCGTCAGTGCC-1"	"A"
"CACGTTCGTGATGCTT-1"	"G"
"CACGTTCGTGCCCAGT-1"	"A"
"CACGTTCGTGGATTCT-1"	"G"
"CACGTTCTCCATTGTT-1"	"A"
"CACGTTCTCCCGCAAG-1"	"A"
"CACTAAGAGAGATTAC-1"	"G"
"CACTAAGAGGAGTACC-1"	"A"
"CACTAAGCAAATTGAG-1"	"G"
"CACTAAGCAAGACTTC-1"	"G"
"CACTAAGCACAAACGG-1"	"G"
"CACTAAGCACAGATGG-1"	"G"
"CACTAAGCAGAAGTGC-1"	"G"
"CACTAAGGTAGAACGC-1"	"G"
"CACTAAGGTCGTAATC-1"	"A"
"CACTAAGGTTAAGGGC-1"	"G"
"CACTAAGTCAGTTGAC-1"	"A"
"CACTAAGTCTTCACTA-1"	"A"
"CACTGAAAGAGGCCTA-1"	"A"
"CACTGAAAGTAGTCGG-1"	"G"
"CACTGAACAACGTCGC-1"	"A"
"CACTGAACATATACGC-1"	"A"
"CACTGAACATCCGTAA-1"	"A"
"CACTGAAGTGAATCGG-1"	"A"
"CACTGAAGTGCATTCA-1"	"A"
"CACTGAAGTGCTGAAG-1"	"G"
"CACTGAAGTGGCCTCA-1"	"A"
"CACTGAATCCAGTACA-1"	"A"
"CACTGAATCGACTTAG-1"	"A"
"CACTGAATCGGAGTTT-1"	"A"
"CACTGAATCTATCTCA-1"	"A"
"CACTGAATCTGGGCGT-1"	"A"
"CAGCCTTAGATGAGGA-1"	"G"
"CAGCCTTAGATGTTGA-1"	"G"
"CAGCCTTAGGGTCTGA-1"	"G"
"CAGCCTTCACTCCTCA-1"	"A"
"CAGCCTTCAGACCTGC-1"	"G"
"CAGCCTTCATTTGGTG-1"	"A"
"CAGCCTTGTTACCACA-1"	"G"
"CAGCCTTTCGCGCTGA-1"	"G"
"CAGCTAAAGACAGCTG-1"	"A"
"CAGCTAAAGACGAAAG-1"	"A"
"CAGCTAAAGGCTTTAC-1"	"G"
"CAGCTAAAGTAACACA-1"	"A"
"CAGCTAAAGTCAGCCC-1"	"G"
"CAGCTAACAAGGCTTT-1"	"A"
"CAGCTAACAGGTGGTA-1"	"G"
"CAGCTAACATGCTATG-1"	"G"
"CAGCTAACATTTGGTG-1"	"G"
"CAGCTAATCCCGGGTA-1"	"G"
"CAGCTAATCGATCTTT-1"	"A"
"CAGCTGGAGAACGTCG-1"	"A"
"CAGCTGGAGCAACGGT-1"	"A"
"CAGCTGGAGGCCTCTG-1"	"A"
"CAGCTGGAGTGAAGGA-1"	"G"
"CAGCTGGAGTGCTAGG-1"	"G"
"CAGCTGGAGTTCCCGG-1"	"G"
"CAGCTGGCAACTCGAT-1"	"A"
"CAGCTGGCAATCCATG-1"	"A"
"CAGCTGGCACACTAGT-1"	"A"
"CAGCTGGCATTCCCGT-1"	"A"
"CAGCTGGGTAAAGCTA-1"	"A"
"CAGCTGGGTATTCTGG-1"	"A"
"CAGCTGGGTGGTAGAC-1"	"A"
"CAGCTGGTCACCGCGA-1"	"A"
"CAGCTGGTCCTCCCAA-1"	"A"
"CAGCTGGTCGATCTTT-1"	"A"
"CAGGATTAGGGTAATT-1"	"A"
"CAGGATTCAAGCGTCC-1"	"G"
"CAGGATTCAATGCACT-1"	"G"
"CAGGATTCACGTGAAG-1"	"A"
"CAGGATTCACTGTCAA-1"	"G"
"CAGGATTCAGGTCCTG-1"	"A"
"CAGGATTCATGGCCCA-1"	"G"
"CAGGATTGTCAATCCA-1"	"A"
"CAGGATTGTTCAGAAA-1"	"A"
"CAGGATTTCCAACAAC-1"	"A"
"CAGGATTTCTCGCGTT-1"	"A"
"CAGGATTTCTTACCTA-1"	"G"
"CAGGGCTAGAATATCG-1"	"A"
"CAGGGCTAGCGCATTT-1"	"G"
"CAGGGCTAGGAACCGT-1"	"A"
"CAGGGCTAGGGAGATA-1"	"A"
"CAGGGCTAGGTTGTGG-1"	"G"
"CAGGGCTAGTGAAACT-1"	"G"
"CAGGGCTAGTGTCGGA-1"	"G"
"CAGGGCTCAGTAGTCT-1"	"A"
"CAGGGCTCATACCCGG-1"	"G"
"CAGGGCTGTAACTGAA-1"	"G"
"CAGGGCTGTCGACTGC-1"	"G"
"CAGGGCTTCCCAGCAG-1"	"A"
"CAGGGCTTCGGTTCCT-1"	"A"
"CAGTATGAGCTAGCAG-1"	"A"
"CAGTATGAGGTCCTCG-1"	"A"
"CAGTATGAGTAACACA-1"	"A"
"CAGTATGAGTCTGCTA-1"	"G"
"CAGTATGCAAGTAACA-1"	"A"
"CAGTATGCAGGTAGCA-1"	"A"
"CAGTATGCATCGTGAT-1"	"A"
"CAGTATGGTATCTAGC-1"	"A"
"CAGTATGGTTCAGAAA-1"	"G"
"CAGTATGGTTCATTTC-1"	"A"
"CAGTATGGTTTCAGCA-1"	"G"
"CAGTATGTCCGAGAGA-1"	"A"
"CAGTATGTCCGAGGAA-1"	"G"
"CAGTGCGAGATATGTG-1"	"A"
"CAGTGCGAGTGAGTTA-1"	"G"
"CAGTGCGCAAGAGATT-1"	"G"
"CAGTGCGCACGTTGTA-1"	"G"
"CAGTGCGCACTTACAG-1"	"G"
"CAGTGCGGTAAGCCGA-1"	"A"
"CAGTGCGGTAGCGAGT-1"	"A"
"CAGTGCGGTATATGGA-1"	"A"
"CAGTGCGGTATGGATA-1"	"A"
"CAGTGCGGTATTGTCG-1"	"A"
"CAGTGCGTCCAACAAC-1"	"A"
"CAGTGCGTCCTTTGAT-1"	"A"
"CAGTGCGTCGTAGCGC-1"	"A"
"CAGTGCGTCGTTGTAG-1"	"G"
"CAGTGCGTCTGGCCAG-1"	"G"
"CAGTGTAAGAGCCACA-1"	"A"
"CAGTGTAAGCGCAATG-1"	"A"
"CAGTGTAAGCTTCAAC-1"	"G"
"CAGTGTAAGGAAGACA-1"	"G"
"CAGTGTAAGTCTCGAT-1"	"A"
"CAGTGTACAAGTAACA-1"	"A"
"CAGTGTACACAGAAGC-1"	"A"
"CAGTGTACAGGGTACA-1"	"A"
"CAGTGTATCAGTCACA-1"	"A"
"CAGTGTATCCAATCCC-1"	"A"
"CATAACGAGTGATAAC-1"	"A"
"CATAACGCATTGTGAC-1"	"A"
"CATAACGGTATTCTTC-1"	"A"
"CATAACGGTCGTAGTT-1"	"A"
"CATAACGGTGGTAAGC-1"	"A"
"CATAACGGTTAACCGT-1"	"A"
"CATAACGTCGCTACCT-1"	"G"
"CATAACGTCGGATAAA-1"	"A"
"CATAACGTCTCTATCA-1"	"G"
"CATGCCTAGAACCCGA-1"	"A"
"CATGCCTAGCGATACG-1"	"G"
"CATGCCTCAGTTAAAG-1"	"A"
"CATGCCTCATAGCAGG-1"	"G"
"CATGCCTCATTAACGC-1"	"G"
"CATGCCTGTCAGGCTC-1"	"A"
"CATGCCTGTGCTAGTT-1"	"A"
"CATGCCTGTTCCTATT-1"	"G"
"CATGCCTTCGCAAACT-1"	"G"
"CATGCCTTCGGAAAGC-1"	"G"
"CATGTTTAGAGACTCG-1"	"A"
"CATGTTTAGAGGCCTA-1"	"A"
"CATGTTTAGTGTTCCA-1"	"A"
"CATGTTTCAAGCACTT-1"	"G"
"CATGTTTGTGCCCGAT-1"	"G"
"CATGTTTTCCTCCATG-1"	"A"
"CATGTTTTCTCATATC-1"	"A"
"CATTCATAGACACAAT-1"	"A"
"CATTCATAGATCTCAC-1"	"G"
"CATTCATAGCTAGTTC-1"	"G"
"CATTCATAGGGCGAAG-1"	"G"
"CATTCATAGGTACTCT-1"	"A"
"CATTCATCACAGTTAC-1"	"A"
"CATTCATCAGAGAGAA-1"	"A"
"CATTCATCATCCGTGG-1"	"G"
"CATTCATGTAGACACG-1"	"A"
"CATTCATGTGATGCGA-1"	"A"
"CATTCATGTGTTGGTT-1"	"A"
"CATTCATTCAGGAATA-1"	"A"
"CATTCATTCCAGAGAG-1"	"G"
"CATTCATTCGAGTGTT-1"	"G"
"CATTCATTCTGAACGT-1"	"A"
"CATTCCGAGAGAGTTT-1"	"A"
"CATTCCGAGGTGTTGG-1"	"G"
"CATTCCGAGTACTCTG-1"	"A"
"CATTCCGAGTGATCTC-1"	"A"
"CATTCCGAGTGTCACT-1"	"A"
"CATTCCGAGTTGCGCC-1"	"G"
"CATTCCGCAACTGCGC-1"	"A"
"CATTCCGCACGTTGTA-1"	"G"
"CATTCCGCACTCCACT-1"	"G"
"CATTCCGCATTTGTTC-1"	"A"
"CATTCCGGTAGCATGG-1"	"G"
"CATTCCGGTATTCGCA-1"	"A"
"CATTCCGGTGATAAGT-1"	"A"
"CATTCCGGTTCTGAAC-1"	"A"
"CATTCCGTCCAACCTC-1"	"A"
"CATTCCGTCCGAGGAA-1"	"G"
"CATTCCGTCGCACCTT-1"	"A"
"CATTCCGTCTTCACTA-1"	"G"
"CATTGGACAAGACTTC-1"	"A"
"CATTGGACAAGCCTTA-1"	"A"
"CATTGGACATTATGGC-1"	"G"
"CATTGGAGTAAGTGCG-1"	"A"
"CATTGGAGTCTGCGCA-1"	"G"
"CATTGGAGTGTGACCC-1"	"G"
"CATTGGAGTTCCATCC-1"	"A"
"CATTGGATCCCTATTA-1"	"A"
"CATTGGATCCGAGGAA-1"	"G"
"CATTGGATCGTCGCAG-1"	"G"
"CCAATGAAGTACAACA-1"	"G"
"CCAATGAAGTAGACCG-1"	"G"
"CCAATGAAGTTAGCGG-1"	"A"
"CCAATGACAAGCAATA-1"	"G"
"CCAATGACACGCTGTG-1"	"G"
"CCAATGACATGATCGT-1"	"G"
"CCAATGACATGCACTA-1"	"G"
"CCAATGAGTCTCAAAC-1"	"A"
"CCAATGAGTCTGATTG-1"	"A"
"CCAATGAGTGCGCTCA-1"	"A"
"CCAATGAGTTAACTCG-1"	"A"
"CCAATGATCACATCCC-1"	"G"
"CCAATGATCACCCTTG-1"	"A"
"CCACAGGAGCGCCTAC-1"	"G"
"CCACAGGAGGGTAATT-1"	"A"
"CCACAGGAGGTGAACC-1"	"A"
"CCACAGGCACCATTCC-1"	"A"
"CCACAGGGTAACGTAA-1"	"A"
"CCACAGGGTATTCTTC-1"	"A"
"CCACAGGGTGCACATT-1"	"A"
"CCACAGGGTTCCGGCA-1"	"G"
"CCACAGGGTTGCAGCC-1"	"A"
"CCACGTTAGAGACTCG-1"	"G"
"CCACGTTAGCGCGTTC-1"	"A"
"CCACGTTAGTTAGCAA-1"	"A"
"CCACGTTCAACTCCCT-1"	"G"
"CCACGTTCAATGGCAG-1"	"A"
"CCACGTTCATACTGCA-1"	"A"
"CCACGTTCATCATCGA-1"	"A"
"CCACGTTCATTACACG-1"	"G"
"CCACGTTGTAACTCCA-1"	"G"
"CCACGTTTCCCAATAG-1"	"A"
"CCACGTTTCCCGATTC-1"	"G"
"CCACGTTTCTCTGACC-1"	"A"
"CCACGTTTCTTACTCA-1"	"A"
"CCACGTTTCTTTATCG-1"	"G"
"CCAGAATAGCATGTGG-1"	"G"
"CCAGAATAGGGACGTT-1"	"A"
"CCAGAATAGGTTAACA-1"	"A"
"CCAGAATAGTGAAGGA-1"	"A"
"CCAGAATCAAGGAAGA-1"	"A"
"CCAGAATCAGGACTGA-1"	"A"
"CCAGAATCATTAGCCA-1"	"A"
"CCAGAATGTACGGAGT-1"	"A"
"CCAGAATGTCCGGTAC-1"	"A"
"CCAGAATGTGCTTACA-1"	"G"
"CCAGAATTCAAAGTAG-1"	"A"
"CCAGAATTCAGTCTTT-1"	"G"
"CCAGAATTCCCGAAGC-1"	"G"
"CCAGAATTCTTAGTGG-1"	"A"
"CCAGATAAGACTAGGC-1"	"A"
"CCAGATAAGATTAGAC-1"	"G"
"CCAGATAAGCATTCCA-1"	"G"
"CCAGATAAGCGTCAAG-1"	"A"
"CCAGATACAAGACTAA-1"	"G"
"CCAGATACAATAGTGA-1"	"G"
"CCAGATAGTCTCTGGG-1"	"G"
"CCAGATAGTCTGGATT-1"	"A"
"CCAGATAGTGAATCAA-1"	"G"
"CCAGATATCCCATAGA-1"	"A"
"CCAGATATCGGCATAT-1"	"A"
"CCAGATATCGGCTATA-1"	"A"
"CCAGATATCGTCAACA-1"	"G"
"CCATACCAGCAACGGT-1"	"G"
"CCATACCAGCACGTAG-1"	"A"
"CCATACCAGCGTGTTT-1"	"G"
"CCATACCAGGCATGCA-1"	"G"
"CCATACCAGGGCTCTC-1"	"A"
"CCATACCAGGTTAGTA-1"	"G"
"CCATACCAGTAGTTCC-1"	"A"
"CCATACCCAAAGAAGG-1"	"A"
"CCATACCCAGCAACGA-1"	"A"
"CCATACCGTCGAGAAC-1"	"A"
"CCATACCTCACTAGGT-1"	"G"
"CCATACCTCGCGATGC-1"	"A"
"CCATACCTCTCTGACC-1"	"A"
"CCCACATCAGCAAACG-1"	"A"
"CCCACATCAGTCAGCC-1"	"A"
"CCCACATCATAGACGG-1"	"A"
"CCCACATGTCTGGTCG-1"	"A"
"CCCACATGTGCATTGT-1"	"G"
"CCCACATGTTTGGATC-1"	"G"
"CCCACATTCCCGGGTA-1"	"G"
"CCCAGAGAGAGTTCGG-1"	"G"
"CCCAGAGAGGACTAGC-1"	"A"
"CCCAGAGAGGCTCAGA-1"	"G"
"CCCAGAGAGGTCGTTT-1"	"A"
"CCCAGAGAGTGAAGGA-1"	"A"
"CCCAGAGGTGCTGTGC-1"	"A"
"CCCAGAGTCACTGGTA-1"	"G"
"CCCAGAGTCCAATAGC-1"	"G"
"CCCAGAGTCCATTGTT-1"	"A"
"CCCAGAGTCGCACAAT-1"	"A"
"CCCAGAGTCTCATATC-1"	"A"
"CCCAGAGTCTGATCTT-1"	"A"
"CCCGTTACAAGGCGTA-1"	"A"
"CCCGTTACACTCGTGG-1"	"A"
"CCCGTTACACTGCTCT-1"	"G"
"CCCGTTACAGTTACAC-1"	"A"
"CCCGTTACATGGTTTG-1"	"A"
"CCCGTTAGTATGGGTG-1"	"G"
"CCCGTTATCCATAGGT-1"	"A"
"CCCGTTATCGATGTAC-1"	"A"
"CCCGTTATCGTAGCGC-1"	"A"
"CCCTAACAGACACTTC-1"	"G"
"CCCTAACAGATGGCAC-1"	"A"
"CCCTAACAGCGCCTAC-1"	"G"
"CCCTAACAGGCTCCTG-1"	"A"
"CCCTAACAGGTTGACG-1"	"G"
"CCCTAACAGTGTCGCC-1"	"G"
"CCCTAACCAACGTCCG-1"	"A"
"CCCTAACCAAGGAACC-1"	"G"
"CCCTAACGTAAGCCGA-1"	"G"
"CCCTAACGTACCCATA-1"	"A"
"CCCTAACGTAGAATAC-1"	"G"
"CCCTAACGTAGCAGGT-1"	"A"
"CCCTAACGTCTGTCCT-1"	"A"
"CCCTAACGTGACGCAA-1"	"A"
"CCCTAACGTGCGCTCA-1"	"A"
"CCCTAACGTTCTGATG-1"	"G"
"CCCTAACTCACTAGCA-1"	"G"
"CCCTAACTCGAAGCCC-1"	"A"
"CCCTAACTCTAAGGTC-1"	"A"
"CCCTAACTCTAGCAGT-1"	"G"
"CCCTAGTAGCGAGAAA-1"	"A"
"CCCTAGTCAATTCTCT-1"	"G"
"CCCTAGTGTCGTAGTT-1"	"G"
"CCCTAGTGTCTGCGCA-1"	"A"
"CCCTAGTGTTGGGAAC-1"	"G"
"CCCTCTCAGAAAGGGT-1"	"A"
"CCCTCTCAGAATATCG-1"	"G"
"CCCTCTCAGTAACATG-1"	"A"
"CCCTCTCAGTACCTCA-1"	"G"
"CCCTCTCAGTATGCTC-1"	"G"
"CCCTCTCAGTGAAGGA-1"	"G"
"CCCTCTCAGTGCTAGG-1"	"A"
"CCCTCTCAGTTGTCCA-1"	"A"
"CCCTCTCCAAGAGATT-1"	"A"
"CCCTCTCCATGGCCCA-1"	"A"
"CCCTCTCCATTACTCT-1"	"A"
"CCCTCTCGTAATGCCT-1"	"A"
"CCCTCTCGTCCCGTGA-1"	"G"
"CCCTCTCGTCTCTGGG-1"	"A"
"CCCTCTCGTCTGTTGA-1"	"G"
"CCCTCTCGTGCGTTTA-1"	"A"
"CCCTCTCTCCGATGCG-1"	"A"
"CCCTGATAGTACGCGA-1"	"A"
"CCCTGATCAAGGACCA-1"	"G"
"CCCTGATCATCCTCGT-1"	"A"
"CCCTGATGTTTAGGAA-1"	"A"
"CCCTGATTCATTGCCC-1"	"G"
"CCCTGATTCCCGTATC-1"	"G"
"CCCTGATTCGCAAGCC-1"	"A"
"CCCTGATTCGCCGAAC-1"	"G"
"CCCTGATTCGTTGTAG-1"	"A"
"CCCTGATTCTCTGAGA-1"	"A"
"CCCTGATTCTGGCACG-1"	"G"
"CCCTGATTCTGGCGCA-1"	"G"
"CCGAAGCAGACACTTC-1"	"A"
"CCGAAGCGTAGACACG-1"	"A"
"CCGAAGCGTCGAGGAT-1"	"A"
"CCGAAGCGTTTCTCTA-1"	"A"
"CCGAAGCTCGAGCGCT-1"	"G"
"CCGAAGCTCGGTCAGC-1"	"G"
"CCGAAGCTCTCCTTGG-1"	"G"
"CCGAAGCTCTTACTCA-1"	"G"
"CCGCATTAGACAACGC-1"	"A"
"CCGCATTAGACACAAT-1"	"A"
"CCGCATTAGAGGCGGA-1"	"A"
"CCGCATTAGGCTGGAT-1"	"G"
"CCGCATTAGGGACGTT-1"	"G"
"CCGCATTAGGTTAACA-1"	"G"
"CCGCATTCACCCATCT-1"	"A"
"CCGCATTCACGCCGAT-1"	"A"
"CCGCATTCACTGAAGG-1"	"G"
"CCGCATTCACTGTTAG-1"	"A"
"CCGCATTCATGATCGT-1"	"G"
"CCGCATTGTAACAATG-1"	"A"
"CCGCATTGTATGCTAC-1"	"A"
"CCGCATTGTTCTTAGG-1"	"A"
"CCGCATTGTTGGAGGT-1"	"G"
"CCGCATTTCCTGGGAC-1"	"A"
"CCGCATTTCGGTTCCT-1"	"G"
"CCGCATTTCGTGTGCG-1"	"A"
"CCGCATTTCTATCTCA-1"	"A"
"CCGTACTAGCACACCC-1"	"G"
"CCGTACTAGTCAGCCC-1"	"G"
"CCGTACTGTATGAAGT-1"	"A"
"CCGTACTGTCATCAAC-1"	"G"
"CCGTACTGTGCTGTGC-1"	"A"
"CCGTACTGTTAACTCG-1"	"A"
"CCGTACTTCGGAAAGC-1"	"A"
"CCGTACTTCGTCGCAG-1"	"A"
"CCGTACTTCGTTGTAG-1"	"A"
"CCGTACTTCTCTGAGA-1"	"A"
"CCGTAGGAGATTGACA-1"	"A"
"CCGTAGGCACAGCCAC-1"	"A"
"CCGTAGGCATGTGAGG-1"	"A"
"CCGTAGGCATTGAACC-1"	"A"
"CCGTAGGTCACCCTTG-1"	"A"
"CCGTAGGTCCGGCTGA-1"	"A"
"CCGTAGGTCGTGATAC-1"	"A"
"CCGTAGGTCGTGGTAT-1"	"A"
"CCGTAGGTCTATCTAC-1"	"G"
"CCGTGAGAGGCCTCTG-1"	"A"
"CCGTGAGCAGTAGGCA-1"	"A"
"CCGTGAGGTCAGAGTG-1"	"G"
"CCGTGAGTCCGGCTGA-1"	"A"
"CCGTGAGTCTGATCTT-1"	"G"
"CCTAAAGAGGGCTTCC-1"	"G"
"CCTAAAGAGGGTTCTT-1"	"A"
"CCTAAAGAGTATCTGC-1"	"A"
"CCTAAAGCAGTAGTCT-1"	"G"
"CCTAAAGCAGTTGCAT-1"	"G"
"CCTAAAGGTAAGGTCG-1"	"A"
"CCTAAAGGTATGGGTG-1"	"A"
"CCTAAAGGTATGTCCA-1"	"A"
"CCTAAAGGTTACACTG-1"	"G"
"CCTAAAGTCCCGGGTA-1"	"G"
"CCTATTAAGTACTCTG-1"	"G"
"CCTATTAAGTTACCAC-1"	"G"
"CCTATTACAGAACTTC-1"	"A"
"CCTATTACAGTTGCAT-1"	"A"
"CCTATTACATCTCACC-1"	"A"
"CCTATTAGTCAGACGA-1"	"G"
"CCTATTAGTCATCGTA-1"	"A"
"CCTATTAGTCCAGACC-1"	"A"
"CCTATTAGTGCAACAG-1"	"G"
"CCTATTAGTTCAGTAC-1"	"G"
"CCTATTATCAGTGTGT-1"	"A"
"CCTATTATCGACCCGA-1"	"A"
"CCTATTATCGTCAACA-1"	"G"
"CCTCCCTAGGTCACTT-1"	"G"
"CCTCCCTAGGTTACAA-1"	"G"
"CCTCCCTCACATTCTT-1"	"A"
"CCTCCCTCACCTGAAT-1"	"A"
"CCTCCCTGTAATGCCT-1"	"G"
"CCTCCCTGTAGAACGC-1"	"A"
"CCTCCCTGTATGGATA-1"	"G"
"CCTCCCTGTGCTTACA-1"	"G"
"CCTCCCTGTGGCATAG-1"	"A"
"CCTCCCTTCGGTTAGT-1"	"A"
"CCTCCCTTCGTTTGAG-1"	"G"
"CCTGCTAAGACCAATA-1"	"A"
"CCTGCTAAGCTGCTCG-1"	"A"
"CCTGCTAAGTGATTAG-1"	"A"
"CCTGCTAAGTGTCACT-1"	"G"
"CCTGCTACAGGAGCAT-1"	"A"
"CCTGCTACAGTATACC-1"	"G"
"CCTGCTACATTGTTCT-1"	"G"
"CCTGCTAGTATGGTTC-1"	"A"
"CCTGCTATCAGGCCGT-1"	"A"
"CCTGCTATCCATGACA-1"	"A"
"CCTGCTATCCCACTTG-1"	"G"
"CCTGCTATCTCTGACC-1"	"A"
"CCTGCTATCTGAACGT-1"	"G"
"CCTGCTATCTTAGTGG-1"	"A"
"CCTGGGAAGATAGGTT-1"	"G"
"CCTGGGAAGGACCGAT-1"	"A"
"CCTGGGAAGTCTCCAA-1"	"A"
"CCTGGGACAAGGAAGA-1"	"G"
"CCTGGGACAGCCACGT-1"	"A"
"CCTGGGAGTCGCTACG-1"	"G"
"CCTGGGAGTGCAGACA-1"	"G"
"CCTGGGAGTGTCCCAG-1"	"A"
"CCTGGGAGTTCCAATG-1"	"A"
"CCTGGGAGTTTAGACC-1"	"G"
"CCTGGGATCCGGACTG-1"	"A"
"CCTGGGATCGCAAACT-1"	"G"
"CCTTAATAGACTCTTG-1"	"G"
"CCTTAATAGAGGTGGG-1"	"A"
"CCTTAATAGCAGAATT-1"	"A"
"CCTTAATAGGCACTAG-1"	"A"
"CCTTAATCAATCAGGG-1"	"G"
"CCTTAATCAGGCAAGT-1"	"A"
"CCTTAATGTCAGCAAG-1"	"A"
"CCTTAATGTCCTTATT-1"	"G"
"CCTTAATGTTATAGAG-1"	"G"
"CCTTAATTCCACTAGA-1"	"G"
"CCTTAATTCCCGCAAG-1"	"G"
"CCTTAATTCGGTTGTA-1"	"G"
"CCTTAATTCTCGACAA-1"	"A"
"CCTTGCAAGCAACGGT-1"	"A"
"CCTTGCAAGCAATGTA-1"	"A"
"CCTTGCAAGCCATGGA-1"	"A"
"CCTTGCAAGGACTTTC-1"	"A"
"CCTTGCAAGGTTTCTG-1"	"G"
"CCTTGCAAGTCCCTCT-1"	"A"
"CCTTGCAAGTCCGGAA-1"	"A"
"CCTTGCAAGTGTTCCA-1"	"A"
"CCTTGCACAAAGAAGG-1"	"A"
"CCTTGCACAGGTGGTA-1"	"G"
"CCTTGCATCTATCTCA-1"	"A"
"CCTTGGTAGGCGTAGT-1"	"A"
"CCTTGGTAGTCATCTG-1"	"A"
"CCTTGGTAGTCGTATC-1"	"G"
"CCTTGGTCAACGTCCG-1"	"A"
"CCTTGGTCAAGCCTTA-1"	"G"
"CCTTGGTCAGGGAGTT-1"	"G"
"CCTTGGTGTCCCGTGA-1"	"A"
"CCTTGGTTCAGGGTTT-1"	"A"
"CCTTGGTTCTTTGCAT-1"	"A"
"CGAGTTAAGGCGATTG-1"	"A"
"CGAGTTAAGTGTCACT-1"	"A"
"CGAGTTACACTAGCCG-1"	"A"
"CGAGTTAGTCCCGTGA-1"	"A"
"CGAGTTAGTCTGTGTA-1"	"G"
"CGAGTTAGTTATAGAG-1"	"A"
"CGAGTTAGTTCTACCC-1"	"A"
"CGAGTTATCAGCACGC-1"	"G"
"CGAGTTATCGTGGCGT-1"	"A"
"CGATGATAGAATACTG-1"	"G"
"CGATGATAGGTCTTTG-1"	"G"
"CGATGATAGTTACCAC-1"	"A"
"CGATGATAGTTAGCAA-1"	"G"
"CGATGATCACGCCGAT-1"	"A"
"CGATGATCATGGAGGT-1"	"G"
"CGATGATCATTGTGAC-1"	"A"
"CGATGATTCAGCACGC-1"	"G"
"CGCAATAAGAACGCCA-1"	"A"
"CGCAATAAGGAGTACC-1"	"A"
"CGCAATAAGTCTCTAG-1"	"G"
"CGCAATAAGTTCAACC-1"	"G"
"CGCAATACACGTTGTA-1"	"A"
"CGCAATACAGCACATT-1"	"G"
"CGCAATAGTAACGGAC-1"	"A"
"CGCAATAGTAGTCTGT-1"	"A"
"CGCAATAGTCTGGTCG-1"	"G"
"CGCAATAGTCTGTGTA-1"	"A"
"CGCAATAGTTTCTTAC-1"	"G"
"CGCAATATCAGTGGTT-1"	"A"
"CGCAATATCGCGTTCT-1"	"A"
"CGCAATATCGGATAAA-1"	"G"
"CGCACAGAGAAATGGG-1"	"G"
"CGCACAGAGGAGTCTG-1"	"A"
"CGCACAGAGGGTCCCT-1"	"G"
"CGCACAGCAAAGGCCA-1"	"G"
"CGCACAGCAAAGGTCG-1"	"A"
"CGCACAGCATATAGAG-1"	"A"
"CGCACAGCATCGAGTT-1"	"G"
"CGCACAGGTGCTTTGA-1"	"A"
"CGCACAGGTTACGAAA-1"	"G"
"CGCACAGGTTCACGTA-1"	"G"
"CGCACAGTCATTCTCA-1"	"A"
"CGCACAGTCGGATAGG-1"	"A"
"CGCACAGTCTCTGCAC-1"	"G"
"CGCAGGTAGCATTCCA-1"	"A"
"CGCAGGTAGCGCATTT-1"	"G"
"CGCAGGTAGCGTCTGC-1"	"G"
"CGCAGGTCAACTAGAA-1"	"A"
"CGCAGGTCAGACTAAA-1"	"A"
"CGCAGGTGTTCACGTA-1"	"G"
"CGCAGGTGTTGTGACT-1"	"G"
"CGCAGGTTCCGTGCAG-1"	"A"
"CGCAGGTTCTCGCGTT-1"	"A"
"CGCGCAAAGTGTCCCG-1"	"A"
"CGCGCAACAAAGAAGG-1"	"A"
"CGCGCAAGTCAGCTTA-1"	"A"
"CGCGCAAGTCCATTGA-1"	"A"
"CGCGCAATCAGCCGGT-1"	"A"
"CGCGCAATCAGGCCGT-1"	"G"
"CGCGCAATCATTCGGA-1"	"G"
"CGCGCAATCTGGCGCA-1"	"A"
"CGCTAGGAGAGCTGTG-1"	"A"
"CGCTAGGAGAGGAATG-1"	"G"
"CGCTAGGAGGTACACG-1"	"G"
"CGCTAGGAGTCCAGAG-1"	"G"
"CGCTAGGCACCATTCC-1"	"G"
"CGCTAGGCATCATGTG-1"	"A"
"CGCTAGGGTCAGAAGC-1"	"A"
"CGCTAGGGTCTGGGAA-1"	"G"
"CGCTAGGGTGAGGGTT-1"	"G"
"CGCTATCAGAACGTCG-1"	"A"
"CGCTATCAGAAGCCGT-1"	"A"
"CGCTATCAGCATGATA-1"	"G"
"CGCTATCAGGACTTTC-1"	"G"
"CGCTATCAGGATTGAT-1"	"G"
"CGCTATCAGTGATCTC-1"	"A"
"CGCTATCAGTGCAACG-1"	"G"
"CGCTATCCAAAGGTCG-1"	"A"
"CGCTATCCACTCGGAC-1"	"A"
"CGCTATCGTACGCCCA-1"	"G"
"CGCTATCGTATGGTTC-1"	"A"
"CGCTATCGTGACAAGC-1"	"A"
"CGCTATCGTTCTGATG-1"	"G"
"CGCTATCTCAGGAAGC-1"	"A"
"CGCTATCTCGAGTTAC-1"	"G"
"CGCTATCTCGATGCAT-1"	"A"
"CGCTATCTCGTGAACT-1"	"G"
"CGCTATCTCGTTTGAG-1"	"G"
"CGCTGGACAATTGTGC-1"	"G"
"CGCTGGACATCTCTCG-1"	"G"
"CGCTGGACATTCTCGC-1"	"A"
"CGCTGGAGTACGTAGG-1"	"A"
"CGCTGGAGTAGGGTCA-1"	"A"
"CGCTGGAGTATTGTCG-1"	"A"
"CGCTGGAGTCAGGCTC-1"	"G"
"CGCTGGAGTCCACCAG-1"	"G"
"CGCTGGAGTCCGTCGA-1"	"A"
"CGCTGGAGTGCACCCA-1"	"A"
"CGCTGGAGTTTGTAGC-1"	"G"
"CGCTGGATCAATGCAC-1"	"A"
"CGCTGGATCCACCTAC-1"	"A"
"CGCTGGATCTCGTGAA-1"	"A"
"CGCTGGATCTGGACAT-1"	"A"
"CGCTGGATCTGGCCAG-1"	"A"
"CGGACCAAGCTGGAGT-1"	"G"
"CGGACCAAGTACAGAT-1"	"A"
"CGGACCAAGTCGAAAT-1"	"G"
"CGGACCAAGTTCAACC-1"	"G"
"CGGACCACAAAGGAAG-1"	"G"
"CGGACCACACCACCAG-1"	"A"
"CGGACCACACCTGGTG-1"	"A"
"CGGACCACAGTAACCT-1"	"A"
"CGGACCACAGTGCGAA-1"	"A"
"CGGACCACATGACTGT-1"	"A"
"CGGACCACATTCGTCC-1"	"G"
"CGGACCAGTCTGGGAA-1"	"A"
"CGGACCAGTGCACCCA-1"	"G"
"CGGACCATCCCGCAAG-1"	"A"
"CGGACCATCCTTCGAC-1"	"G"
"CGGACTGAGGAATGGA-1"	"G"
"CGGACTGCAATGGCAG-1"	"G"
"CGGACTGCACGCTAAT-1"	"A"
"CGGACTGCAGTAAGAT-1"	"A"
"CGGACTGCATCGTGAT-1"	"G"
"CGGACTGGTAGCGTTT-1"	"G"
"CGGACTGTCCTGTAGA-1"	"A"
"CGGACTGTCTACTTTG-1"	"A"
"CGGACTGTCTGGCACG-1"	"A"
"CGGTGCAAGATATGAC-1"	"G"
"CGGTGCAAGCTGAAAT-1"	"A"
"CGGTGCAAGGACTTTC-1"	"A"
"CGGTGCAAGGCTTTAC-1"	"A"
"CGGTGCAAGTACGCGA-1"	"G"
"CGGTGCACAAACCCTA-1"	"A"
"CGGTGCACACTGAAGG-1"	"A"
"CGGTGCACACTGCTCT-1"	"A"
"CGGTGCACAGCAGGTA-1"	"A"
"CGGTGCACATGATCGT-1"	"A"
"CGGTGCAGTATCAGCT-1"	"A"
"CGGTGCAGTATTCGAC-1"	"G"
"CGGTGCAGTCAGCTTA-1"	"G"
"CGGTGCATCAACACGT-1"	"G"
"CGGTGCATCTCGTGAA-1"	"A"
"CGGTGCATCTGAACGT-1"	"G"
"CGGTGCATCTTTCGAT-1"	"A"
"CGTAAACAGCGCGTTC-1"	"A"
"CGTAAACAGGATTAAC-1"	"G"
"CGTAAACAGGGAAATG-1"	"A"
"CGTAAACAGTCTGCTA-1"	"A"
"CGTAAACCAAGAGATT-1"	"A"
"CGTAAACGTCAGGTGA-1"	"G"
"CGTAAACGTGCGTTTA-1"	"A"
"CGTAAACTCAAACCCA-1"	"A"
"CGTAAACTCCTGTGGG-1"	"G"
"CGTACAAAGGTCGGTA-1"	"A"
"CGTACAAAGTACGACG-1"	"A"
"CGTACAACAATACTGC-1"	"A"
"CGTACAACACTAAACC-1"	"G"
"CGTACAACATCCTGGG-1"	"G"
"CGTACAAGTCAACGGA-1"	"G"
"CGTACAAGTCCACCAG-1"	"G"
"CGTACAATCACAGGGA-1"	"A"
"CGTACAATCCAACCTC-1"	"G"
"CGTACAATCCCTACGT-1"	"G"
"CGTACAATCCGCTATC-1"	"A"
"CGTACAATCCTATCAT-1"	"A"
"CGTACAATCCTCAAGA-1"	"G"
"CGTACAATCGCTATAG-1"	"A"
"CGTACAATCGGACGAA-1"	"A"
"CGTGGCAAGGAAGACA-1"	"G"
"CGTGGCAAGGAATGGA-1"	"A"
"CGTGGCAAGGTTGACG-1"	"G"
"CGTGGCACACCGATCG-1"	"A"
"CGTGGCAGTCCCGAGT-1"	"G"
"CGTGGCAGTTCTTTGT-1"	"G"
"CGTGGCAGTTTGGATC-1"	"A"
"CGTGGCATCTGTGTGA-1"	"A"
"CGTTCCAAGCACACCC-1"	"A"
"CGTTCCAAGGATTTGA-1"	"A"
"CGTTCCAAGTAGGAAG-1"	"A"
"CGTTCCAAGTCGAGCA-1"	"A"
"CGTTCCACAACAACTC-1"	"A"
"CGTTCCACAACTCGAT-1"	"A"
"CGTTCCACAAGTTGCT-1"	"G"
"CGTTCCACACCTGGTG-1"	"A"
"CGTTCCACAGATACAA-1"	"A"
"CGTTCCAGTAACCATC-1"	"G"
"CGTTCCAGTAACGTAA-1"	"G"
"CGTTCCAGTCAGCAAG-1"	"G"
"CGTTCCAGTGACGCAA-1"	"A"
"CGTTCCAGTGGTTCTA-1"	"A"
"CGTTCCATCGCACCGA-1"	"A"
"CTAACTTAGATTACGA-1"	"A"
"CTAACTTAGCAGAATT-1"	"A"
"CTAACTTAGCATGATA-1"	"A"
"CTAACTTAGGCGTAGT-1"	"A"
"CTAACTTAGTTCTCCC-1"	"G"
"CTAACTTCAAAGACGC-1"	"G"
"CTAACTTCAGAACTTC-1"	"A"
"CTAACTTCATACTGCA-1"	"A"
"CTAACTTCATGATTGC-1"	"G"
"CTAACTTGTACCAAGG-1"	"A"
"CTAACTTGTACTTGAC-1"	"G"
"CTAACTTGTAGCGGTA-1"	"G"
"CTAACTTGTGCGTAGA-1"	"G"
"CTAACTTGTTACCCAA-1"	"A"
"CTAACTTGTTTGCCAA-1"	"A"
"CTAACTTTCAGAGTGG-1"	"A"
"CTACAGAAGGGACGTT-1"	"G"
"CTACAGACATGGCCTG-1"	"A"
"CTACAGACATGTGGGA-1"	"G"
"CTACAGAGTAACGGCA-1"	"G"
"CTACAGAGTAGTTTGC-1"	"G"
"CTACAGAGTATCACAC-1"	"G"
"CTACAGAGTGCCCTAG-1"	"A"
"CTACAGAGTGTGAGGT-1"	"A"
"CTACAGATCAAGGCCC-1"	"G"
"CTACAGATCCAGCACG-1"	"A"
"CTACAGATCGCATAAC-1"	"G"
"CTACTTAAGCTAGCAG-1"	"G"
"CTACTTAAGGAAGAAC-1"	"A"
"CTACTTAAGGGTGTTG-1"	"G"
"CTACTTAAGTATGCTC-1"	"A"
"CTACTTAAGTCTAGAA-1"	"A"
"CTACTTAAGTGAAACT-1"	"A"
"CTACTTACAGGGAGTT-1"	"A"
"CTACTTAGTATCCCTC-1"	"A"
"CTACTTAGTCACAGGA-1"	"G"
"CTACTTAGTCCCGTGA-1"	"A"
"CTACTTAGTCTAAAGA-1"	"G"
"CTACTTAGTCTGGATT-1"	"A"
"CTACTTATCCCACGGA-1"	"A"
"CTAGCGGAGACACAAT-1"	"A"
"CTAGCGGAGGCGCTTC-1"	"G"
"CTAGCGGCAAGGAGGG-1"	"A"
"CTAGCGGCACATAAAG-1"	"G"
"CTAGCGGCACATTCTT-1"	"A"
"CTAGCGGCACCGTCTT-1"	"A"
"CTAGCGGCACGTTACA-1"	"G"
"CTAGCGGCAGTTGGAG-1"	"G"
"CTAGCGGGTGTTGTTG-1"	"G"
"CTAGCGGTCGCTTCAC-1"	"G"
"CTAGCGGTCGGATCGC-1"	"A"
"CTAGCGGTCGTATAGC-1"	"G"
"CTAGCGGTCTGCTACC-1"	"A"
"CTAGGATAGTACCTCA-1"	"A"
"CTAGGATAGTAGTCGG-1"	"G"
"CTAGGATAGTCTCGAT-1"	"A"
"CTAGGATAGTTCCAGT-1"	"A"
"CTAGGATCAAATTCCG-1"	"A"
"CTAGGATCAATTGCCA-1"	"G"
"CTAGGATCACCTGAAT-1"	"G"
"CTAGGATCAGCAATGG-1"	"A"
"CTAGGATCATCGTACA-1"	"G"
"CTAGGATGTACGCAAG-1"	"G"
"CTAGGATGTACTTCAG-1"	"A"
"CTAGGATGTCAGGCTC-1"	"A"
"CTAGGATGTCGTAGTT-1"	"A"
"CTAGGATGTCTAACCA-1"	"A"
"CTAGGATGTGCCCGAT-1"	"G"
"CTAGGATGTTTCGATG-1"	"A"
"CTAGGATTCTCCAACC-1"	"A"
"CTAGGATTCTCTGTTA-1"	"A"
"CTAGGGCGTAGAAAGG-1"	"A"
"CTAGGGCGTCACAGTT-1"	"A"
"CTAGGGCGTTCAGTAC-1"	"G"
"CTAGGGCGTTGCTTGA-1"	"A"
"CTAGGGCTCACCACAA-1"	"A"
"CTAGGGCTCCCAGTAA-1"	"G"
"CTAGGGCTCCTCCAGT-1"	"G"
"CTAGGGCTCGCCCTTA-1"	"G"
"CTAGGGCTCGCGTGAC-1"	"G"
"CTAGGGCTCGTATAGC-1"	"A"
"CTCAACCAGGAATGGA-1"	"A"
"CTCAACCAGTACGCGA-1"	"A"
"CTCAACCAGTCCTTCC-1"	"G"
"CTCAACCCAATGCATC-1"	"G"
"CTCAACCCACCGATCG-1"	"A"
"CTCAACCCAGTCAGAG-1"	"G"
"CTCAACCGTATTGTCG-1"	"A"
"CTCAACCGTGCATTGT-1"	"A"
"CTCAACCGTTGGAGGT-1"	"A"
"CTCAACCTCGCATACA-1"	"G"
"CTCAACCTCGCCTTAC-1"	"A"
"CTCAACCTCTATACCT-1"	"G"
"CTCAACCTCTGTGTGA-1"	"G"
"CTCACCAAGAAACGCC-1"	"A"
"CTCACCAAGATGTTGA-1"	"A"
"CTCACCAAGTGTAATG-1"	"A"
"CTCACCAAGTTCTCCC-1"	"A"
"CTCACCACAATGCATC-1"	"A"
"CTCACCATCCTTTGAT-1"	"G"
"CTCAGAAAGACTTGAA-1"	"G"
"CTCAGAAAGCTGATTC-1"	"A"
"CTCAGAAAGTCCCTCT-1"	"A"
"CTCAGAAAGTCTGCTA-1"	"A"
"CTCAGAAAGTTCAAGA-1"	"G"
"CTCAGAACAAACCGAG-1"	"A"
"CTCAGAACAAAGCATA-1"	"G"
"CTCAGAACACGCGACT-1"	"G"
"CTCAGAACAGATACAA-1"	"A"
"CTCAGAAGTAAAGGCC-1"	"A"
"CTCAGAAGTACCTATG-1"	"A"
"CTCAGAAGTACTTCAG-1"	"A"
"CTCAGAAGTTACTACG-1"	"G"
"CTCAGAAGTTCGGGAA-1"	"G"
"CTCAGAATCACTCGGG-1"	"A"
"CTCAGAATCCGTGCAG-1"	"G"
"CTCAGAATCGCAAACT-1"	"A"
"CTCAGAATCGTGTGCG-1"	"G"
"CTCAGAATCTCTCAAT-1"	"G"
"CTCAGAATCTGGCACG-1"	"A"
"CTCAGCTAGAGACTCG-1"	"A"
"CTCAGCTAGGTCACTT-1"	"A"
"CTCAGCTAGTGTCACT-1"	"A"
"CTCAGCTCACCGATCG-1"	"G"
"CTCAGCTCAGGTTATC-1"	"A"
"CTCAGCTCATACAACC-1"	"G"
"CTCAGCTGTACGGATG-1"	"G"
"CTCAGCTGTACTAGAA-1"	"A"
"CTCAGCTGTTAGTAGA-1"	"A"
"CTCAGCTTCCAGGGAA-1"	"G"
"CTCAGCTTCGAGGCTC-1"	"A"
"CTCAGCTTCGAGTTAC-1"	"G"
"CTCAGCTTCTTAAGCG-1"	"G"
"CTCAGCTTCTTCATAC-1"	"A"
"CTCAGCTTCTTGCGCT-1"	"A"
"CTCATGCAGAATATCG-1"	"G"
"CTCATGCAGGAAGAAC-1"	"G"
"CTCATGCAGGGTGTTG-1"	"A"
"CTCATGCCAGCAACAG-1"	"A"
"CTCATGCCAGGTAGGT-1"	"A"
"CTCATGCCATCCGTAA-1"	"A"
"CTCATGCGTAAAGCTA-1"	"G"
"CTCATGCGTCAAACAA-1"	"G"
"CTCATGCGTCTGTGTA-1"	"G"
"CTCATGCTCAAATGGA-1"	"A"
"CTCATGCTCAACACGT-1"	"A"
"CTCATGCTCACTTACT-1"	"G"
"CTCATGCTCCATGTTT-1"	"G"
"CTCCCAAAGACTTGAA-1"	"A"
"CTCCCAAAGCAGGAGG-1"	"G"
"CTCCCAAAGCTCCGGT-1"	"A"
"CTCCCAACAAGTAATG-1"	"G"
"CTCCCAACACCACCAG-1"	"A"
"CTCCCAACACCTCGTT-1"	"G"
"CTCCCAACACGTTACA-1"	"A"
"CTCCCAACACTGTCAA-1"	"G"
"CTCCCAACAGTAGTTC-1"	"A"
"CTCCCAAGTCTGAGCC-1"	"G"
"CTCCCAAGTGCCCTAG-1"	"G"
"CTCCCAAGTTGGTAAA-1"	"A"
"CTCCCAATCAGAGTGG-1"	"A"
"CTCCCAATCCATCATT-1"	"A"
"CTCCCAATCGCCACTT-1"	"A"
"CTCCCAATCGGCTATA-1"	"A"
"CTCGCTAAGACCCTAT-1"	"G"
"CTCGCTAAGCCTCGCA-1"	"A"
"CTCGCTAAGGTTCGAG-1"	"G"
"CTCGCTACAAGGATGC-1"	"G"
"CTCGCTACATGTCCCT-1"	"G"
"CTCGCTAGTAGAAGCC-1"	"G"
"CTCGCTAGTATCTCAG-1"	"G"
"CTCGCTAGTTACCACA-1"	"G"
"CTCGCTATCACTTACT-1"	"G"
"CTCGCTATCAGTGGTT-1"	"A"
"CTCTACGAGACCGCAA-1"	"A"
"CTCTACGAGGTCGTTT-1"	"A"
"CTCTACGAGTCTGCTA-1"	"A"
"CTCTACGAGTTCAAGA-1"	"A"
"CTCTACGAGTTCGTTG-1"	"A"
"CTCTACGCACCTCGTT-1"	"A"
"CTCTACGGTTTCCACC-1"	"G"
"CTCTACGGTTTGCGAT-1"	"G"
"CTCTACGTCCTCCAGT-1"	"A"
"CTCTAGCAGAGGCAGG-1"	"G"
"CTCTAGCAGTCAACTC-1"	"G"
"CTCTAGCCAACACGGA-1"	"G"
"CTCTAGCCAGGCAAGT-1"	"A"
"CTCTAGCCATCAACTG-1"	"G"
"CTCTAGCGTATCTCAG-1"	"G"
"CTCTAGCGTATGGGTG-1"	"G"
"CTCTAGCTCCTTCGAC-1"	"A"
"CTCTCAGAGAAATACC-1"	"G"
"CTCTCAGAGAGATTAC-1"	"A"
"CTCTCAGAGAGCGGTT-1"	"A"
"CTCTCAGAGCATGTGG-1"	"A"
"CTCTCAGAGGAGGCGA-1"	"G"
"CTCTCAGAGGGTCCCT-1"	"G"
"CTCTCAGCAATGAAAC-1"	"G"
"CTCTCAGCACTGATAC-1"	"G"
"CTCTCAGCAGGGCTTC-1"	"A"
"CTCTCAGCATAGCCAT-1"	"A"
"CTCTCAGCATTCTCGC-1"	"A"
"CTCTCAGTCAAAGTAG-1"	"A"
"CTCTCAGTCGGTACTA-1"	"G"
"CTCTCAGTCTATACCT-1"	"G"
"CTCTCAGTCTTGGCCT-1"	"A"
"CTCTCGAAGAATCAGT-1"	"A"
"CTCTCGAAGATGTTCC-1"	"G"
"CTCTCGAAGCCATCAT-1"	"A"
"CTCTCGAAGCTGCCAC-1"	"G"
"CTCTCGAAGGTTCGTT-1"	"A"
"CTCTCGACACGTGAAG-1"	"G"
"CTCTCGACAGGCATCC-1"	"A"
"CTCTCGACATCCTGGG-1"	"A"
"CTCTCGACATGTCCCT-1"	"G"
"CTCTCGAGTCAAGACG-1"	"G"
"CTCTCGATCCAGGGAA-1"	"A"
"CTCTCGATCCATAACG-1"	"G"
"CTCTCGATCCCTACGT-1"	"G"
"CTGAATGAGAGAAGCA-1"	"A"
"CTGAATGAGCGTGTTT-1"	"G"
"CTGAATGAGCTTACCA-1"	"A"
"CTGAATGAGTTCGACT-1"	"G"
"CTGAATGCAAGGGTAC-1"	"G"
"CTGAATGCATCGACGC-1"	"A"
"CTGAATGGTAAGCCGA-1"	"G"
"CTGAATGGTTTCACCC-1"	"A"
"CTGAATGTCACTGATG-1"	"A"
"CTGAATGTCGTTGTTT-1"	"A"
"CTGAATGTCTAGCTGA-1"	"A"
"CTGCGTTAGACTAATG-1"	"G"
"CTGCGTTAGAGTCCGA-1"	"A"
"CTGCGTTAGCAGGAGG-1"	"G"
"CTGCGTTAGCTGCCAC-1"	"G"
"CTGCGTTAGCTGGAGT-1"	"G"
"CTGCGTTAGGCTTCGC-1"	"A"
"CTGCGTTAGGTGATGC-1"	"G"
"CTGCGTTAGTACCTCA-1"	"A"
"CTGCGTTCAAGACTAA-1"	"G"
"CTGCGTTCAATGTAAG-1"	"A"
"CTGCGTTCAGGCTACC-1"	"A"
"CTGCGTTCATTCGTCC-1"	"G"
"CTGCGTTGTCTGTGTA-1"	"A"
"CTGCGTTGTTCCAATG-1"	"A"
"CTGCGTTGTTCTGATG-1"	"A"
"CTGCGTTGTTTGCGAT-1"	"G"
"CTGCGTTTCCCAGCGA-1"	"A"
"CTGCGTTTCTAAACGC-1"	"G"
"CTGCTCAAGAAGCCGT-1"	"A"
"CTGCTCAAGCAGAAAG-1"	"A"
"CTGCTCAAGGGAAATG-1"	"G"
"CTGCTCAAGGTACACG-1"	"G"
"CTGCTCACACAGCTTA-1"	"A"
"CTGCTCACACTACACA-1"	"A"
"CTGCTCACAGGATGTG-1"	"G"
"CTGCTCACAGGCACAA-1"	"A"
"CTGCTCACATCTGCAA-1"	"A"
"CTGCTCACATGTATCG-1"	"A"
"CTGCTCACATTCGTCC-1"	"G"
"CTGCTCAGTCGCTACG-1"	"A"
"CTGCTCAGTGAATGTA-1"	"G"
"CTGCTCAGTTCCATCC-1"	"G"
"CTGCTCAGTTGGCGAA-1"	"A"
"CTGCTCATCACATTCT-1"	"A"
"CTGCTCATCCGTTTCG-1"	"A"
"CTGCTCATCCTGTGGG-1"	"A"
"CTGCTCATCTTCAGAG-1"	"G"
"CTGGCAGAGCTCCATA-1"	"A"
"CTGGCAGAGGTTGTGG-1"	"A"
"CTGGCAGAGTACGCGA-1"	"G"
"CTGGCAGAGTATGGGC-1"	"G"
"CTGGCAGCACTCCACT-1"	"A"
"CTGGCAGCAGAACTTC-1"	"G"
"CTGGCAGGTAATGCCT-1"	"A"
"CTGGCAGGTTCTACCC-1"	"A"
"CTGGCAGTCCGATGCG-1"	"G"
"CTGGCAGTCCTTGACC-1"	"G"
"CTGGGACAGCCAGAAC-1"	"A"
"CTGGGACAGCTATCCA-1"	"G"
"CTGGGACAGTCCCTCT-1"	"A"
"CTGGGACCAGATACAA-1"	"A"
"CTGGGACCAGTTGCAT-1"	"A"
"CTGGGACCATCGACCG-1"	"A"
"CTGGGACCATGGCCGT-1"	"G"
"CTGGGACGTGCCCTAG-1"	"G"
"CTGGGACTCCCGAAGC-1"	"A"
"CTGGGACTCGCGATGC-1"	"G"
"CTGGGACTCGCTACCT-1"	"A"
"CTGGGACTCTAGTCGA-1"	"G"
"CTGGGACTCTGACATG-1"	"G"
"CTGTATTAGCCTTTGA-1"	"A"
"CTGTATTAGGATTGAT-1"	"G"
"CTGTATTAGGTAAGCC-1"	"G"
"CTGTATTAGTCCCTCT-1"	"G"
"CTGTATTAGTCGAAAT-1"	"G"
"CTGTATTCAAACTACC-1"	"A"
"CTGTATTCACACTAGT-1"	"G"
"CTGTATTCACATAAAG-1"	"G"
"CTGTATTCACTGCTCT-1"	"A"
"CTGTATTCATGCGTTA-1"	"A"
"CTGTATTGTCATAAGA-1"	"G"
"CTGTATTGTTACGGAG-1"	"G"
"CTGTATTTCAGTCTTT-1"	"A"
"CTGTATTTCGTCCCAT-1"	"G"
"CTGTATTTCTGATCTT-1"	"G"
"CTGTTCGAGCAATGTA-1"	"A"
"CTGTTCGAGCGTAGCA-1"	"A"
"CTGTTCGAGGCCTAAG-1"	"A"
"CTGTTCGAGGTACACG-1"	"A"
"CTGTTCGCACGCGTTG-1"	"A"
"CTGTTCGCAGATACAA-1"	"G"
"CTGTTCGCATGCGACC-1"	"A"
"CTGTTCGGTATTCGCA-1"	"G"
"CTGTTCGTCAGGTCTA-1"	"G"
"CTGTTCGTCTATATCC-1"	"G"
"CTTAATCAGACTAGCG-1"	"G"
"CTTAATCAGAGCTACG-1"	"A"
"CTTAATCAGAGTAAGG-1"	"G"
"CTTAATCAGCAGGACT-1"	"A"
"CTTAATCAGTCGTATC-1"	"G"
"CTTAATCGTAGAATAC-1"	"A"
"CTTAATCGTATCGCGC-1"	"A"
"CTTAATCGTCTGCACG-1"	"G"
"CTTAATCGTGTCCCAG-1"	"A"
"CTTAATCGTGTGTGCC-1"	"G"
"CTTAATCGTTCTGAGT-1"	"A"
"CTTAATCTCCACGGCA-1"	"A"
"CTTAATCTCCGTGCGA-1"	"G"
"CTTAATCTCGGGAATG-1"	"A"
"CTTAATCTCGTCTAGA-1"	"G"
"CTTAATCTCGTGTGCG-1"	"G"
"CTTAATCTCTTGTCGC-1"	"A"
"CTTCCAGAGCGATACG-1"	"G"
"CTTCCAGAGTAGACCG-1"	"A"
"CTTCCAGAGTATGGGC-1"	"G"
"CTTCCAGAGTTCGTTG-1"	"A"
"CTTCCAGCACTTATGG-1"	"A"
"CTTCCAGCAGGGTACA-1"	"A"
"CTTCCAGGTATGTCCA-1"	"G"
"CTTCCAGGTCTGTCCT-1"	"G"
"CTTCTAAAGAATATCG-1"	"A"
"CTTCTAAAGACACTTC-1"	"G"
"CTTCTAAAGACAGTGC-1"	"G"
"CTTCTAAAGGATTGAT-1"	"G"
"CTTCTAAAGGCAAGCT-1"	"A"
"CTTCTAACAAGCAATA-1"	"A"
"CTTCTAACAATTAGGA-1"	"A"
"CTTCTAACAGCAACCC-1"	"A"
"CTTCTAAGTGATAACA-1"	"G"
"CTTCTAAGTGCACCCA-1"	"G"
"CTTCTAAGTTATGCAC-1"	"A"
"CTTCTAATCGGTACTA-1"	"A"
"CTTCTAATCTGGTACA-1"	"G"
"CTTGAAGCAAAGCTGG-1"	"A"
"CTTGAAGCACAGCCAC-1"	"A"
"CTTGAAGCACATTCTT-1"	"G"
"CTTGAAGCACCATTCC-1"	"G"
"CTTGAAGCACGACGAA-1"	"G"
"CTTGAAGCACGCCGAT-1"	"A"
"CTTGAAGCAGGCTACC-1"	"G"
"CTTGAAGCATATAGAG-1"	"A"
"CTTGAAGCATCGAGTT-1"	"A"
"CTTGAAGCATCGTGAT-1"	"A"
"CTTGAAGCATCTGCAA-1"	"A"
"CTTGAAGGTAAACGTA-1"	"G"
"CTTGAAGGTACGGAGT-1"	"A"
"CTTGAAGGTAGCATGG-1"	"G"
"CTTGAAGGTCAACTAC-1"	"G"
"CTTGAAGGTCACCCGA-1"	"A"
"CTTGAAGGTGAATGTA-1"	"A"
"CTTGAAGTCACTAGGT-1"	"A"
"CTTGAAGTCAGTACAC-1"	"G"
"CTTGAAGTCGCGTGAC-1"	"A"
"CTTGAAGTCGGCATAT-1"	"G"
"CTTGAAGTCGTCCCTA-1"	"G"
"CTTGAAGTCTAAACGC-1"	"A"
"CTTGAAGTCTGAACGT-1"	"A"
"CTTGCCAAGACTTCCA-1"	"G"
"CTTGCCAAGCATGATA-1"	"A"
"CTTGCCAAGCCCATGC-1"	"A"
"CTTGCCAAGCTGATTC-1"	"A"
"CTTGCCAAGGGAGATA-1"	"G"
"CTTGCCAAGTACAGAT-1"	"G"
"CTTGCCACACATGATC-1"	"G"
"CTTGCCACATCCGTGG-1"	"A"
"CTTGCCAGTCATCGTA-1"	"A"
"CTTGCCAGTCGCGCTA-1"	"A"
"CTTGCCAGTGCAACAG-1"	"G"
"CTTGCCAGTGCGCTCA-1"	"G"
"CTTGCCATCGAGAAGC-1"	"A"
"CTTGCCATCTAAACGC-1"	"A"
"CTTGCTGAGAGCTACG-1"	"G"
"CTTGCTGAGATCTCAC-1"	"G"
"CTTGCTGAGCAGAGCT-1"	"A"
"CTTGCTGCAAACGTTC-1"	"A"
"CTTGCTGCAACGTCGC-1"	"A"
"CTTGCTGCAGCAATGG-1"	"G"
"CTTGCTGGTATGTCCA-1"	"A"
"CTTGCTGGTGTGACCC-1"	"A"
"CTTGCTGTCGGACGAA-1"	"G"
"CTTGCTGTCTCTTCTC-1"	"A"
"CTTGTCGAGAACGACC-1"	"A"
"CTTGTCGAGAGTGGAA-1"	"A"
"CTTGTCGAGCGCATTT-1"	"G"
"CTTGTCGAGCTATCCA-1"	"G"
"CTTGTCGGTATGCTAC-1"	"G"
"CTTGTCGTCAGTGTGT-1"	"G"
"CTTGTCGTCGATGTGT-1"	"G"
"CTTGTCGTCGCTCTAC-1"	"A"
"CTTGTCGTCTATAGGC-1"	"A"
"CTTTGCGAGATCGAGC-1"	"G"
"CTTTGCGAGCTGATTC-1"	"A"
"CTTTGCGAGGATGTCG-1"	"G"
"CTTTGCGAGGCGCTTC-1"	"A"
"CTTTGCGAGGTGTTGG-1"	"A"
"CTTTGCGAGTCCCTCT-1"	"A"
"CTTTGCGAGTCTCTAG-1"	"A"
"CTTTGCGCAACAACTC-1"	"G"
"CTTTGCGCAAGCAACG-1"	"A"
"CTTTGCGCATCCGTGG-1"	"G"
"CTTTGCGGTAGAATAC-1"	"G"
"CTTTGCGGTATTCGAC-1"	"A"
"CTTTGCGGTCAGTGCC-1"	"G"
"CTTTGCGGTCTAACCA-1"	"G"
"CTTTGCGTCACTCCCA-1"	"A"
"CTTTGCGTCAGGATCT-1"	"A"
"GAAACAAAGAACCCGA-1"	"A"
"GAAACAAAGACACGGT-1"	"A"
"GAAACAAAGACCATAA-1"	"A"
"GAAACAAAGATATGAC-1"	"G"
"GAAACAAAGGCGTAGT-1"	"A"
"GAAACAAAGTAGAAGG-1"	"G"
"GAAACAAAGTTCGACT-1"	"A"
"GAAACAACAAGGATGC-1"	"G"
"GAAACAACACTGGGCT-1"	"A"
"GAAACAACAGATACAA-1"	"G"
"GAAACAAGTGAATCAA-1"	"G"
"GAAACAAGTGAATCGG-1"	"G"
"GAAACAAGTGTCCTTC-1"	"A"
"GAAACAATCCAAACCA-1"	"G"
"GAAACAATCCCGAAGC-1"	"A"
"GAAACAATCGAGTGTT-1"	"A"
"GAAACAATCGATAGGG-1"	"G"
"GAAACAATCGCAACTA-1"	"A"
"GAAAGTAAGCTGAGGT-1"	"G"
"GAAAGTAAGGCGTCCT-1"	"G"
"GAAAGTAAGTCGAGCA-1"	"G"
"GAAAGTACATAGCCAT-1"	"G"
"GAAAGTAGTACGGATG-1"	"G"
"GAAAGTAGTCCCGTGA-1"	"G"
"GAAAGTATCACAACAC-1"	"A"
"GAAAGTATCCCAGCGA-1"	"A"
"GAAAGTATCCTCCAGT-1"	"A"
"GAAATGAAGAATCAAC-1"	"G"
"GAAATGAAGATCCGAG-1"	"A"
"GAAATGAAGCAATGTA-1"	"A"
"GAAATGAAGCGTCTGC-1"	"A"
"GAAATGAAGTGAATAC-1"	"G"
"GAAATGACAATTGCCA-1"	"A"
"GAAATGACACCGATCG-1"	"A"
"GAAATGACAGAGCCAA-1"	"A"
"GAAATGACAGCAACGA-1"	"A"
"GAAATGACATCAGCTA-1"	"A"
"GAAATGACATTGTTCT-1"	"A"
"GAAATGAGTAGGTCTT-1"	"G"
"GAAATGAGTGGGTAGT-1"	"A"
"GAAATGAGTTGGGAAC-1"	"G"
"GAAATGATCCGATGCG-1"	"G"
"GAAATGATCTGTGTCC-1"	"A"
"GAACCGCAGACAGCTG-1"	"G"
"GAACCGCAGAGCGGTT-1"	"A"
"GAACCGCAGGTGTTGG-1"	"G"
"GAACCGCAGTCGAGCA-1"	"A"
"GAACCGCAGTGATAAC-1"	"G"
"GAACCGCCAAAGGTCG-1"	"A"
"GAACCGCCAACATAAG-1"	"G"
"GAACCGCCAATGCACT-1"	"A"
"GAACCGCCAGATTAAG-1"	"G"
"GAACCGCCAGGGTAAC-1"	"G"
"GAACCGCCAGTCAGAG-1"	"G"
"GAACCGCGTAGCTGTT-1"	"A"
"GAACCGCGTAGGTAAT-1"	"A"
"GAACCGCGTTAAGGGC-1"	"G"
"GAACCGCGTTCCCTTG-1"	"A"
"GAACCGCTCCATAACG-1"	"G"
"GAACCGCTCGACGGAA-1"	"A"
"GAACCGCTCGCTTCAC-1"	"G"
"GAACCGCTCTTTATCG-1"	"A"
"GAACCTAAGAATCAAC-1"	"G"
"GAACCTAAGAGCCACA-1"	"A"
"GAACCTAAGGAGTCTG-1"	"A"
"GAACCTAAGGATGCCA-1"	"A"
"GAACCTAAGTACAGAT-1"	"A"
"GAACCTACAGAAGTGC-1"	"G"
"GAACCTACATGTATCG-1"	"G"
"GAACCTAGTAACGTAA-1"	"G"
"GAACCTAGTCTGGTCG-1"	"G"
"GAACCTAGTGTACGCC-1"	"G"
"GAACCTAGTGTCCTTC-1"	"G"
"GAACCTATCGCAGATT-1"	"A"
"GAACCTATCGCGCTGA-1"	"A"
"GAACCTATCTACCCGT-1"	"A"
"GAACCTATCTTAAGCG-1"	"A"
"GAACGTTAGCTTACCA-1"	"G"
"GAACGTTAGGGACGTT-1"	"A"
"GAACGTTAGTAGCAAT-1"	"G"
"GAACGTTCAAATAGTG-1"	"G"
"GAACGTTCAAGGTTCT-1"	"A"
"GAACGTTCATGATTGC-1"	"A"
"GAACGTTCATGTATCG-1"	"G"
"GAACGTTGTCGCTAGC-1"	"G"
"GAACGTTGTGAATGTA-1"	"G"
"GAACGTTGTGATGTGG-1"	"G"
"GAACGTTGTGCAACAG-1"	"A"
"GAACGTTGTGGACAGT-1"	"G"
"GAACGTTTCACAGGGA-1"	"A"
"GAACGTTTCAGGGTTT-1"	"A"
"GAACGTTTCCATCTAT-1"	"A"
"GAACGTTTCCTCCCAA-1"	"A"
"GAACGTTTCGTCTTAT-1"	"A"
"GAACGTTTCGTGGCGT-1"	"A"
"GAACTTGAGCTCCATA-1"	"G"
"GAACTTGAGTCCGGAA-1"	"A"
"GAACTTGCATTGCACA-1"	"G"
"GAACTTGGTAACGGTG-1"	"G"
"GAACTTGGTACAAATG-1"	"A"
"GAACTTGGTATGGGTG-1"	"G"
"GAACTTGGTGGACGAT-1"	"A"
"GAACTTGGTTAAGGGC-1"	"G"
"GAACTTGTCCTCTCTT-1"	"G"
"GAAGAGCAGAAATACC-1"	"A"
"GAAGAGCAGCAATGTA-1"	"G"
"GAAGAGCCAACTCGTA-1"	"A"
"GAAGAGCCAAGACTAA-1"	"A"
"GAAGAGCCACAGCTTA-1"	"A"
"GAAGAGCCACGTTGTA-1"	"G"
"GAAGAGCCATCGTACA-1"	"G"
"GAAGAGCGTAACCATC-1"	"A"
"GAAGAGCGTCAATCCA-1"	"A"
"GAAGTCTAGAATCAAC-1"	"A"
"GAAGTCTAGAGCTACG-1"	"G"
"GAAGTCTAGATATGTG-1"	"G"
"GAAGTCTAGCAACTGG-1"	"A"
"GAAGTCTAGTCGAGCA-1"	"A"
"GAAGTCTCACGCTGTG-1"	"G"
"GAAGTCTCAGGACTGA-1"	"G"
"GAAGTCTCATAAAGTG-1"	"A"
"GAAGTCTGTACCGGCT-1"	"G"
"GAAGTCTGTGCATTCA-1"	"A"
"GAAGTCTTCGAGGTCC-1"	"G"
"GAAGTCTTCTATACCT-1"	"G"
"GAAGTCTTCTGTCGGG-1"	"A"
"GAAGTCTTCTTATCAC-1"	"G"
"GAAGTGGAGAAATCTG-1"	"A"
"GAAGTGGAGCTTTCCC-1"	"A"
"GAAGTGGAGGACTAGC-1"	"G"
"GAAGTGGAGGGCATTG-1"	"G"
"GAAGTGGAGTAATCAG-1"	"A"
"GAAGTGGAGTTGCGCC-1"	"A"
"GAAGTGGCAAGGCTTT-1"	"A"
"GAAGTGGCAATGGCTT-1"	"A"
"GAAGTGGCATATTGGC-1"	"G"
"GAAGTGGCATCAGAAA-1"	"A"
"GAAGTGGGTAACAATG-1"	"A"
"GAAGTGGGTCCAAGTT-1"	"A"
"GAAGTGGGTTGCAGAG-1"	"A"
"GAAGTGGTCAAATGGA-1"	"A"
"GAAGTGGTCATTCATC-1"	"A"
"GAAGTGGTCCTTACGC-1"	"G"
"GAAGTGGTCGGGAAAC-1"	"A"
"GAAGTGGTCTGGACAT-1"	"A"
"GAATCTGAGACACAAT-1"	"A"
"GAATCTGAGATATGTG-1"	"A"
"GAATCTGAGTGGACGT-1"	"A"
"GAATCTGCATAGCAGG-1"	"G"
"GAATCTGGTAAGCCTT-1"	"A"
"GAATCTGGTACCTATG-1"	"A"
"GAATCTGGTAGTCCAT-1"	"G"
"GAATCTGGTGTTGTTG-1"	"G"
"GAATCTGTCCATCTAT-1"	"A"
"GAATCTGTCTATATCC-1"	"G"
"GAATCTGTCTTCAGAG-1"	"G"
"GACCAATAGGCTGGAT-1"	"G"
"GACCAATAGGGCATTG-1"	"G"
"GACCAATAGGTAAGCC-1"	"G"
"GACCAATAGGTCGTTT-1"	"A"
"GACCAATAGTCGAAAT-1"	"G"
"GACCAATCAAACCTAC-1"	"A"
"GACCAATCAAGACTTC-1"	"A"
"GACCAATCAATGCACT-1"	"G"
"GACCAATCAGATACAA-1"	"A"
"GACCAATGTAACCCAT-1"	"A"
"GACCAATGTCAGTGTT-1"	"G"
"GACCAATGTCTGCACG-1"	"A"
"GACCAATGTTTAAGCC-1"	"G"
"GACCAATGTTTCGTTT-1"	"A"
"GACCAATTCAATTCCT-1"	"G"
"GACCAATTCACAGGGA-1"	"A"
"GACCAATTCCAATAGC-1"	"A"
"GACCAATTCCGTTTCG-1"	"A"
"GACCAATTCGATGTAC-1"	"A"
"GACCAATTCTACATCT-1"	"A"
"GACCCAGAGAATGCTA-1"	"G"
"GACCCAGAGGAGTACC-1"	"G"
"GACCCAGAGGCCTAAG-1"	"A"
"GACCCAGAGGTTGTTC-1"	"A"
"GACCCAGAGTTAGCGG-1"	"G"
"GACCCAGCAAGGTTCT-1"	"G"
"GACCCAGCATACCCGG-1"	"A"
"GACCCAGCATCCGTGG-1"	"G"
"GACCCAGGTAATGTGA-1"	"G"
"GACCCAGGTGACGCAA-1"	"A"
"GACCCAGGTTGGTAAA-1"	"A"
"GACCCAGTCGAACACT-1"	"G"
"GACCCAGTCGACCCGA-1"	"G"
"GACCCAGTCGAGAACG-1"	"A"
"GACCGACAGAGAAGCA-1"	"A"
"GACCGACAGAGCTGTG-1"	"A"
"GACCGACAGCTTTCCC-1"	"G"
"GACCGACAGTGGACGT-1"	"G"
"GACCGACCAACTCAAC-1"	"G"
"GACCGACCAAGTCCTA-1"	"A"
"GACCGACCAATGCACT-1"	"A"
"GACCGACCAATGTAAG-1"	"A"
"GACCGACCACTCCACT-1"	"A"
"GACCGACGTCATCGTA-1"	"A"
"GACCGACGTTCCAGTA-1"	"G"
"GACCGACTCAGTACAC-1"	"A"
"GACCGACTCATGTTCT-1"	"G"
"GACCGACTCCGTCAAA-1"	"A"
"GACCGACTCGGATCGC-1"	"A"
"GACCGACTCTCCTTAA-1"	"A"
"GACCTTCAGGCCTCTG-1"	"A"
"GACCTTCAGGTTGACG-1"	"A"
"GACCTTCAGTCGACCC-1"	"G"
"GACCTTCAGTTAGAGT-1"	"G"
"GACCTTCCACAAGTGG-1"	"A"
"GACCTTCCACCATTCC-1"	"G"
"GACCTTCCACTGAAGG-1"	"A"
"GACCTTCGTATACGCT-1"	"A"
"GACCTTCGTATCCCTC-1"	"A"
"GACCTTCGTGAATGTA-1"	"A"
"GACCTTCGTGCCCGAT-1"	"A"
"GACCTTCGTTTAAGCC-1"	"A"
"GACCTTCTCATTCATC-1"	"G"
"GACCTTCTCCTTTGCG-1"	"G"
"GACCTTCTCGGGTCCA-1"	"A"
"GACCTTCTCTGTCGGG-1"	"G"
"GACCTTCTCTGTGTCC-1"	"A"
"GACCTTCTCTTCACTA-1"	"A"
"GACCTTCTCTTGTACT-1"	"A"
"GACTAACAGACCAATA-1"	"G"
"GACTAACAGCGCAATG-1"	"A"
"GACTAACAGCTGCCAC-1"	"G"
"GACTAACAGTGAGTGC-1"	"A"
"GACTAACGTACGCCCA-1"	"A"
"GACTAACGTAGCGAGT-1"	"G"
"GACTAACGTATTGTGC-1"	"G"
"GACTAACGTCCCTAAA-1"	"G"
"GACTAACGTGATAACA-1"	"G"
"GACTAACTCCACTAGA-1"	"G"
"GACTAACTCGCTCGGA-1"	"G"
"GACTAGTCAAGCCAGA-1"	"G"
"GACTAGTCATAGACGG-1"	"A"
"GACTAGTGTAGCGAGT-1"	"A"
"GACTAGTGTATTGTGC-1"	"G"
"GACTAGTGTGCTTCCT-1"	"A"
"GACTAGTGTTGAATAG-1"	"G"
"GACTAGTTCATTGCCC-1"	"G"
"GACTAGTTCCCGTATC-1"	"G"
"GACTAGTTCGGTACTA-1"	"G"
"GACTAGTTCGGTCAGC-1"	"A"
"GAGAACGAGCAACGGT-1"	"G"
"GAGAACGAGCATACCT-1"	"G"
"GAGAACGAGGCAATTA-1"	"G"
"GAGAACGAGTAGACCG-1"	"G"
"GAGAACGAGTATACCC-1"	"A"
"GAGAACGCAACTACTG-1"	"A"
"GAGAACGCACAAGGGT-1"	"G"
"GAGAACGCAGTCCTGG-1"	"A"
"GAGAACGGTCATAGCT-1"	"G"
"GAGAACGGTGCTTACA-1"	"A"
"GAGAACGGTTCTACGA-1"	"A"
"GAGAACGTCCAACCTC-1"	"G"
"GAGAACGTCTAGCAAC-1"	"G"
"GAGAACGTCTGCTACC-1"	"A"
"GAGACTTAGCGGACTA-1"	"G"
"GAGACTTAGCTAGTTC-1"	"G"
"GAGACTTAGCTGCTCG-1"	"A"
"GAGACTTAGTAGGTCG-1"	"G"
"GAGACTTAGTCGCCTG-1"	"A"
"GAGACTTCATTTGGCA-1"	"G"
"GAGACTTGTGCTTACA-1"	"A"
"GAGACTTTCATGCTTT-1"	"A"
"GAGACTTTCCAGTACA-1"	"A"
"GAGACTTTCCCAATGA-1"	"A"
"GAGACTTTCTCTTCCT-1"	"G"
"GAGATTCAGAACGCCA-1"	"A"
"GAGATTCAGACGCCAA-1"	"A"
"GAGATTCAGCATACCT-1"	"A"
"GAGATTCAGTAGACCG-1"	"A"
"GAGATTCAGTTCCCGG-1"	"G"
"GAGATTCCAACGAGGT-1"	"A"
"GAGATTCCAAGGAACC-1"	"G"
"GAGATTCCACATGATC-1"	"A"
"GAGATTCCAGGCACAA-1"	"A"
"GAGATTCCATGCGCTG-1"	"G"
"GAGATTCGTATGAAGT-1"	"A"
"GAGATTCGTCCGTAGC-1"	"A"
"GAGATTCTCCCAATAG-1"	"G"
"GAGATTCTCCTGTAGA-1"	"A"
"GAGATTCTCGGGACAA-1"	"G"
"GAGATTCTCGTTCCGT-1"	"A"
"GAGCATTAGAGTAAGG-1"	"A"
"GAGCATTAGATGTTGA-1"	"A"
"GAGCATTAGTACAGAT-1"	"G"
"GAGCATTCAAAGCTTC-1"	"A"
"GAGCATTCACACATGT-1"	"G"
"GAGCATTCACGGCCAT-1"	"G"
"GAGCATTGTAGAATAC-1"	"A"
"GAGCATTGTAGTATCC-1"	"G"
"GAGCATTGTATGGGTG-1"	"A"
"GAGCATTGTCCCTAAA-1"	"A"
"GAGCATTGTCCCTTTG-1"	"A"
"GAGCATTGTGTGTGCC-1"	"A"
"GAGCATTTCAACTTGG-1"	"G"
"GAGCATTTCGTGTGCG-1"	"G"
"GAGCGCTAGATCCGAG-1"	"A"
"GAGCGCTCATGGGAAC-1"	"A"
"GAGCGCTGTATCACAC-1"	"G"
"GAGCGCTGTCCAAGAG-1"	"A"
"GAGCGCTGTCCTTCAC-1"	"A"
"GAGCGCTGTCTCTGGG-1"	"A"
"GAGCGCTGTTTCCTAT-1"	"G"
"GAGCGCTTCAAGTTGC-1"	"A"
"GAGCGCTTCCCACTTG-1"	"G"
"GAGCGCTTCGATAGTC-1"	"A"
"GAGCGCTTCTATGAGC-1"	"G"
"GAGGATGAGAATCAGT-1"	"A"
"GAGGATGAGCGGACAT-1"	"A"
"GAGGATGAGTACAGTA-1"	"G"
"GAGGATGAGTCTCGAT-1"	"G"
"GAGGATGCATTTGGTG-1"	"A"
"GAGGCTCAGATAGGTT-1"	"G"
"GAGGCTCAGGAGTACC-1"	"A"
"GAGGCTCAGTCCGTGC-1"	"A"
"GAGGCTCAGTCGCCTG-1"	"A"
"GAGGCTCCAAGAAACT-1"	"A"
"GAGGCTCCAGAACGAC-1"	"A"
"GAGGCTCCAGAAGTGC-1"	"G"
"GAGGCTCGTGAATACA-1"	"G"
"GAGGCTCGTTTGTGAC-1"	"G"
"GAGGCTCTCGTCCCTA-1"	"A"
"GAGGCTCTCTGACATG-1"	"A"
"GAGGTCCAGACTAGGC-1"	"G"
"GAGGTCCAGCCTCGCA-1"	"A"
"GAGGTCCAGCGAGAAA-1"	"G"
"GAGGTCCCAAAGGAAG-1"	"A"
"GAGGTCCCACAAACAA-1"	"G"
"GAGGTCCGTAACACTC-1"	"G"
"GAGGTCCGTGCTGTGC-1"	"A"
"GAGGTCCGTTCTTTCA-1"	"A"
"GAGGTCCTCCCAGCGA-1"	"G"
"GAGGTCCTCCCATAGA-1"	"G"
"GAGGTCCTCGCGTGAC-1"	"G"
"GAGGTCCTCTCGTGAA-1"	"G"
"GAGGTCCTCTGTGTGA-1"	"G"
"GAGTGAGAGATGGCAC-1"	"A"
"GAGTGAGCAAAGAGAG-1"	"G"
"GAGTGAGGTCACAGGA-1"	"A"
"GAGTGAGGTCTGTGTA-1"	"G"
"GAGTGAGGTTTGCGAT-1"	"G"
"GAGTGAGTCGACTTAG-1"	"A"
"GAGTGAGTCTGCGTCT-1"	"G"
"GATCATGAGAGGCCTA-1"	"A"
"GATCATGCAAGGACCA-1"	"G"
"GATCATGCACAGAAGC-1"	"A"
"GATCATGCACATGATC-1"	"G"
"GATCATGCACTAGCCG-1"	"G"
"GATCATGCAGCACATT-1"	"A"
"GATCATGCAGCGCGTT-1"	"A"
"GATCATGGTAACTGAA-1"	"A"
"GATCATGGTCCGTAGC-1"	"G"
"GATCATGGTCTGGGAA-1"	"A"
"GATCATGGTGCTTACA-1"	"G"
"GATCATGGTGTGTGCC-1"	"A"
"GATCATGGTTCAGTAC-1"	"A"
"GATCATGTCCAGTACA-1"	"G"
"GATCATGTCCATAGGT-1"	"G"
"GATCATGTCTACCCGT-1"	"G"
"GATCATGTCTGCGTCT-1"	"A"
"GATCGTAAGAACAGGA-1"	"G"
"GATCGTAAGAGATTAC-1"	"A"
"GATCGTAAGATGCGCA-1"	"A"
"GATCGTACAAACGTTC-1"	"A"
"GATCGTAGTGGAAAGA-1"	"G"
"GATCGTATCCTAAGTG-1"	"A"
"GATCGTATCTTCACTA-1"	"A"
"GATGATCAGAACGACC-1"	"G"
"GATGATCAGAGAACCC-1"	"A"
"GATGATCAGTGTAATG-1"	"G"
"GATGATCCAAAGAGAG-1"	"G"
"GATGATCGTAAACGGC-1"	"A"
"GATGATCGTCAGAGTG-1"	"G"
"GATGATCTCCTGGGAC-1"	"G"
"GATGATCTCTCGGCGA-1"	"A"
"GATGGCCAGACTCTTG-1"	"G"
"GATGGCCAGTAGACCG-1"	"G"
"GATGGCCAGTTACACC-1"	"A"
"GATGGCCCAAAGGTCG-1"	"A"
"GATGGCCCAAGTTGCT-1"	"A"
"GATGGCCCAGATAAGT-1"	"G"
"GATGGCCCAGTTCGGC-1"	"G"
"GATGGCCGTGAATACA-1"	"A"
"GATGGCCGTTACGAAA-1"	"A"
"GATGGCCGTTCCCAAA-1"	"G"
"GATGGCCTCCGAGGAA-1"	"A"
"GATGGCCTCCGCCTAT-1"	"A"
"GATGGCCTCCGGCTGA-1"	"A"
"GATTAGCAGTAACATG-1"	"A"
"GATTAGCAGTGATCTC-1"	"A"
"GATTAGCCATATACGC-1"	"G"
"GATTAGCGTAATGCAA-1"	"A"
"GATTAGCGTCACCCGA-1"	"A"
"GATTAGCGTCATAGAA-1"	"A"
"GATTAGCGTCCGCTTT-1"	"A"
"GATTAGCGTGATAAGT-1"	"G"
"GATTAGCGTTACCCAA-1"	"A"
"GATTAGCGTTCTTTGT-1"	"G"
"GATTAGCGTTTAGAAG-1"	"A"
"GATTAGCTCACCACAA-1"	"A"
"GATTAGCTCCTCATTA-1"	"G"
"GATTAGCTCCTCCTGA-1"	"G"
"GATTAGCTCGCGTGAC-1"	"A"
"GATTGACAGGTTAGTA-1"	"G"
"GATTGACCAAGATTAG-1"	"A"
"GATTGACGTAGGGTCA-1"	"A"
"GATTGACGTCACAGTT-1"	"G"
"GATTGACGTCGTAATC-1"	"G"
"GATTGACGTGGCATAG-1"	"G"
"GATTGACGTTTAGAAG-1"	"G"
"GATTGACTCACGATTG-1"	"G"
"GATTGACTCCAGAATC-1"	"G"
"GATTGACTCGAAGCCC-1"	"G"
"GCAAAGGAGCAGGACT-1"	"A"
"GCAAAGGAGTTCCCGG-1"	"A"
"GCAAAGGCAACTGCGC-1"	"A"
"GCAAAGGCATCGCTAA-1"	"A"
"GCAAAGGGTATTCGAC-1"	"A"
"GCAAAGGGTCATAAGA-1"	"A"
"GCAAAGGGTTCTACCC-1"	"G"
"GCAAAGGTCATTCTCA-1"	"G"
"GCAAAGGTCCCTACGT-1"	"A"
"GCAAAGGTCGGGACAA-1"	"A"
"GCAAAGGTCTCCTTGG-1"	"A"
"GCAAAGGTCTCTGCAC-1"	"A"
"GCAAAGGTCTTGGCCT-1"	"A"
"GCAACCGAGGTTCTCA-1"	"A"
"GCAACCGAGTGCTGAG-1"	"A"
"GCAACCGAGTTCAAGA-1"	"G"
"GCAACCGCAGTTGCAT-1"	"A"
"GCAACCGGTTAGGAGC-1"	"G"
"GCAACCGTCAACGTGT-1"	"A"
"GCAACCGTCGACTTAG-1"	"A"
"GCAACCGTCGGGAATG-1"	"A"
"GCAACCGTCTACTGCC-1"	"A"
"GCACCTTAGAATCAAC-1"	"G"
"GCACCTTAGTAGTTCC-1"	"G"
"GCACCTTCAAAGGCCA-1"	"A"
"GCACCTTCAACGTACT-1"	"A"
"GCACCTTCAGCGTGAA-1"	"A"
"GCACCTTGTAGCCATT-1"	"G"
"GCACCTTGTCATGAGG-1"	"A"
"GCACCTTGTGATGCTT-1"	"G"
"GCACCTTTCAGAATGA-1"	"A"
"GCACCTTTCGGTAGGA-1"	"A"
"GCACCTTTCTGCGTCT-1"	"A"
"GCACCTTTCTTCGTTA-1"	"G"
"GCACGCAAGAACGACC-1"	"G"
"GCACGCAAGAATGCTA-1"	"G"
"GCACGCAAGAGAAGCA-1"	"A"
"GCACGCAAGGCCAATG-1"	"G"
"GCACGCAAGTCTTAGC-1"	"G"
"GCACGCACACTCCTCA-1"	"A"
"GCACGCACATGCTATG-1"	"A"
"GCACGCAGTATGGATA-1"	"G"
"GCACGCAGTCAGAGTG-1"	"G"
"GCACGCAGTGCGCTCA-1"	"A"
"GCACGCATCGAACCGC-1"	"G"
"GCACGCATCGGGACAA-1"	"G"
"GCACGCATCTCATATC-1"	"A"
"GCACGCATCTGAAAGA-1"	"G"
"GCACGCATCTTCATAC-1"	"G"
"GCACGCATCTTTCGAT-1"	"G"
"GCACGGTAGCACCATT-1"	"A"
"GCACGGTAGGGATCCA-1"	"G"
"GCACGGTAGTAGTCGG-1"	"G"
"GCACGGTCAAGGATGC-1"	"A"
"GCACGGTCAAGTGGCA-1"	"G"
"GCACGGTCACCTACCT-1"	"A"
"GCACGGTCAGATTAAG-1"	"G"
"GCACGGTGTCGATTAC-1"	"G"
"GCACGGTTCCCTATTA-1"	"G"
"GCACGGTTCCGCCTAT-1"	"G"
"GCACGGTTCTTACCTA-1"	"G"
"GCAGATTAGGCAGTGT-1"	"A"
"GCAGATTAGTGTTCCA-1"	"A"
"GCAGATTCACATTGCA-1"	"G"
"GCAGATTGTCAAATCC-1"	"G"
"GCAGATTGTCTCGGGT-1"	"A"
"GCAGATTGTGATAAGT-1"	"A"
"GCAGATTGTGTGTGTT-1"	"G"
"GCAGATTTCAAACCCA-1"	"A"
"GCAGATTTCCCTACCA-1"	"A"
"GCAGATTTCCTGGGAC-1"	"A"
"GCAGATTTCGACGGAA-1"	"A"
"GCAGATTTCGAGCGCT-1"	"A"
"GCAGATTTCGCTCGGA-1"	"A"
"GCAGCCAAGCTGAAAT-1"	"A"
"GCAGCCAAGTAACATG-1"	"A"
"GCAGCCACAATACTGC-1"	"A"
"GCAGCCACAGGCATTT-1"	"G"
"GCAGCCACATGATTGC-1"	"A"
"GCAGCCAGTGCAAGCA-1"	"G"
"GCAGCCAGTTAGCTCA-1"	"G"
"GCAGCCAGTTCTCGAA-1"	"A"
"GCAGCCATCCAGTTAG-1"	"A"
"GCAGCCATCGGTTGTA-1"	"A"
"GCAGCCATCTTAGTGG-1"	"G"
"GCAGCTGAGACCAATA-1"	"A"
"GCAGCTGCACAGAAGC-1"	"G"
"GCAGCTGCACCATTCC-1"	"A"
"GCAGCTGCATTCTTTG-1"	"A"
"GCAGCTGGTCTCAAAC-1"	"G"
"GCAGCTGGTGTAGGAC-1"	"A"
"GCAGCTGTCACTTACT-1"	"A"
"GCAGCTGTCATTCTTG-1"	"G"
"GCAGCTGTCCGAATTG-1"	"A"
"GCAGCTGTCCTTTGAT-1"	"A"
"GCAGCTGTCGCACCTT-1"	"G"
"GCATGATAGCAGAATT-1"	"G"
"GCATGATAGCTGGAGT-1"	"G"
"GCATGATAGTACCCAT-1"	"A"
"GCATGATAGTGATCTC-1"	"A"
"GCATGATCAGGTCTGC-1"	"A"
"GCATGATCATCGGCTG-1"	"G"
"GCATGATGTAACGGAC-1"	"G"
"GCATGATGTAGCATGG-1"	"G"
"GCATGATGTCATCAAC-1"	"A"
"GCATGATGTGCCGGTT-1"	"G"
"GCATGATGTTATCGAC-1"	"G"
"GCATGATGTTGAAGCG-1"	"A"
"GCATGATTCCTTCGAC-1"	"G"
"GCATGATTCTGTGTGA-1"	"G"
"GCATTCCAGGTTACAA-1"	"A"
"GCATTCCAGTAACACA-1"	"G"
"GCATTCCCAAACGACG-1"	"A"
"GCATTCCCACGCGCAT-1"	"A"
"GCATTCCCACTGGGCT-1"	"A"
"GCATTCCCATCGCCTT-1"	"A"
"GCATTCCCATGGCCTG-1"	"G"
"GCATTCCGTCACCCGA-1"	"A"
"GCATTCCGTGACCAGA-1"	"A"
"GCATTCCGTTCCCTTG-1"	"A"
"GCATTCCGTTTCGACA-1"	"G"
"GCATTCCTCCATACGA-1"	"A"
"GCATTCCTCCGGGCAT-1"	"G"
"GCATTCCTCGATGCAT-1"	"A"
"GCATTCCTCTGAAAGA-1"	"A"
"GCATTCCTCTGACATG-1"	"G"
"GCATTGAAGAGAATTC-1"	"A"
"GCATTGAAGATACCAA-1"	"G"
"GCATTGAAGCAGGACT-1"	"A"
"GCATTGAAGCAGGAGG-1"	"A"
"GCATTGAAGGTTACAA-1"	"G"
"GCATTGAAGTGAGTTA-1"	"A"
"GCATTGAAGTGCTAGG-1"	"G"
"GCATTGACACGTTGTA-1"	"A"
"GCATTGACAGATAAGT-1"	"G"
"GCATTGAGTACCTATG-1"	"A"
"GCATTGAGTGGACGAT-1"	"A"
"GCATTGAGTTTGACCA-1"	"G"
"GCATTGATCTGGACAT-1"	"G"
"GCCAGACAGGATTGCG-1"	"G"
"GCCAGACCAGGCAAGT-1"	"A"
"GCCAGACCAGTAGTTC-1"	"A"
"GCCAGACGTAAGGTCG-1"	"A"
"GCCAGACGTTACGAAA-1"	"G"
"GCCAGACTCGAACACT-1"	"A"
"GCCAGACTCGCGGCAT-1"	"G"
"GCCAGACTCTGATCTT-1"	"A"
"GCCAGCAAGCTGAAAT-1"	"A"
"GCCAGCAAGTTGCGCC-1"	"A"
"GCCAGCACACTCAAGT-1"	"G"
"GCCAGCACACTCCACT-1"	"G"
"GCCAGCACACTGATTG-1"	"G"
"GCCAGCAGTCCCGTGA-1"	"A"
"GCCAGCAGTTAACCGT-1"	"A"
"GCCAGCAGTTTCAGCA-1"	"A"
"GCCAGCATCACTACCC-1"	"G"
"GCCAGCATCAGAACGG-1"	"G"
"GCCAGCATCCATATCT-1"	"A"
"GCCAGCATCGTTTGAG-1"	"G"
"GCCAGCATCTCTGTTA-1"	"A"
"GCCAGCATCTGCGTCT-1"	"G"
"GCCATAAAGAAAGGGT-1"	"G"
"GCCATAAAGCCAGAAC-1"	"G"
"GCCATAAAGCCTTTGA-1"	"A"
"GCCATAAAGTCGAGCA-1"	"A"
"GCCATAACAAGCAACG-1"	"A"
"GCCATAACACCACCAG-1"	"G"
"GCCATAACACGCTAAT-1"	"G"
"GCCATAACAGCCACGT-1"	"A"
"GCCATAACATGTCCCT-1"	"G"
"GCCATAAGTAAACGTA-1"	"G"
"GCCATAAGTAGGTCTT-1"	"A"
"GCCATAAGTCGATTAC-1"	"G"
"GCCATAAGTTGTCGGC-1"	"G"
"GCCATAATCGTTGTAG-1"	"A"
"GCCATAATCTTACTCA-1"	"A"
"GCCCAGAAGCTGAATA-1"	"A"
"GCCCAGAAGGGTAATT-1"	"A"
"GCCCAGACAATTCAGC-1"	"A"
"GCCCAGAGTATCACAC-1"	"G"
"GCCCAGATCCAAGAGG-1"	"G"
"GCCCAGATCGCATACA-1"	"G"
"GCCCAGATCGCCACTT-1"	"A"
"GCCCGAAAGAGCGAAA-1"	"A"
"GCCCGAAAGAGCTGTG-1"	"A"
"GCCCGAAAGGAAGACA-1"	"A"
"GCCCGAACAAGCGGTA-1"	"A"
"GCCCGAACAATTAGGA-1"	"A"
"GCCCGAACAGTGGTCC-1"	"G"
"GCCCGAACATGTCCCT-1"	"A"
"GCCCGAACATTACTCT-1"	"G"
"GCCCGAAGTCAGCAAG-1"	"G"
"GCCCGAAGTCCCGAGT-1"	"G"
"GCCCGAAGTGATCAGG-1"	"A"
"GCCCGAATCAAATGGA-1"	"A"
"GCCCGAATCACTTACT-1"	"A"
"GCCCGAATCCCGATTC-1"	"G"
"GCCCGAATCGCCACTT-1"	"G"
"GCCCGAATCGTGGAAG-1"	"G"
"GCCCGAATCTATCTAC-1"	"G"
"GCCTACTAGATCTCAC-1"	"A"
"GCCTACTCAGATACAA-1"	"A"
"GCCTACTCAGCTATAC-1"	"A"
"GCCTACTCAGGAGCAT-1"	"A"
"GCCTACTCATGCTATG-1"	"G"
"GCCTACTGTACTTCGA-1"	"A"
"GCCTACTGTAGAAGCC-1"	"G"
"GCCTACTGTATCGCGC-1"	"G"
"GCCTACTGTCAACGGA-1"	"A"
"GCCTACTTCACTGATG-1"	"G"
"GCCTACTTCCACGCTT-1"	"A"
"GCCTACTTCCTGAAAC-1"	"G"
"GCCTACTTCGCCCTTA-1"	"G"
"GCCTACTTCTGCGTCT-1"	"A"
"GCCTAGGAGGCAAGGG-1"	"G"
"GCCTAGGCAAACCCTA-1"	"A"
"GCCTAGGCAGAGTCGA-1"	"G"
"GCCTAGGGTCACAGTT-1"	"G"
"GCCTAGGGTGCATTGT-1"	"G"
"GCCTAGGGTGTCCCAG-1"	"A"
"GCCTAGGTCGGAGTTT-1"	"A"
"GCCTAGGTCTTGTCAT-1"	"A"
"GCGAGAAAGACCCTAT-1"	"G"
"GCGAGAAAGCCGCTGT-1"	"A"
"GCGAGAAAGTGGTGTG-1"	"A"
"GCGAGAACAACTCGAT-1"	"A"
"GCGAGAACAGGGTAAC-1"	"A"
"GCGAGAAGTATGCTAC-1"	"A"
"GCGAGAAGTATGTCCA-1"	"G"
"GCGAGAAGTTCAGTAC-1"	"A"
"GCGAGAATCAGGCCGT-1"	"G"
"GCGAGAATCCCGCAAG-1"	"A"
"GCGAGAATCCCTACCA-1"	"A"
"GCGAGAATCCTTTGAT-1"	"G"
"GCGAGAATCTCGTAGA-1"	"A"
"GCGAGAATCTGGTACA-1"	"A"
"GCGAGTCAGAACTCCT-1"	"A"
"GCGAGTCAGAGCTCCC-1"	"G"
"GCGAGTCAGATCCGAG-1"	"A"
"GCGAGTCAGCGCGTTC-1"	"A"
"GCGAGTCAGGACTTTC-1"	"A"
"GCGAGTCAGGCACTAG-1"	"G"
"GCGAGTCCAAAGGCCA-1"	"A"
"GCGAGTCCAATGTAAG-1"	"A"
"GCGAGTCCAATTCAGC-1"	"G"
"GCGAGTCGTAAGCCTT-1"	"G"
"GCGAGTCGTAATGCCT-1"	"G"
"GCGAGTCGTATCAGCT-1"	"G"
"GCGAGTCGTTAGTAGA-1"	"A"
"GCGAGTCGTTCAGAAA-1"	"A"
"GCGAGTCGTTGGCTAT-1"	"A"
"GCGAGTCTCAGTCTTT-1"	"G"
"GCGAGTCTCCATCGAA-1"	"A"
"GCGAGTCTCGTCAACA-1"	"A"
"GCGAGTCTCGTCGCAG-1"	"A"
"GCGAGTCTCTATTTCG-1"	"A"
"GCGATCGAGAAGCCGT-1"	"A"
"GCGATCGAGACCCTAT-1"	"G"
"GCGATCGAGGGTTCTT-1"	"A"
"GCGATCGAGGTTTCTG-1"	"A"
"GCGATCGAGTCTTAGC-1"	"G"
"GCGATCGCAAACCCTA-1"	"A"
"GCGATCGCAAGTAATG-1"	"A"
"GCGATCGCACCACAGC-1"	"A"
"GCGATCGCAGGCATCC-1"	"A"
"GCGATCGGTAACGGAC-1"	"G"
"GCGATCGGTAGCATGG-1"	"G"
"GCGATCGGTCATTGCA-1"	"G"
"GCGATCGGTTCCCAAA-1"	"A"
"GCGATCGTCAAATGGA-1"	"G"
"GCGATCGTCCCATAGA-1"	"A"
"GCGATCGTCCTAAAGC-1"	"A"
"GCGATCGTCCTGAAAC-1"	"A"
"GCGATCGTCGATATGC-1"	"A"
"GCGATCGTCGTGAGTT-1"	"A"
"GCGATCGTCGTTCCGT-1"	"A"
"GCGATCGTCTGGACAT-1"	"G"
"GCGATTAAGAACCATA-1"	"A"
"GCGATTAAGAGAGTAG-1"	"A"
"GCGATTAAGCTATCGT-1"	"A"
"GCGATTAAGGAAGGTA-1"	"A"
"GCGATTAAGGCCTAAG-1"	"A"
"GCGATTAAGTGCACAG-1"	"A"
"GCGATTACAACTCGAT-1"	"A"
"GCGATTACACGGCCAT-1"	"A"
"GCGATTACACTGTCGG-1"	"G"
"GCGATTAGTACATGGG-1"	"G"
"GCGATTAGTGTTGGTT-1"	"A"
"GCGATTAGTTTCGACA-1"	"G"
"GCGATTATCCCTACGT-1"	"G"
"GCGATTATCGATAGCT-1"	"A"
"GCGATTATCGTAGCGC-1"	"A"
"GCGATTATCTGAACGT-1"	"A"
"GCGCATGAGAAACGCC-1"	"A"
"GCGCATGAGCAGAATT-1"	"G"
"GCGCATGAGGAGGCGA-1"	"G"
"GCGCATGAGTAGTGTA-1"	"A"
"GCGCATGAGTCTGGGA-1"	"A"
"GCGCATGGTTCTACGA-1"	"G"
"GCGCATGTCCTGACCT-1"	"A"
"GCGCATGTCGCTATTT-1"	"A"
"GCGCATGTCTGAAAGA-1"	"G"
"GCGCCAAAGCCTGTAT-1"	"A"
"GCGCCAAAGCGCCTAC-1"	"G"
"GCGCCAAAGGCCAGTA-1"	"G"
"GCGCCAAAGTAATCAG-1"	"G"
"GCGCCAACAACTAGAA-1"	"G"
"GCGCCAAGTCAAACAA-1"	"G"
"GCGCCAATCACGTCAA-1"	"A"
"GCGCCAATCGATGAAA-1"	"A"
"GCGCCAATCGTATAGC-1"	"A"
"GCGCCAATCTTCACTA-1"	"G"
"GCGCCAATCTTCCAGC-1"	"G"
"GCGGAAAAGAGTCCGA-1"	"A"
"GCGGAAAAGGCCAGTA-1"	"A"
"GCGGAAAAGGGTTCCC-1"	"G"
"GCGGAAACAACTTGGT-1"	"G"
"GCGGAAACAGGCACAA-1"	"G"
"GCGGAAACAGGTAGCA-1"	"A"
"GCGGAAACATAGAATG-1"	"A"
"GCGGAAAGTACGTATC-1"	"A"
"GCGGAAAGTACTAGAA-1"	"A"
"GCGGAAAGTCTTAGCA-1"	"A"
"GCGGAAAGTGCATTGT-1"	"A"
"GCGGAAAGTGTCGTGC-1"	"G"
"GCGGAAAGTTGGTAAA-1"	"G"
"GCGGAAATCCCGAAGC-1"	"G"
"GCGGAAATCCGTTAGA-1"	"A"
"GCGGAAATCGCCAGAC-1"	"A"
"GCGGAAATCGCGATGC-1"	"G"
"GCGGAAATCTATAGGC-1"	"A"
"GCGGGTTAGATCTAAG-1"	"G"
"GCGGGTTAGATTCCGT-1"	"G"
"GCGGGTTAGGAGACTC-1"	"A"
"GCGGGTTAGTGCTGAG-1"	"G"
"GCGGGTTCAATCACTG-1"	"A"
"GCGGGTTCACAAGGGT-1"	"A"
"GCGGGTTCAGGTCCTG-1"	"A"
"GCGGGTTCATTGCCTC-1"	"A"
"GCGGGTTGTAAAGCTA-1"	"G"
"GCGGGTTGTACCCACG-1"	"G"
"GCGGGTTGTAGGTCTT-1"	"A"
"GCGGGTTGTCAACTGT-1"	"G"
"GCGGGTTGTGCATTCA-1"	"A"
"GCGGGTTGTTCCTATT-1"	"A"
"GCGGGTTGTTTCCGGG-1"	"G"
"GCGGGTTTCCGAGAGA-1"	"G"
"GCGGGTTTCCGTTTCG-1"	"A"
"GCGGGTTTCCTTTGCG-1"	"A"
"GCGGGTTTCTTTGCAT-1"	"A"
"GCGGTGTAGACTAGCG-1"	"G"
"GCGGTGTAGAGAGGTA-1"	"A"
"GCGGTGTAGATGGCAC-1"	"A"
"GCGGTGTCAAGCAATA-1"	"G"
"GCGGTGTCAGAATGCG-1"	"G"
"GCGGTGTCAGCTATAC-1"	"A"
"GCGGTGTCATTAACGC-1"	"A"
"GCGGTGTGTACCAAGG-1"	"A"
"GCGGTGTGTGAATGTA-1"	"A"
"GCGGTGTTCATGCTTT-1"	"G"
"GCGTAGCAGAATGCTA-1"	"G"
"GCGTAGCAGATCGAGC-1"	"A"
"GCGTAGCAGCGTTAGG-1"	"G"
"GCGTAGCAGGCTCAGA-1"	"G"
"GCGTAGCAGTCCCTCT-1"	"A"
"GCGTAGCCACATATCG-1"	"G"
"GCGTAGCGTACTTCGA-1"	"A"
"GCGTAGCTCACCCTTG-1"	"G"
"GCGTTGGAGAACTCCT-1"	"A"
"GCGTTGGAGACAACGC-1"	"A"
"GCGTTGGAGATCTCAC-1"	"G"
"GCGTTGGAGATGCGAC-1"	"G"
"GCGTTGGAGTACGACG-1"	"G"
"GCGTTGGAGTTGCCGC-1"	"A"
"GCGTTGGCAAACTACC-1"	"G"
"GCGTTGGCAAGGCTTT-1"	"G"
"GCGTTGGCAAGGTTCT-1"	"A"
"GCGTTGGGTAGGGTCA-1"	"A"
"GCGTTGGGTCAGAGTG-1"	"G"
"GCGTTGGGTCTGTCCT-1"	"A"
"GCGTTGGGTCTGTTGA-1"	"A"
"GCGTTGGGTTACCACA-1"	"G"
"GCGTTGGGTTCGGGAA-1"	"G"
"GCGTTGGGTTCTCGAA-1"	"A"
"GCGTTGGGTTTGCCCT-1"	"G"
"GCGTTGGTCAACTTGG-1"	"A"
"GCTCACTAGGAATGGA-1"	"A"
"GCTCACTAGTCGTATC-1"	"A"
"GCTCACTCAAAGCTTC-1"	"A"
"GCTCACTCAAGAGATT-1"	"A"
"GCTCACTCACGTTGTA-1"	"G"
"GCTCACTCAGAGATGC-1"	"G"
"GCTCACTCAGAGCCAA-1"	"G"
"GCTCACTCATGCACTA-1"	"G"
"GCTCACTGTCAACTAC-1"	"A"
"GCTCACTGTGGTCGAA-1"	"A"
"GCTCACTGTTCTTATC-1"	"G"
"GCTCACTGTTGCCTGG-1"	"A"
"GCTCACTTCTGAGTCA-1"	"A"
"GCTCAGGAGAAATCTG-1"	"A"
"GCTCAGGAGCCTGTAT-1"	"A"
"GCTCAGGAGCGTAGCA-1"	"A"
"GCTCAGGAGGTAAGCC-1"	"A"
"GCTCAGGAGTGTAATG-1"	"A"
"GCTCAGGCAATCAGGG-1"	"G"
"GCTCAGGGTACGGATG-1"	"G"
"GCTCAGGGTAGTTTGC-1"	"G"
"GCTCAGGGTATCCCTC-1"	"A"
"GCTCAGGTCAGGTTTG-1"	"G"
"GCTCAGGTCCTATCAT-1"	"G"
"GCTCAGGTCTCGACCT-1"	"A"
"GCTCCTAAGAACCATA-1"	"G"
"GCTCCTAAGAGCGGTT-1"	"G"
"GCTCCTAAGAGCTCCC-1"	"G"
"GCTCCTAAGGAAACTT-1"	"G"
"GCTCCTAAGGCACCTC-1"	"A"
"GCTCCTAAGTGTCGGA-1"	"G"
"GCTCCTACAATGGCAG-1"	"G"
"GCTCCTACATCCTGGG-1"	"A"
"GCTCCTAGTCATCGTA-1"	"A"
"GCTCGAGAGCGAGAAA-1"	"A"
"GCTCGAGAGGGACGTT-1"	"G"
"GCTCGAGAGGTTTCTG-1"	"G"
"GCTCGAGAGTGCTAGG-1"	"G"
"GCTCGAGAGTGCTCGC-1"	"G"
"GCTCGAGGTAGAAGCC-1"	"A"
"GCTCGAGGTAGACGCA-1"	"A"
"GCTCGAGGTTACGGAG-1"	"G"
"GCTCGAGTCCAGGTAT-1"	"A"
"GCTCGAGTCTCAGATG-1"	"G"
"GCTGAGCAGAGTGGAA-1"	"G"
"GCTGAGCAGTGATCTC-1"	"G"
"GCTGAGCAGTGTAATG-1"	"G"
"GCTGAGCAGTTATGAG-1"	"G"
"GCTGAGCCAGGTAACG-1"	"A"
"GCTGAGCGTGAGTTGG-1"	"A"
"GCTGAGCGTTACCACA-1"	"A"
"GCTGAGCTCCTTCGAC-1"	"A"
"GCTGAGCTCGTAGCGC-1"	"A"
"GCTGCGAAGCGTTAGG-1"	"A"
"GCTGCGAAGGTGAACC-1"	"G"
"GCTGCGACAGTAGGCA-1"	"A"
"GCTGCGAGTAAGTCTC-1"	"A"
"GCTGCGAGTCATAAGA-1"	"G"
"GCTGCGAGTGTCGTGC-1"	"A"
"GCTGCGAGTTGCAGAG-1"	"A"
"GCTGCGAGTTTAAGGA-1"	"G"
"GCTGCGATCACTAGGT-1"	"G"
"GCTGCGATCATGCTTT-1"	"A"
"GCTGCGATCCTAAAGC-1"	"G"
"GCTGTTCAGACTTGAA-1"	"A"
"GCTGTTCAGGTGAACC-1"	"A"
"GCTGTTCAGTTCGACT-1"	"A"
"GCTGTTCCAAGCCCTG-1"	"G"
"GCTGTTCCATGTATCG-1"	"A"
"GCTGTTCGTACTTGAC-1"	"G"
"GCTGTTCGTAGGTCTT-1"	"G"
"GCTGTTCGTGCATTCA-1"	"G"
"GCTGTTCGTTCCAATG-1"	"A"
"GCTGTTCGTTGGCTTA-1"	"A"
"GCTGTTCTCGGCTATA-1"	"A"
"GCTGTTCTCTCCAACC-1"	"G"
"GCTGTTCTCTGTCGGG-1"	"G"
"GCTGTTCTCTTAAGCG-1"	"A"
"GCTTAAGCAAGCCTTA-1"	"A"
"GCTTAAGCAAGTAATG-1"	"G"
"GCTTAAGCAGGTCTGC-1"	"G"
"GCTTAAGCATCACAGT-1"	"A"
"GCTTAAGCATCGCTAA-1"	"A"
"GCTTAAGGTCGGCTGT-1"	"G"
"GCTTAAGGTGTCGTCG-1"	"G"
"GCTTAAGTCAGGTTTG-1"	"A"
"GCTTAAGTCCAGGGAA-1"	"A"
"GCTTAAGTCGGGACAA-1"	"G"
"GCTTGCTAGAGCAGCT-1"	"A"
"GCTTGCTAGCCATGGA-1"	"A"
"GCTTGCTCATCCCGGA-1"	"A"
"GCTTGCTCATGTCCCT-1"	"A"
"GCTTGCTCATTTGGCA-1"	"G"
"GCTTGCTGTGAATACA-1"	"A"
"GCTTGCTGTTATGCAC-1"	"A"
"GCTTGCTGTTGAAGCG-1"	"G"
"GCTTGCTTCACTCCCA-1"	"A"
"GCTTGCTTCCATATCT-1"	"A"
"GCTTGCTTCTTGCGCT-1"	"G"
"GCTTTCGCAAACCTAC-1"	"A"
"GCTTTCGCAAAGACGC-1"	"A"
"GCTTTCGCATGTAGAA-1"	"G"
"GCTTTCGGTTACCACA-1"	"G"
"GCTTTCGGTTACCCAA-1"	"G"
"GCTTTCGGTTATCGAC-1"	"A"
"GCTTTCGGTTTGGATC-1"	"G"
"GCTTTCGTCACATTCT-1"	"A"
"GCTTTCGTCTGGCACG-1"	"A"
"GCTTTCGTCTTGTACT-1"	"A"
"GGAACCCAGGTCCTCG-1"	"A"
"GGAACCCCAAACCCTA-1"	"A"
"GGAACCCCAATGAAAC-1"	"A"
"GGAACCCCAGGTGTCC-1"	"G"
"GGAACCCCAGTATCTG-1"	"A"
"GGAACCCCATACAACC-1"	"G"
"GGAACCCCATTGAACC-1"	"A"
"GGAACCCGTGCGTTTA-1"	"G"
"GGAACCCGTTCTGAGT-1"	"A"
"GGAACCCTCATACTTC-1"	"A"
"GGAACCCTCGGATGTT-1"	"G"
"GGAACTTAGCTTCAAC-1"	"A"
"GGAACTTAGTACGCGA-1"	"A"
"GGAACTTAGTCGATAA-1"	"A"
"GGAACTTCAACTCGAT-1"	"G"
"GGAACTTCATGATTGC-1"	"A"
"GGAACTTCATGCGTTA-1"	"G"
"GGAACTTGTAGAATAC-1"	"G"
"GGAACTTGTATCTGCA-1"	"A"
"GGAACTTGTCCGCTTT-1"	"A"
"GGAACTTGTCTAACCA-1"	"G"
"GGAACTTGTTCCTATT-1"	"G"
"GGAATCTAGATGTTGA-1"	"A"
"GGAATCTAGTCTTAGC-1"	"A"
"GGAATCTCAAGACTTC-1"	"A"
"GGAATCTCAAGCACTT-1"	"G"
"GGAATCTCAAGCTTTG-1"	"A"
"GGAATCTCAATGGCTT-1"	"A"
"GGAATCTCACATCATG-1"	"G"
"GGAATCTCAGAATGCG-1"	"A"
"GGAATCTCAGGTCTGC-1"	"G"
"GGAATCTCATACCCGG-1"	"G"
"GGAATCTCATCCTCGT-1"	"G"
"GGAATCTCATCCTGGG-1"	"G"
"GGAATCTTCCCAGCAG-1"	"A"
"GGAATCTTCGACTGGC-1"	"A"
"GGAATCTTCGTATAGC-1"	"G"
"GGAATCTTCTGGGCGT-1"	"G"
"GGACACCAGAGCACTG-1"	"G"
"GGACACCAGTGATCTC-1"	"G"
"GGACACCAGTTCGACT-1"	"A"
"GGACACCCAAAGAAGG-1"	"A"
"GGACACCCACAGCTTA-1"	"A"
"GGACACCCAGTAACTC-1"	"A"
"GGACACCCATCAGAAA-1"	"A"
"GGACACCGTCAAATCC-1"	"G"
"GGACACCGTGATAACA-1"	"G"
"GGACACCGTTCTACCC-1"	"A"
"GGACACCTCAAACCCA-1"	"A"
"GGACACCTCAATTCCT-1"	"G"
"GGACACCTCCAACCTC-1"	"G"
"GGACACCTCGTGAACT-1"	"A"
"GGAGAACAGACCGCAA-1"	"G"
"GGAGAACAGTCAGGAC-1"	"A"
"GGAGAACCAAGCCCTG-1"	"G"
"GGAGAACCAAGTCTGT-1"	"G"
"GGAGAACCAATCCATG-1"	"A"
"GGAGAACCAATGCCAT-1"	"A"
"GGAGAACCACAGTTAC-1"	"G"
"GGAGAACCATCCATAG-1"	"G"
"GGAGAACGTAATGTGA-1"	"G"
"GGAGAACGTACGCAAG-1"	"A"
"GGAGAACGTTACACTG-1"	"A"
"GGAGAACGTTCAGTAC-1"	"G"
"GGAGAACTCCGAGAGA-1"	"G"
"GGAGAACTCGGTTCCT-1"	"A"
"GGAGAACTCTCATCCG-1"	"G"
"GGAGAACTCTGGTACA-1"	"A"
"GGAGGATAGGTACATA-1"	"G"
"GGAGGATAGTATCTGC-1"	"A"
"GGAGGATAGTTCAGGG-1"	"A"
"GGAGGATCAAGCTTTG-1"	"G"
"GGAGGATCACGAACGA-1"	"G"
"GGAGGATCAGTATCTG-1"	"A"
"GGAGGATGTAAAGGCC-1"	"A"
"GGAGGATGTCTCGGGT-1"	"A"
"GGAGGATGTGGAGTGT-1"	"A"
"GGAGGATGTGGTCGAA-1"	"G"
"GGAGGATGTTTCGACA-1"	"A"
"GGAGGATGTTTGACCA-1"	"A"
"GGAGGATGTTTGTACG-1"	"A"
"GGAGGATTCACGATTG-1"	"A"
"GGAGGATTCCATAACG-1"	"G"
"GGAGGATTCGCATAAC-1"	"G"
"GGAGGATTCTATTTCG-1"	"A"
"GGAGTAGAGAAGACTT-1"	"A"
"GGAGTAGAGAGTCCGA-1"	"G"
"GGAGTAGAGGCAAGGG-1"	"A"
"GGAGTAGAGGTACACG-1"	"A"
"GGAGTAGAGTCCGGAA-1"	"A"
"GGAGTAGAGTGAGCTG-1"	"G"
"GGAGTAGAGTGGACGT-1"	"G"
"GGAGTAGCAAGGTCGA-1"	"A"
"GGAGTAGGTATTCTGG-1"	"A"
"GGAGTAGGTGAATACA-1"	"A"
"GGAGTAGGTTCACGTA-1"	"G"
"GGAGTAGGTTCCCAAA-1"	"G"
"GGAGTAGGTTGCTTGA-1"	"G"
"GGAGTAGGTTGTATCG-1"	"A"
"GGAGTAGTCGATATGC-1"	"A"
"GGATAGGAGAACCATA-1"	"A"
"GGATAGGAGTATGGGC-1"	"A"
"GGATAGGCAAATTCCG-1"	"A"
"GGATAGGCAAGGAAGA-1"	"A"
"GGATAGGCACGGTTAT-1"	"A"
"GGATAGGGTATTCTTC-1"	"G"
"GGATAGGGTGATGCGA-1"	"A"
"GGATAGGGTGTCTACA-1"	"A"
"GGATAGGTCCTTCGAC-1"	"A"
"GGATAGGTCTCCACTG-1"	"A"
"GGATAGGTCTCCTTAA-1"	"G"
"GGATAGGTCTGGCTAA-1"	"A"
"GGATGAGAGGGACGTT-1"	"A"
"GGATGAGAGGGTCCCT-1"	"G"
"GGATGAGAGTCCAGAG-1"	"A"
"GGATGAGCAGCAACAG-1"	"A"
"GGATGAGCAGTCAGAG-1"	"G"
"GGATGAGCATGCCCTT-1"	"A"
"GGATGAGGTCGTCGCA-1"	"G"
"GGATGAGGTTACGGAG-1"	"A"
"GGATGAGTCAGTCACA-1"	"G"
"GGATGAGTCCAGAATC-1"	"G"
"GGATGAGTCCATAACG-1"	"A"
"GGATGAGTCGGGTCCA-1"	"G"
"GGCACGTAGAGGTACC-1"	"A"
"GGCACGTAGCGAGAAA-1"	"A"
"GGCACGTAGTTGAATG-1"	"G"
"GGCACGTCAAGCAGGT-1"	"G"
"GGCACGTCATTGAACC-1"	"G"
"GGCACGTGTATGGTTC-1"	"A"
"GGCACGTGTCAGCAAG-1"	"G"
"GGCACGTGTGCAGACA-1"	"A"
"GGCACGTTCCTATCCG-1"	"G"
"GGCACGTTCGACTTAG-1"	"A"
"GGCATTAAGACCCATT-1"	"A"
"GGCATTAAGACTTCCA-1"	"G"
"GGCATTAAGGCAGATC-1"	"A"
"GGCATTACAACACGGA-1"	"A"
"GGCATTACAATGACTC-1"	"G"
"GGCATTACACAGATGG-1"	"A"
"GGCATTAGTTCTGAGT-1"	"G"
"GGCATTAGTTTGTGAC-1"	"A"
"GGCATTATCACCACAA-1"	"G"
"GGCATTATCACGTCAA-1"	"A"
"GGCGAAAAGAATATCG-1"	"A"
"GGCGAAAAGGCCAGTA-1"	"G"
"GGCGAAACAAGTCTCA-1"	"A"
"GGCGAAACAATAGTGA-1"	"G"
"GGCGAAACACCATTCC-1"	"G"
"GGCGAAACACCGTCTT-1"	"G"
"GGCGAAACATGTAGAA-1"	"A"
"GGCGAAAGTACTTCAG-1"	"A"
"GGCGAAAGTAGGTGAC-1"	"G"
"GGCGAAATCTGGCACG-1"	"A"
"GGCGTTGAGAGCTACG-1"	"G"
"GGCGTTGAGAGCTCCC-1"	"A"
"GGCGTTGAGGACTTTC-1"	"G"
"GGCGTTGAGGGTTCCC-1"	"G"
"GGCGTTGAGTAGACCG-1"	"G"
"GGCGTTGAGTCATACC-1"	"A"
"GGCGTTGCAAATTCCG-1"	"A"
"GGCGTTGCAAGGTCGA-1"	"G"
"GGCGTTGCACATTCTT-1"	"A"
"GGCGTTGGTAGACGCA-1"	"A"
"GGCGTTGGTCCTTCAC-1"	"G"
"GGCGTTGGTTTCCACC-1"	"A"
"GGCGTTGTCAACGTGT-1"	"G"
"GGCGTTGTCGGGCTCA-1"	"A"
"GGGAACAAGCGTATCT-1"	"A"
"GGGAACAAGCTACGCC-1"	"A"
"GGGAACAAGCTAGCAG-1"	"G"
"GGGAACAAGCTGATTC-1"	"A"
"GGGAACAAGGGCGAAG-1"	"G"
"GGGAACAAGTCTGCTA-1"	"G"
"GGGAACACAACGAGGT-1"	"G"
"GGGAACACAACTGCGC-1"	"G"
"GGGAACAGTATACGCT-1"	"A"
"GGGAACAGTCAACTGT-1"	"G"
"GGGAACAGTGACAAGC-1"	"A"
"GGGAACAGTGCTGTCG-1"	"A"
"GGGAACAGTTCCTATT-1"	"A"
"GGGAACAGTTTGATCG-1"	"A"
"GGGAACATCCCAATGA-1"	"A"
"GGGAACATCGCCGAAC-1"	"G"
"GGGAACATCTCCTTAA-1"	"G"
"GGGAACATCTGGCACG-1"	"A"
"GGGACCTAGAAACGCC-1"	"G"
"GGGACCTAGGTCACTT-1"	"A"
"GGGACCTAGGTTGACG-1"	"G"
"GGGACCTCAACGACAG-1"	"A"
"GGGACCTCAATGTAAG-1"	"A"
"GGGACCTCAGGCATCC-1"	"A"
"GGGACCTGTCAATCCA-1"	"G"
"GGGACCTGTCTGTGTA-1"	"A"
"GGGACCTGTGATGCTT-1"	"G"
"GGGACCTGTGTCGTCG-1"	"A"
"GGGACCTTCCGAATTG-1"	"A"
"GGGCCATAGGATGTCG-1"	"A"
"GGGCCATAGGTTGTTC-1"	"A"
"GGGCCATCAGATACAA-1"	"G"
"GGGCCATCATCACAGT-1"	"G"
"GGGCCATCATGGCCGT-1"	"A"
"GGGCCATGTGCCAAGA-1"	"G"
"GGGCCATGTTAGTAGA-1"	"G"
"GGGCCATGTTATAGAG-1"	"G"
"GGGCCATGTTTGACCA-1"	"A"
"GGGCCATTCGGTCAGC-1"	"A"
"GGGCCATTCGTGAGTT-1"	"G"
"GGGTCTGAGAAATGGG-1"	"A"
"GGGTCTGAGACCAATA-1"	"G"
"GGGTCTGAGGTCCTCG-1"	"G"
"GGGTCTGAGTCTCGAT-1"	"A"
"GGGTCTGCACAGCCAC-1"	"A"
"GGGTCTGCAGATTTGC-1"	"G"
"GGGTCTGCATCACAAC-1"	"A"
"GGGTCTGGTACGTAAA-1"	"A"
"GGGTCTGGTAGTTTGC-1"	"A"
"GGGTCTGGTATCTAGC-1"	"G"
"GGGTCTGGTCTGGGCT-1"	"A"
"GGGTCTGGTGCTGAAG-1"	"A"
"GGGTCTGGTTGTGAGG-1"	"A"
"GGGTCTGTCGCCACTT-1"	"A"
"GGGTGTCAGAGTTTGA-1"	"A"
"GGGTGTCAGGACTTTC-1"	"G"
"GGGTGTCAGGATTTGA-1"	"A"
"GGGTGTCAGGCAAGCT-1"	"G"
"GGGTGTCCAAGACTTC-1"	"A"
"GGGTGTCCAAGCCCTG-1"	"A"
"GGGTGTCCAAGGTTCT-1"	"A"
"GGGTGTCCATAGAATG-1"	"A"
"GGGTGTCGTCAGGCTC-1"	"A"
"GGGTGTCGTCCAGACC-1"	"G"
"GGGTGTCGTCTCAAAC-1"	"A"
"GGGTGTCGTGCCCAGT-1"	"G"
"GGGTGTCGTTCTGAGT-1"	"A"
"GGGTGTCTCGCCCTTA-1"	"A"
"GGGTGTCTCGGGCTCA-1"	"G"
"GGGTGTCTCGGTAGGA-1"	"A"
"GGGTTATCAATTCTCT-1"	"A"
"GGGTTATCACGCTGTG-1"	"A"
"GGGTTATCACTGCTCT-1"	"A"
"GGGTTATGTACTTCAG-1"	"G"
"GGGTTATGTAGAATAC-1"	"A"
"GGGTTATGTTGGGAAC-1"	"A"
"GGGTTATTCCCGAAGC-1"	"A"
"GGGTTATTCTTCGTTA-1"	"G"
"GGTACCGCAAAGCATA-1"	"A"
"GGTACCGGTCAATCCA-1"	"G"
"GGTAGGAAGACCCTAT-1"	"G"
"GGTAGGACAATGAAAC-1"	"G"
"GGTAGGACAGTAGTCT-1"	"A"
"GGTAGGAGTAAGCCTT-1"	"A"
"GGTAGGAGTAGAACGC-1"	"A"
"GGTAGGAGTGAGGGTT-1"	"A"
"GGTAGGATCGCAAGCC-1"	"G"
"GGTAGGATCGGTCCGA-1"	"A"
"GGTCATACAACGAGGT-1"	"G"
"GGTCATACATGGGACA-1"	"A"
"GGTCATAGTAGCGTTT-1"	"A"
"GGTCATAGTCATGAGG-1"	"G"
"GGTCATATCAGTCACA-1"	"G"
"GGTCATATCCCGTATC-1"	"A"
"GGTCATATCGAGGTCC-1"	"A"
"GGTCATATCGCATACA-1"	"A"
"GGTCATATCGCGGCAT-1"	"A"
"GGTCATATCGGACGAA-1"	"A"
"GGTCATATCTGATCCC-1"	"A"
"GGTCATATCTTCAGAG-1"	"G"
"GGTGAAGAGATTAGAC-1"	"A"
"GGTGAAGAGGCAAGGG-1"	"A"
"GGTGAAGAGGCATGCA-1"	"G"
"GGTGAAGCAACTACTG-1"	"A"
"GGTGAAGCACTGTCGG-1"	"A"
"GGTGAAGCAGCGTAGA-1"	"A"
"GGTGAAGGTTCTCGAA-1"	"A"
"GGTGAAGTCCATTGTT-1"	"G"
"GGTGAAGTCCGGACTG-1"	"A"
"GGTGAAGTCGGTCCGA-1"	"G"
"GGTGAAGTCGTTACAG-1"	"G"
"GGTGAAGTCTAGCAAC-1"	"G"
"GGTGCTGAGAAATACC-1"	"A"
"GGTGCTGAGTAGGAAG-1"	"A"
"GGTGCTGCATGCTATG-1"	"G"
"GGTGCTGGTATTCGAC-1"	"G"
"GGTGCTGGTCAATCCA-1"	"A"
"GGTGCTGGTGATAACA-1"	"G"
"GGTGCTGGTGGACTGA-1"	"G"
"GGTGCTGTCCATATCT-1"	"G"
"GGTGCTGTCTCCCTTT-1"	"A"
"GGTGTCGAGACAGTGC-1"	"A"
"GGTGTCGAGACCCATT-1"	"A"
"GGTGTCGAGAGCGGTT-1"	"A"
"GGTGTCGAGGCTTCGC-1"	"A"
"GGTGTCGAGGGCGAAG-1"	"A"
"GGTGTCGAGTATACCC-1"	"G"
"GGTGTCGAGTTGCCGC-1"	"G"
"GGTGTCGCAGTCAGAG-1"	"A"
"GGTGTCGCATCATAGC-1"	"A"
"GGTGTCGGTACAAATG-1"	"A"
"GGTGTCGGTCAGCAAG-1"	"A"
"GGTGTCGGTCTGCACG-1"	"A"
"GGTGTCGGTGGAGTGT-1"	"G"
"GGTGTCGTCAGGATCT-1"	"A"
"GGTGTCGTCTAGCAGT-1"	"G"
"GGTTGCGAGCAGTAGC-1"	"G"
"GGTTGCGAGGGAAATG-1"	"A"
"GGTTGCGCAAGGGAGG-1"	"G"
"GGTTGCGCAATACTGC-1"	"A"
"GGTTGCGCATGGTAAA-1"	"A"
"GGTTGCGCATTCTTTG-1"	"G"
"GGTTGCGGTAATGTAG-1"	"G"
"GGTTGCGGTCAAACAA-1"	"G"
"GGTTGCGTCACTACCC-1"	"G"
"GGTTGCGTCCTGAAAC-1"	"G"
"GTAATCGAGCTCGGCT-1"	"G"
"GTAATCGAGGGTATCG-1"	"A"
"GTAATCGAGGTCGTTT-1"	"A"
"GTAATCGAGTAGAAGG-1"	"G"
"GTAATCGCAACAACTC-1"	"G"
"GTAATCGCAATTAGGA-1"	"G"
"GTAATCGCAGAGATGC-1"	"G"
"GTAATCGCATTTGTTC-1"	"G"
"GTAATCGGTTGGAGGT-1"	"A"
"GTAATCGTCCATTGTT-1"	"G"
"GTAATCGTCGCATACA-1"	"G"
"GTAATCGTCGTCAACA-1"	"A"
"GTAATCGTCTTCTTCC-1"	"A"
"GTACTTTAGGGCTCTC-1"	"G"
"GTACTTTAGTCCGTGC-1"	"G"
"GTACTTTAGTGGTGTG-1"	"A"
"GTACTTTCAAACGTTC-1"	"G"
"GTACTTTCAAGTCTGT-1"	"A"
"GTACTTTCACGCGCAT-1"	"G"
"GTACTTTCACGTTAGT-1"	"A"
"GTACTTTCATTCTTTG-1"	"A"
"GTACTTTGTACAACGG-1"	"A"
"GTACTTTGTGCAAAGC-1"	"A"
"GTACTTTGTTAAGGGC-1"	"G"
"GTACTTTGTTCTGAAC-1"	"A"
"GTACTTTTCCCGGGTA-1"	"A"
"GTACTTTTCCTCTCTT-1"	"G"
"GTACTTTTCGCATAAC-1"	"G"
"GTACTTTTCGGTTCCT-1"	"G"
"GTACTTTTCTACTTTG-1"	"A"
"GTACTTTTCTGATCTT-1"	"A"
"GTACTTTTCTGGCTAA-1"	"G"
"GTACTTTTCTTACTCA-1"	"A"
"GTAGACTAGGGTCTGA-1"	"A"
"GTAGACTCAAGGAAGA-1"	"A"
"GTAGACTCAATTAGGA-1"	"A"
"GTAGACTCACGAACGA-1"	"G"
"GTAGACTCAGTGCTCG-1"	"G"
"GTAGACTCATCGGCCA-1"	"A"
"GTAGACTGTGCGTAGA-1"	"A"
"GTAGACTGTTGGGAAC-1"	"A"
"GTAGACTTCACTCCCA-1"	"G"
"GTAGACTTCAGTTGAC-1"	"G"
"GTAGGAGAGACACGGT-1"	"G"
"GTAGGAGAGGAATGGA-1"	"A"
"GTAGGAGAGGTTACAA-1"	"G"
"GTAGGAGAGTCATACC-1"	"A"
"GTAGGAGAGTTCCCGG-1"	"G"
"GTAGGAGCAAACCCTA-1"	"G"
"GTAGGAGCACTGTAAC-1"	"G"
"GTAGGAGGTGATAACA-1"	"G"
"GTAGGAGTCGTCTTAT-1"	"A"
"GTAGTACAGAGAGTAG-1"	"G"
"GTAGTACAGGCCAATG-1"	"A"
"GTAGTACAGGGACGTT-1"	"A"
"GTAGTACAGTTATGAG-1"	"G"
"GTAGTACCAATCAGGG-1"	"G"
"GTAGTACCAATGGTCT-1"	"A"
"GTAGTACCAGAATGCG-1"	"A"
"GTAGTACGTAAAGCTA-1"	"G"
"GTAGTACGTAGACGCA-1"	"G"
"GTAGTACGTAGTCCAT-1"	"A"
"GTAGTACGTTCTGAAC-1"	"G"
"GTAGTACTCACAGGGA-1"	"A"
"GTAGTACTCCATACCC-1"	"A"
"GTAGTACTCCATACGA-1"	"A"
"GTAGTACTCCGAGGAA-1"	"G"
"GTAGTACTCGGTCAGC-1"	"A"
"GTAGTACTCTCGCGGA-1"	"A"
"GTAGTACTCTGGCCAG-1"	"G"
"GTCACAAAGAGCAGCT-1"	"A"
"GTCACAAAGAGTTTGA-1"	"A"
"GTCACAAAGTTGCCGC-1"	"A"
"GTCACAACAAAGACGC-1"	"G"
"GTCACAACAACTTGGT-1"	"G"
"GTCACAACAAGGATGC-1"	"G"
"GTCACAACAGCAACAG-1"	"G"
"GTCACAACAGGTAGCA-1"	"A"
"GTCACAACATGGAGGT-1"	"A"
"GTCACAAGTAGCCATT-1"	"A"
"GTCACAAGTTAACCGT-1"	"G"
"GTCACAATCAAATGGA-1"	"A"
"GTCACAATCATGTTCT-1"	"A"
"GTCACCTAGGTTAACA-1"	"A"
"GTCACCTAGTCCGGAA-1"	"G"
"GTCACCTAGTCGAAAT-1"	"A"
"GTCACCTGTAACAATG-1"	"A"
"GTCACCTGTAAGCCTT-1"	"A"
"GTCACCTGTCAATACC-1"	"G"
"GTCACCTGTCAGGTGA-1"	"A"
"GTCACCTGTTAGAGAT-1"	"A"
"GTCACCTGTTTCGATG-1"	"G"
"GTCACCTTCAATTCCT-1"	"G"
"GTCACCTTCACTCGGG-1"	"A"
"GTCACCTTCATGTTCT-1"	"A"
"GTCACCTTCGCGGCAT-1"	"A"
"GTCACGGAGGAGAACA-1"	"G"
"GTCACGGAGGGACGTT-1"	"A"
"GTCACGGAGTATAGTG-1"	"A"
"GTCACGGAGTCCCGCA-1"	"A"
"GTCACGGAGTGCCCTG-1"	"G"
"GTCACGGCAACGTAGG-1"	"G"
"GTCACGGCAGGATAGC-1"	"G"
"GTCACGGGTAAACGTA-1"	"A"
"GTCACGGGTATCCCTC-1"	"A"
"GTCACGGGTATCCTTT-1"	"G"
"GTCACGGGTCAACGGA-1"	"G"
"GTCACGGGTCAGTGTT-1"	"G"
"GTCACGGGTTAGTAGA-1"	"G"
"GTCACGGGTTCCAGTA-1"	"A"
"GTCACGGGTTTGACCA-1"	"G"
"GTCACGGTCAAAGTAG-1"	"G"
"GTCACGGTCATTCTCA-1"	"A"
"GTCACGGTCATTGCCC-1"	"A"
"GTCACGGTCCAGGTCG-1"	"G"
"GTCACGGTCCTGACCT-1"	"G"
"GTCACGGTCGTCTAGA-1"	"A"
"GTCACGGTCTTACGGA-1"	"A"
"GTCACTCAGTGTTCCA-1"	"A"
"GTCACTCAGTTACACC-1"	"G"
"GTCACTCCAGACTAAA-1"	"G"
"GTCACTCCATTGCCTC-1"	"A"
"GTCACTCCATTTGGCA-1"	"A"
"GTCACTCGTAACAATG-1"	"A"
"GTCACTCGTAGAATAC-1"	"A"
"GTCACTCGTAGACACG-1"	"G"
"GTCACTCGTCCTTATT-1"	"A"
"GTCACTCTCAGTACAC-1"	"A"
"GTCACTCTCCCGTATC-1"	"G"
"GTCACTCTCGCAAACT-1"	"G"
"GTCACTCTCTAAACGC-1"	"G"
"GTCCATCAGAATGCTA-1"	"A"
"GTCCATCAGCTGAATA-1"	"G"
"GTCCATCAGGCCTCTG-1"	"G"
"GTCCATCAGGGCGAAG-1"	"A"
"GTCCATCAGTGAACCG-1"	"A"
"GTCCATCAGTGTGTAA-1"	"A"
"GTCCATCAGTTAGCAA-1"	"G"
"GTCCATCCATTCACCC-1"	"A"
"GTCCATCGTAGAGAGA-1"	"A"
"GTCCATCTCATTGCCC-1"	"A"
"GTCCATCTCGGTTCCT-1"	"G"
"GTCCATCTCTCTATCA-1"	"G"
"GTCGTAAAGCCGCAAA-1"	"A"
"GTCGTAAAGTTTGGAA-1"	"G"
"GTCGTAACAAACGTTC-1"	"G"
"GTCGTAACAAGTCTGT-1"	"G"
"GTCGTAACAATTAGGA-1"	"G"
"GTCGTAAGTAGAGAGA-1"	"A"
"GTCGTAAGTTTGATCG-1"	"G"
"GTCGTAATCCCTAAAG-1"	"G"
"GTCGTAATCCGCTCTA-1"	"A"
"GTCGTAATCTGAACGT-1"	"G"
"GTCTACCAGTAGTTCC-1"	"G"
"GTCTACCAGTTGAATG-1"	"A"
"GTCTACCCACATTCTT-1"	"G"
"GTCTACCGTCAGGCTC-1"	"A"
"GTCTACCGTCCAAGAG-1"	"G"
"GTCTACCGTCGACTGC-1"	"G"
"GTCTACCGTGAGTTGG-1"	"A"
"GTCTACCGTGGCCTCA-1"	"A"
"GTCTACCGTTAACCAC-1"	"A"
"GTCTACCTCGCAAACT-1"	"A"
"GTCTACCTCGTTGTAG-1"	"G"
"GTCTACCTCTGTGTCC-1"	"A"
"GTGACATAGCACACCC-1"	"G"
"GTGACATAGGGAGATA-1"	"G"
"GTGACATAGTCGGGAT-1"	"A"
"GTGACATAGTTTGGAA-1"	"G"
"GTGACATCACGTTACA-1"	"A"
"GTGACATCACTCAAGT-1"	"G"
"GTGACATCAGTAAGCG-1"	"G"
"GTGACATCATCATGTG-1"	"A"
"GTGACATCATGGCCGT-1"	"G"
"GTGACATCATTCACGA-1"	"G"
"GTGACATGTCTGGATT-1"	"A"
"GTGACATGTTTCTACT-1"	"A"
"GTGACATTCAAGGCAG-1"	"G"
"GTGACATTCCTATCAT-1"	"G"
"GTGACATTCGCATACA-1"	"G"
"GTGACATTCTCTGAGA-1"	"G"
"GTGATCAAGATTAGAC-1"	"G"
"GTGATCAAGCGTTAGG-1"	"G"
"GTGATCAAGTCGGGAT-1"	"A"
"GTGATCACAAAGCTTC-1"	"A"
"GTGATCACAACCTCCT-1"	"A"
"GTGATCACAGAAAGAG-1"	"G"
"GTGATCACAGAGATGC-1"	"G"
"GTGATCACATACCCGG-1"	"A"
"GTGATCAGTCAACTAC-1"	"A"
"GTGATCAGTCCGGTAC-1"	"G"
"GTGATCAGTGACCAGA-1"	"G"
"GTGATCAGTGATCAGG-1"	"G"
"GTGATCAGTTCCCGGA-1"	"G"
"GTGATCATCCATACGA-1"	"G"
"GTGATCATCCGTTTCG-1"	"A"
"GTGATCATCCTGTGGG-1"	"A"
"GTGATCATCGAGCGCT-1"	"G"
"GTGATCATCTCGACAA-1"	"A"
"GTGATCATCTCTGTTA-1"	"G"
"GTGCACGAGACCCATT-1"	"G"
"GTGCACGAGGCGACTA-1"	"A"
"GTGCACGAGGGCTTCC-1"	"G"
"GTGCACGAGTTATGAG-1"	"A"
"GTGCACGAGTTCAGGG-1"	"G"
"GTGCACGCACCACCAG-1"	"A"
"GTGCACGCACCTCGTT-1"	"G"
"GTGCACGCACGCTGTG-1"	"G"
"GTGCACGGTAACCGAG-1"	"G"
"GTGCACGGTACGCCCA-1"	"A"
"GTGCACGGTACTATGC-1"	"A"
"GTGCACGGTACTTGAC-1"	"A"
"GTGCACGGTTGGAGGT-1"	"A"
"GTGCACGGTTGTGAGG-1"	"A"
"GTGCACGTCTCAGATG-1"	"A"
"GTGCCAGAGAGAGGTA-1"	"A"
"GTGCCAGAGCTTCAAC-1"	"G"
"GTGCCAGGTGTACGCC-1"	"A"
"GTGCCAGGTTACGCTA-1"	"A"
"GTGCCAGGTTAGGAAT-1"	"A"
"GTGCCAGGTTCCCTTG-1"	"A"
"GTGCCAGTCCGGACTG-1"	"A"
"GTGCTGGAGGAGTAGA-1"	"G"
"GTGCTGGAGGGCTCTC-1"	"A"
"GTGCTGGAGGTTAACA-1"	"A"
"GTGCTGGAGTGGACGT-1"	"A"
"GTGCTGGAGTTGCTTG-1"	"A"
"GTGCTGGGTAACATAG-1"	"A"
"GTGCTGGGTCATTGGT-1"	"G"
"GTGCTGGTCCACTAGA-1"	"G"
"GTGCTGGTCGTCCCTA-1"	"G"
"GTGCTGGTCTTGTCAT-1"	"A"
"GTGGATTAGATAGGTT-1"	"A"
"GTGGATTAGTCGCCTG-1"	"A"
"GTGGATTCACTGTAAC-1"	"G"
"GTGGATTCAGCTATAC-1"	"G"
"GTGGATTGTAAACGGC-1"	"G"
"GTGGATTGTCAGGTGA-1"	"G"
"GTGGATTGTCGATAGG-1"	"G"
"GTGGATTGTGCGCATC-1"	"A"
"GTGGATTGTGCGTTTA-1"	"G"
"GTGGATTGTGGGTAGT-1"	"A"
"GTGGATTGTGGTTCTA-1"	"G"
"GTGGATTTCATCGCAA-1"	"A"
"GTGGATTTCCAGCACG-1"	"G"
"GTGGATTTCCATGACA-1"	"A"
"GTGGATTTCGTGGTAT-1"	"G"
"GTGGATTTCTCTATTG-1"	"A"
"GTGGCGTAGCAGAGCT-1"	"G"
"GTGGCGTAGGTACACG-1"	"A"
"GTGGCGTAGTACAGTA-1"	"G"
"GTGGCGTCAAGCAACG-1"	"G"
"GTGGCGTCAATACTGC-1"	"A"
"GTGGCGTCAGACTAAA-1"	"A"
"GTGGCGTCAGCAACGA-1"	"G"
"GTGGCGTGTAAACGAT-1"	"A"
"GTGGCGTGTAATGTAG-1"	"G"
"GTGGCGTGTAGCGTTT-1"	"A"
"GTGGCGTGTCCCGAGT-1"	"A"
"GTGGCGTGTCGACTGC-1"	"G"
"GTGGCGTTCATCATGG-1"	"G"
"GTGGCGTTCCAAGTCA-1"	"A"
"GTGGCGTTCCTTTGAT-1"	"G"
"GTGGCGTTCGAACACT-1"	"G"
"GTGGCGTTCGCTACCT-1"	"A"
"GTGTCAAAGACTTCCA-1"	"A"
"GTGTCAAAGCGAGCTA-1"	"A"
"GTGTCAAAGTACGCGA-1"	"G"
"GTGTCAACAAGTAATG-1"	"G"
"GTGTCAACAAGTCTCA-1"	"A"
"GTGTCAACACTGAAGG-1"	"G"
"GTGTCAACAGAACTTC-1"	"A"
"GTGTCAACATAGATAG-1"	"A"
"GTGTCAAGTCGTAATC-1"	"A"
"GTGTCAAGTGGACAGT-1"	"G"
"GTGTCAATCGCTCGGA-1"	"G"
"GTGTCAATCTACTTTG-1"	"A"
"GTGTCCTAGAGTGGTC-1"	"A"
"GTGTCCTAGCACGTAG-1"	"G"
"GTGTCCTAGGTAGGCT-1"	"A"
"GTGTCCTAGTAGTCGG-1"	"A"
"GTGTCCTCAAGTAACA-1"	"A"
"GTGTCCTCACATAAAG-1"	"A"
"GTGTCCTCACTCGGAC-1"	"A"
"GTGTCCTCATTCTTTG-1"	"A"
"GTGTCCTCATTGCACA-1"	"A"
"GTGTCCTGTATTTGCG-1"	"A"
"GTGTCCTGTCATAAGA-1"	"A"
"GTGTCCTGTGACGCAA-1"	"G"
"GTGTCCTGTGAGTAAT-1"	"A"
"GTGTCCTTCTCCCTTT-1"	"A"
"GTGTGATAGAGCTGTG-1"	"A"
"GTGTGATAGGTGAACC-1"	"A"
"GTGTGATAGGTTGACG-1"	"A"
"GTGTGATCAAGATGCG-1"	"G"
"GTGTGATCACAACGGA-1"	"G"
"GTGTGATCACAAGGGT-1"	"A"
"GTGTGATCAGAGCCAA-1"	"A"
"GTGTGATCATAGCCGC-1"	"A"
"GTGTGATCATCATAGC-1"	"A"
"GTGTGATGTTCTTAGG-1"	"A"
"GTGTGATTCCCATAGA-1"	"A"
"GTGTGATTCGCTCGGA-1"	"G"
"GTGTGATTCGGAGTTT-1"	"A"
"GTGTGATTCTTGTACT-1"	"G"
"GTTACGAAGAACAGGA-1"	"A"
"GTTACGAAGACCAATA-1"	"G"
"GTTACGAAGACTTGAA-1"	"G"
"GTTACGAAGAGAGTTT-1"	"G"
"GTTACGAAGCTTTCCC-1"	"A"
"GTTACGAAGTCTTAGC-1"	"A"
"GTTACGACAACCTCCT-1"	"A"
"GTTACGACATTGCGAT-1"	"G"
"GTTACGAGTAGTCTGT-1"	"A"
"GTTACGAGTCACAGGA-1"	"G"
"GTTACGAGTCGACTGC-1"	"G"
"GTTACGAGTGCAAAGC-1"	"G"
"GTTACGATCACCCGGA-1"	"A"
"GTTACGATCCAGCACG-1"	"A"
"GTTACTTAGGGTCTGA-1"	"A"
"GTTACTTAGGTTTCTG-1"	"G"
"GTTACTTCAAGGACCA-1"	"A"
"GTTACTTCACCGTCTT-1"	"A"
"GTTACTTGTATCCTTT-1"	"G"
"GTTACTTGTGCATTCA-1"	"A"
"GTTACTTTCCTGGAAT-1"	"A"
"GTTATGGAGGAGTACC-1"	"A"
"GTTATGGAGGTTCGAG-1"	"G"
"GTTATGGAGTTCGACT-1"	"A"
"GTTATGGCACTCCACT-1"	"A"
"GTTATGGGTATTGTCG-1"	"A"
"GTTATTCAGCTGAATA-1"	"G"
"GTTATTCCATTGAACC-1"	"G"
"GTTATTCGTATGTCCA-1"	"A"
"GTTATTCGTCGATAGG-1"	"G"
"GTTATTCGTCTGAGCC-1"	"G"
"GTTATTCGTTTGAAGA-1"	"A"
"GTTATTCTCACAGGGA-1"	"A"
"GTTATTCTCTAAACGC-1"	"G"
"GTTCAAGAGCGGACAT-1"	"A"
"GTTCAAGAGGATCCTT-1"	"A"
"GTTCAAGAGTGCTCGC-1"	"G"
"GTTCAAGCACAGTAGG-1"	"A"
"GTTCAAGCACCAAGGA-1"	"G"
"GTTCAAGCACCCTTAC-1"	"A"
"GTTCAAGGTCCGGTAC-1"	"A"
"GTTCAAGGTGAAACAT-1"	"A"
"GTTCAAGGTGATTCCA-1"	"G"
"GTTCAAGTCAATTGGC-1"	"G"
"GTTCAAGTCAGGGTTT-1"	"G"
"GTTCAAGTCCGTACGG-1"	"A"
"GTTCAAGTCGCAGATT-1"	"A"
"GTTCAAGTCTGATCCC-1"	"A"
"GTTGGGCAGAGCACTG-1"	"A"
"GTTGGGCAGGGAGTTC-1"	"A"
"GTTGGGCAGTCATACC-1"	"A"
"GTTGGGCAGTTTGGAA-1"	"A"
"GTTGGGCCAGCAAACG-1"	"G"
"GTTGGGCCAGTATACC-1"	"A"
"GTTGGGCCATGATTGC-1"	"A"
"GTTGGGCCATGCCTTC-1"	"A"
"GTTGGGCGTAACTGAA-1"	"G"
"GTTGGGCGTCGATTAC-1"	"A"
"GTTGGGCGTGTCCCAG-1"	"A"
"GTTGGGCGTTAAGGGC-1"	"A"
"GTTGGGCGTTGGACGA-1"	"A"
"GTTGGGCTCCCGTAGG-1"	"G"
"GTTGGGCTCGTTACAG-1"	"A"
"GTTGGGCTCTGATCTT-1"	"A"
"GTTGGGCTCTTCTCTC-1"	"A"
"GTTGGTAAGACACGGT-1"	"G"
"GTTGGTAAGATATGAC-1"	"G"
"GTTGGTAAGCGATACG-1"	"A"
"GTTGGTAAGGCGTAGT-1"	"A"
"GTTGGTAAGGTTTCTG-1"	"G"
"GTTGGTAAGTACGCGA-1"	"G"
"GTTGGTACACGATATC-1"	"A"
"GTTGGTACAGTGCTCG-1"	"A"
"GTTGGTACATCGTACA-1"	"G"
"GTTGGTACATTACACG-1"	"G"
"GTTGGTACATTACTTC-1"	"A"
"GTTGGTAGTCGCTAGC-1"	"A"
"GTTGGTAGTGATGCGA-1"	"A"
"GTTGGTATCATACTTC-1"	"G"
"GTTGGTATCCAAGAGG-1"	"A"
"GTTGGTATCCCATAGA-1"	"A"
"GTTGGTATCCTCCTGA-1"	"A"
"TAAACCGAGACAGTGC-1"	"A"
"TAAACCGAGCTTCAAC-1"	"A"
"TAAACCGAGTGAGCTG-1"	"G"
"TAAACCGAGTTACACC-1"	"A"
"TAAACCGCAACGTCGC-1"	"A"
"TAAACCGCAAGATGCG-1"	"A"
"TAAACCGCACAAACGG-1"	"G"
"TAAACCGCATCCATAG-1"	"G"
"TAAACCGGTACTTCAG-1"	"G"
"TAAACCGGTATACGCT-1"	"A"
"TAAACCGGTATGTCCA-1"	"A"
"TAAACCGGTCAATCCA-1"	"G"
"TAAACCGGTCACTCTC-1"	"A"
"TAAACCGGTCGATAGG-1"	"A"
"TAAACCGGTGCAAGAC-1"	"A"
"TAAACCGGTTACACTG-1"	"A"
"TAAACCGTCCCAGCGA-1"	"G"
"TAAACCGTCCGGCTGA-1"	"G"
"TAAACCGTCGATTACG-1"	"A"
"TAAACCGTCTTTCGAT-1"	"G"
"TAACAGCAGAGCCACA-1"	"A"
"TAACAGCAGGCAAGGG-1"	"A"
"TAACAGCCAAACGTTC-1"	"A"
"TAACAGCCACCTCGTT-1"	"A"
"TAACAGCCAGTTGGAG-1"	"G"
"TAACAGCCATCCGTAA-1"	"A"
"TAACAGCCATGGAGGT-1"	"G"
"TAACAGCGTAACATAG-1"	"A"
"TAACAGCGTCCGGTAC-1"	"G"
"TAACAGCGTCGTAATC-1"	"G"
"TAACAGCGTGCTGAAG-1"	"G"
"TAACAGCGTTGCTTGA-1"	"A"
"TAACGGTAGCAACGGT-1"	"A"
"TAACGGTAGGGCATTG-1"	"A"
"TAACGGTAGGTTGTTC-1"	"G"
"TAACGGTAGTCTGTGT-1"	"A"
"TAACGGTCAGCTTACA-1"	"A"
"TAACGGTCATAGATAG-1"	"A"
"TAACGGTCATTGCCTC-1"	"G"
"TAACGGTGTCTGGTTA-1"	"A"
"TAACGGTGTGATCAGG-1"	"A"
"TAACGGTGTGATGCTT-1"	"A"
"TAACGGTTCCAACCTC-1"	"G"
"TAACGGTTCCAGGTAT-1"	"G"
"TAACGGTTCGTGCTTC-1"	"A"
"TAACGGTTCTAGTCGA-1"	"A"
"TAACGGTTCTGTGTCC-1"	"A"
"TAACTTCAGATACCAA-1"	"G"
"TAACTTCCAACGAGGT-1"	"A"
"TAACTTCCAACTACTG-1"	"A"
"TAACTTCCAATACTGC-1"	"A"
"TAACTTCCACATTCTT-1"	"G"
"TAACTTCCACGTGAAG-1"	"A"
"TAACTTCGTAATGCCT-1"	"A"
"TAACTTCGTGGAAAGA-1"	"A"
"TAACTTCGTTTAAGGA-1"	"A"
"TAACTTCGTTTCCGGG-1"	"A"
"TAACTTCTCAAATGGA-1"	"G"
"TAACTTCTCAATTGGC-1"	"G"
"TAACTTCTCCTATCCG-1"	"G"
"TAACTTCTCGTATAGC-1"	"A"
"TAACTTCTCTTACTCA-1"	"G"
"TAAGCCAAGATATGAC-1"	"A"
"TAAGCCAAGCAGAAAG-1"	"A"
"TAAGCCAAGGTAAGTT-1"	"A"
"TAAGCCAAGGTAGGAA-1"	"A"
"TAAGCCAAGTCATACC-1"	"G"
"TAAGCCAAGTTCGACT-1"	"G"
"TAAGCCACAAGAAACT-1"	"A"
"TAAGCCACAAGCCTTA-1"	"A"
"TAAGCCACAAGTGGCA-1"	"G"
"TAAGCCACAGATTTGC-1"	"A"
"TAAGCCACATTAAGGA-1"	"G"
"TAAGCCAGTACTTCAG-1"	"G"
"TAAGCCAGTAGAATAC-1"	"G"
"TAAGCCAGTTTGACCA-1"	"A"
"TAAGTGCAGATGCGAC-1"	"A"
"TAAGTGCAGCCATGGA-1"	"G"
"TAAGTGCAGGAGTACC-1"	"G"
"TAAGTGCAGGCTCAGA-1"	"A"
"TAAGTGCAGTCTTAGC-1"	"A"
"TAAGTGCCAACTACTG-1"	"G"
"TAAGTGCCAATTAGGA-1"	"A"
"TAAGTGCCACATATCG-1"	"A"
"TAAGTGCCATCGTGAT-1"	"A"
"TAAGTGCCATGGTATC-1"	"A"
"TAAGTGCGTCTCGGGT-1"	"G"
"TAAGTGCGTGCCCGAT-1"	"G"
"TAAGTGCGTGTGACCC-1"	"A"
"TAAGTGCGTGTGTGTT-1"	"A"
"TAAGTGCGTTAGGAAT-1"	"A"
"TAAGTGCTCCCACTTG-1"	"A"
"TAAGTGCTCCGCGATG-1"	"G"
"TAAGTGCTCGGTTCCT-1"	"G"
"TAAGTGCTCGTTTGAG-1"	"A"
"TAAGTGCTCTCAGATG-1"	"A"
"TAAGTGCTCTCCCTTT-1"	"A"
"TAATCGGAGGTCCTCG-1"	"A"
"TAATCGGAGTGCACAG-1"	"A"
"TAATCGGCAGTATACC-1"	"A"
"TAATCGGCATTGCACA-1"	"G"
"TAATCGGGTAACACTC-1"	"G"
"TAATCGGGTCCGTAGC-1"	"A"
"TAATCGGGTGATTCCA-1"	"A"
"TAATCGGGTTAAGGGC-1"	"A"
"TAATCGGGTTCCAATG-1"	"G"
"TAATCGGGTTCCTATT-1"	"G"
"TAATCGGGTTGTGACT-1"	"G"
"TAATCGGTCACTAGGT-1"	"A"
"TAATCGGTCCAAACCA-1"	"G"
"TAATTCCAGAGCTGTG-1"	"A"
"TAATTCCAGTCCCTCT-1"	"A"
"TAATTCCAGTCGTGAG-1"	"A"
"TAATTCCAGTCTGTGT-1"	"G"
"TAATTCCCAAGGTTCT-1"	"A"
"TAATTCCCACAGATGG-1"	"G"
"TAATTCCCATAGCCAT-1"	"A"
"TAATTCCGTATCCTTT-1"	"G"
"TAATTCCGTCAGTGTT-1"	"A"
"TAATTCCGTCGCTAGC-1"	"A"
"TAATTCCTCCTCTCTT-1"	"G"
"TAATTCCTCCTTTGCG-1"	"A"
"TAATTCCTCGCTATAG-1"	"A"
"TAATTCCTCTGGAAGG-1"	"G"
"TACAGCAAGAGCACTG-1"	"A"
"TACAGCAAGAGGCCTA-1"	"G"
"TACAGCAAGCAGGAGG-1"	"G"
"TACAGCAAGGCACCTC-1"	"A"
"TACAGCACAAGTCTGT-1"	"A"
"TACAGCACACCCTTTG-1"	"G"
"TACAGCACAGAATGCG-1"	"A"
"TACAGCAGTAAACGTA-1"	"G"
"TACAGCAGTACGAGAC-1"	"G"
"TACAGCAGTGAATCAA-1"	"A"
"TACAGCATCAACTTGG-1"	"A"
"TACAGCATCAATCGTG-1"	"A"
"TACAGCATCATGAACC-1"	"A"
"TACAGCATCGAGTGTT-1"	"G"
"TACATGGAGAAGAGTG-1"	"G"
"TACATGGAGCATGATA-1"	"A"
"TACATGGAGGCTTTAC-1"	"G"
"TACATGGAGGGTGTTG-1"	"A"
"TACATGGAGGTTTCTG-1"	"G"
"TACATGGAGTGAACCG-1"	"A"
"TACATGGCAAGCAATA-1"	"G"
"TACATGGCAGTTCGGC-1"	"A"
"TACATGGGTAAACGAT-1"	"G"
"TACATGGGTCCATTGA-1"	"A"
"TACATGGGTCCGTCGA-1"	"A"
"TACATGGGTGGACGAT-1"	"A"
"TACATGGTCGATGTAC-1"	"G"
"TACATGGTCGGGCTCA-1"	"A"
"TACATTCAGATTACGA-1"	"A"
"TACATTCAGTTGCTTG-1"	"G"
"TACATTCCAACTCCCT-1"	"G"
"TACATTCCAATGAAAC-1"	"G"
"TACATTCCACCACGAC-1"	"G"
"TACATTCCAGTTCGGC-1"	"A"
"TACATTCGTTGGAGGT-1"	"A"
"TACATTCTCACGATTG-1"	"A"
"TACATTCTCCAACCTC-1"	"A"
"TACATTCTCCATAACG-1"	"A"
"TACATTCTCTTCCGTG-1"	"G"
"TACCCTGAGAGGAACA-1"	"G"
"TACCCTGAGAGGCAGG-1"	"G"
"TACCCTGAGATTAGAC-1"	"A"
"TACCCTGAGTCCCGCA-1"	"A"
"TACCCTGAGTGAGCAC-1"	"A"
"TACCCTGCAAGAGATT-1"	"G"
"TACCCTGCAAGCGTCC-1"	"A"
"TACCCTGCACCTCGTT-1"	"A"
"TACCCTGCAGTAGTTC-1"	"G"
"TACCCTGCATTTGGTG-1"	"A"
"TACCCTGGTATACGCT-1"	"G"
"TACCCTGGTATTTGCG-1"	"A"
"TACCCTGGTCTCTAAG-1"	"A"
"TACCCTGGTCTGTCCT-1"	"A"
"TACCCTGGTGATGCGA-1"	"A"
"TACCCTGGTGGAGTGT-1"	"A"
"TACCCTGGTTCAGTTG-1"	"A"
"TACCTATAGAAAGGGT-1"	"G"
"TACCTATAGACACTTC-1"	"G"
"TACCTATAGTAGGTCG-1"	"G"
"TACCTATAGTCGTATC-1"	"G"
"TACCTATCAATTGCCA-1"	"A"
"TACCTATCATTTCTTG-1"	"G"
"TACCTATGTAGGGTCA-1"	"A"
"TACCTATGTCCCGAGT-1"	"A"
"TACCTATTCCACACCT-1"	"A"
"TACCTATTCCGAGGAA-1"	"A"
"TACCTATTCGGCTATA-1"	"G"
"TACCTCGAGCCCATGC-1"	"A"
"TACCTCGAGGCGATTG-1"	"A"
"TACCTCGAGTTAGCAA-1"	"G"
"TACCTCGCAAGAGCGT-1"	"A"
"TACCTCGCAATTCAGC-1"	"A"
"TACCTCGCAATTGTGC-1"	"G"
"TACCTCGCAGAGATGC-1"	"G"
"TACCTCGGTCCGTAGC-1"	"G"
"TACCTCGGTGGACGAT-1"	"G"
"TACCTCGTCAGTCTTT-1"	"A"
"TACGCAAAGCGTCTGC-1"	"A"
"TACGCAACATGCGACC-1"	"A"
"TACGCAACATTTCTTG-1"	"G"
"TACGCAAGTATTCGCA-1"	"G"
"TACGCAAGTGCACCCA-1"	"A"
"TACGCAAGTGCCGGTT-1"	"G"
"TACGCAAGTTCCAGTA-1"	"G"
"TACGCAAGTTCTCGAA-1"	"A"
"TACGCAAGTTGCAGCC-1"	"A"
"TACGCAATCAAGGCAG-1"	"G"
"TACGCAATCAGGCCGT-1"	"G"
"TACGCAATCCATCGAA-1"	"A"
"TACGCAATCGCTAGTA-1"	"G"
"TACGCAATCGGTCTAA-1"	"G"
"TACGCAATCGTTGTAG-1"	"A"
"TACGCAATCTCTATTG-1"	"G"
"TACGCAATCTCTGAGA-1"	"G"
"TACGCCTAGACTAATG-1"	"A"
"TACGCCTAGAGCGAAA-1"	"A"
"TACGCCTAGCTGAGGT-1"	"G"
"TACGCCTAGGCTTCGC-1"	"A"
"TACGCCTAGTCGCCTG-1"	"A"
"TACGCCTCAATGGTCT-1"	"A"
"TACGCCTCACAGTTAC-1"	"G"
"TACGCCTCACCTCGTT-1"	"A"
"TACGCCTGTGTGTGCC-1"	"G"
"TACGCCTGTTCCGCGA-1"	"A"
"TACGCCTTCCAATAGC-1"	"A"
"TACGCCTTCCATAGGT-1"	"A"
"TACGCCTTCGGGTCCA-1"	"A"
"TACGGATAGAATCAAC-1"	"G"
"TACGGATAGACCGCAA-1"	"G"
"TACGGATAGCGCAATG-1"	"G"
"TACGGATAGTCACGCC-1"	"A"
"TACGGATAGTTAGCAA-1"	"G"
"TACGGATCATTATGGC-1"	"G"
"TACGGATGTATCGCGC-1"	"G"
"TACGGATGTATCTAGC-1"	"A"
"TACGGATGTCCTCAGG-1"	"A"
"TACGGATGTGTGAGGT-1"	"G"
"TACGGATGTTCTGATG-1"	"A"
"TACGGATTCGACTTAG-1"	"G"
"TACGGATTCGAGTGTT-1"	"A"
"TACGGATTCGCCACTT-1"	"G"
"TACGGATTCTGATCTT-1"	"A"
"TACTAGGAGATATGAC-1"	"A"
"TACTAGGAGGATCCTT-1"	"A"
"TACTAGGAGGCAAGCT-1"	"G"
"TACTAGGAGGGTCCCT-1"	"G"
"TACTAGGAGGTGAACC-1"	"G"
"TACTAGGAGTAGTTCC-1"	"A"
"TACTAGGCACGCGCAT-1"	"G"
"TACTAGGGTCCTTCAC-1"	"A"
"TACTAGGGTGATGTGG-1"	"A"
"TACTAGGTCGCTATAG-1"	"A"
"TACTAGGTCGGATAGG-1"	"A"
"TACTAGGTCGGTTGTA-1"	"G"
"TACTAGGTCTATATCC-1"	"A"
"TACTAGGTCTCATATC-1"	"A"
"TACTAGGTCTCTGAGA-1"	"A"
"TACTCGCAGAACGCCA-1"	"G"
"TACTCGCAGGTTACAA-1"	"G"
"TACTCGCAGTGAATAC-1"	"A"
"TACTCGCCAAACCTAC-1"	"A"
"TACTCGCCATCAACTG-1"	"G"
"TACTCGCGTAGCAGGT-1"	"A"
"TACTCGCGTCTGGTCG-1"	"A"
"TACTCGCGTGATAGAT-1"	"G"
"TACTCGCGTGTCCAGC-1"	"G"
"TACTCGCGTGTGACCC-1"	"A"
"TACTCGCTCATTCGGA-1"	"A"
"TACTCGCTCTCTATTG-1"	"A"
"TACTCGCTCTCTGCGT-1"	"A"
"TACTGCCAGCTGAGGT-1"	"G"
"TACTGCCAGGAGTCTG-1"	"A"
"TACTGCCAGGATATCA-1"	"A"
"TACTGCCAGGGAAATG-1"	"A"
"TACTGCCCAAAGAAGG-1"	"A"
"TACTGCCCAATGTGCT-1"	"G"
"TACTGCCCACCACCAG-1"	"G"
"TACTGCCCAGCAACCC-1"	"G"
"TACTGCCCATCCCGGA-1"	"G"
"TACTGCCCATCGACCG-1"	"G"
"TACTGCCGTAGTCTGT-1"	"A"
"TACTGCCGTGCGCTCA-1"	"G"
"TACTGCCTCGCACCTT-1"	"G"
"TACTGCCTCGCATAAC-1"	"G"
"TACTGCCTCGGTTGTA-1"	"G"
"TAGACTGAGCCCATGC-1"	"A"
"TAGACTGAGGGTCTGA-1"	"A"
"TAGACTGAGTAGGTCG-1"	"A"
"TAGACTGCACTCGCAG-1"	"A"
"TAGACTGCACTCGTGG-1"	"A"
"TAGACTGGTAAACGAT-1"	"A"
"TAGACTGGTAGTAACA-1"	"A"
"TAGACTGGTCCTTCAC-1"	"A"
"TAGACTGGTCTAACCA-1"	"A"
"TAGACTGGTGACAAGC-1"	"G"
"TAGACTGGTGCAAAGC-1"	"A"
"TAGACTGTCAACTTGG-1"	"A"
"TAGACTGTCCTTTGAT-1"	"G"
"TAGACTGTCGTGTGCG-1"	"A"
"TAGCACAAGTACCTCA-1"	"G"
"TAGCACACATAAAGTG-1"	"A"
"TAGCACACATTATGGC-1"	"A"
"TAGCACAGTATGGTTC-1"	"A"
"TAGCACAGTTCTCGAA-1"	"A"
"TAGCACATCCATCTAT-1"	"G"
"TAGCACATCCATGACA-1"	"A"
"TAGCACATCCCACGGA-1"	"A"
"TAGCACATCGTCAACA-1"	"A"
"TAGCACATCTAGCAAC-1"	"G"
"TAGCATGAGATTCCGT-1"	"G"
"TAGCATGAGGAATGGA-1"	"G"
"TAGCATGAGTGCAACG-1"	"A"
"TAGCATGCACAGGTAG-1"	"A"
"TAGCATGCATCACAGT-1"	"A"
"TAGCATGGTAGTAACA-1"	"A"
"TAGCATGGTCCACCAG-1"	"G"
"TAGCATGGTGAGCTAG-1"	"A"
"TAGCATGGTGTCTACA-1"	"A"
"TAGCATGTCAAAGTAG-1"	"G"
"TAGCATGTCCAACGCG-1"	"G"
"TAGCATGTCCAATAGC-1"	"G"
"TAGCCCTAGAAATGGG-1"	"G"
"TAGCCCTGTACGGTTT-1"	"G"
"TAGCCCTGTATCAGCT-1"	"A"
"TAGCCCTGTATCTAGC-1"	"G"
"TAGCCCTGTCTGGGCT-1"	"G"
"TAGCCCTGTGAGGGTT-1"	"A"
"TAGCCCTGTTTCCGGG-1"	"A"
"TAGCCCTTCCAATAGC-1"	"A"
"TAGCCCTTCCAGTTAG-1"	"A"
"TAGCCCTTCGAGAACG-1"	"A"
"TAGCCCTTCGGATAAA-1"	"A"
"TAGCCCTTCTCATATC-1"	"A"
"TAGCCGGAGCCCATGC-1"	"G"
"TAGCCGGAGCGTCTGC-1"	"A"
"TAGCCGGAGGTGTTGG-1"	"A"
"TAGCCGGAGGTTTCTG-1"	"G"
"TAGCCGGAGTACGACG-1"	"A"
"TAGCCGGGTAACCCAT-1"	"G"
"TAGCCGGGTCAAACAA-1"	"A"
"TAGCCGGTCCACGCTT-1"	"G"
"TAGCCGGTCGCCAGAC-1"	"A"
"TAGCCGGTCTAGTCGA-1"	"A"
"TAGCCGGTCTCTTAAC-1"	"G"
"TAGCGGCAGACGCCCT-1"	"A"
"TAGCGGCAGGAGAACA-1"	"A"
"TAGCGGCCAATGAAAC-1"	"G"
"TAGCGGCCAGTCCTGG-1"	"A"
"TAGCGGCGTGATAACA-1"	"A"
"TAGCGGCGTGCTGTCG-1"	"A"
"TAGCGGCTCAGGAATA-1"	"G"
"TAGCGGCTCAGTGTAC-1"	"A"
"TAGCGGCTCCAACCTC-1"	"A"
"TAGCGGCTCGATGTAC-1"	"A"
"TAGCGGCTCGCGGCAT-1"	"A"
"TAGCTTTAGCAACTGG-1"	"A"
"TAGCTTTAGGTACTCT-1"	"A"
"TAGCTTTAGTCTTAGC-1"	"G"
"TAGCTTTAGTGGACGT-1"	"A"
"TAGCTTTCAGAGCCAA-1"	"G"
"TAGCTTTCAGTATACC-1"	"G"
"TAGCTTTCAGTGGTCC-1"	"G"
"TAGCTTTCATGACTGT-1"	"A"
"TAGCTTTCATTACTCT-1"	"A"
"TAGCTTTGTCAATACC-1"	"A"
"TAGCTTTGTGTGCTTA-1"	"A"
"TAGCTTTTCATTGCCC-1"	"G"
"TAGCTTTTCGACTGGC-1"	"A"
"TAGCTTTTCGCACAAT-1"	"G"
"TAGCTTTTCGGGAATG-1"	"G"
"TAGCTTTTCGTTGTAG-1"	"G"
"TAGGAGGAGAACGTCG-1"	"A"
"TAGGAGGAGCTACGCC-1"	"G"
"TAGGAGGAGGCTCCTG-1"	"A"
"TAGGAGGAGTGGTGTG-1"	"A"
"TAGGAGGCAACACGGA-1"	"G"
"TAGGAGGCACGACGAA-1"	"A"
"TAGGAGGCAGTAACTC-1"	"G"
"TAGGAGGCATTCTCGC-1"	"A"
"TAGGAGGGTGGTGGTA-1"	"A"
"TAGGAGGGTTCCCAAA-1"	"A"
"TAGGAGGGTTCTACCC-1"	"A"
"TAGGAGGGTTCTTTGT-1"	"G"
"TAGGAGGGTTTCAGCA-1"	"A"
"TAGGAGGTCGCTTCAC-1"	"A"
"TAGGAGGTCTCGACAA-1"	"G"
"TAGGTCACACAGATGG-1"	"A"
"TAGGTCACACCCTTTG-1"	"A"
"TAGGTCACACGTTGTA-1"	"G"
"TAGGTCACAGATACAA-1"	"A"
"TAGGTCACATTGCACA-1"	"A"
"TAGGTCAGTAGAAGCC-1"	"A"
"TAGGTCAGTATCAGCT-1"	"A"
"TAGGTCAGTATTCACG-1"	"A"
"TAGGTCAGTCATAGCT-1"	"G"
"TAGGTCAGTGAAACAT-1"	"G"
"TAGGTCAGTGACAAGC-1"	"A"
"TAGGTCAGTGTGCTTA-1"	"A"
"TAGGTGTCAAGACTAA-1"	"G"
"TAGGTGTCATCACAAC-1"	"G"
"TAGGTGTGTAACGGAC-1"	"A"
"TAGGTGTGTCGACTGC-1"	"A"
"TAGGTGTGTTCAGTTG-1"	"G"
"TAGGTGTTCCCGGGTA-1"	"G"
"TAGGTGTTCGGTTGTA-1"	"A"
"TAGTCCCAGACCTATC-1"	"G"
"TAGTCCCAGAGCCTGA-1"	"G"
"TAGTCCCAGGACCGAT-1"	"A"
"TAGTCCCAGGGCATTG-1"	"A"
"TAGTCCCCAATTCGTG-1"	"G"
"TAGTCCCCACACACAT-1"	"G"
"TAGTCCCCATACCCGG-1"	"G"
"TAGTCCCCATCCTCGT-1"	"A"
"TAGTCCCCATCTGCAA-1"	"G"
"TAGTCCCGTGTAGGAC-1"	"G"
"TAGTCCCTCCATGACA-1"	"G"
"TAGTCCCTCCATTGAG-1"	"A"
"TAGTCCCTCGCACAAT-1"	"G"
"TATCGAGAGACTAATG-1"	"A"
"TATCGAGAGACTAGCG-1"	"A"
"TATCGAGAGCTAACAA-1"	"A"
"TATCGAGAGCTGCCAC-1"	"G"
"TATCGAGAGGTCCTCG-1"	"G"
"TATCGAGCAAACCCTA-1"	"A"
"TATCGAGCAATGCACT-1"	"A"
"TATCGAGCAATGCCAT-1"	"G"
"TATCGAGCACAAGTGG-1"	"A"
"TATCGAGCACTAAACC-1"	"A"
"TATCGAGCAGACTAAA-1"	"G"
"TATCGAGCAGATTAAG-1"	"A"
"TATCGAGCAGCAATGG-1"	"G"
"TATCGAGCAGGCAAGT-1"	"G"
"TATCGAGGTATGGGTG-1"	"G"
"TATCGAGGTCTGTGTA-1"	"A"
"TATCGAGGTTCAGAAA-1"	"G"
"TATCGAGGTTTGAAGA-1"	"A"
"TATCGAGTCCGTTAGA-1"	"A"
"TATCGAGTCGTCTAGA-1"	"A"
"TATCTGTAGAACCATA-1"	"A"
"TATCTGTAGAGCAGCT-1"	"A"
"TATCTGTAGCATGATA-1"	"G"
"TATCTGTAGCCATTCA-1"	"A"
"TATCTGTAGCGAATAT-1"	"A"
"TATCTGTAGGGCGAAG-1"	"A"
"TATCTGTCATGGCCGT-1"	"G"
"TATCTGTGTAGTACAA-1"	"G"
"TATCTGTGTGGCCTTG-1"	"G"
"TATCTGTTCAATGCAC-1"	"A"
"TATCTGTTCCCGAAGC-1"	"G"
"TATCTGTTCGTAGCGC-1"	"A"
"TATCTGTTCTTAGTGG-1"	"A"
"TATGTGGAGGGAAGCG-1"	"A"
"TATGTGGAGGGCTCTC-1"	"A"
"TATGTGGCAAGAGCGT-1"	"A"
"TATGTGGCAGCAAACG-1"	"A"
"TATGTGGCAGCAACAG-1"	"A"
"TATGTGGGTCACTCTC-1"	"A"
"TATGTGGGTGAGCTAG-1"	"A"
"TATGTGGTCCCTAAAG-1"	"G"
"TATGTGGTCGACTTAG-1"	"A"
"TATGTTCAGACCAATA-1"	"A"
"TATGTTCAGGAGTACC-1"	"A"
"TATGTTCAGGTACATA-1"	"A"
"TATGTTCCAACTCGTA-1"	"A"
"TATGTTCCAGATTAAG-1"	"A"
"TATGTTCCATTTCTTG-1"	"A"
"TATGTTCGTACAAATG-1"	"A"
"TATGTTCGTCAGAAGC-1"	"G"
"TATGTTCGTCGCTAGC-1"	"G"
"TATGTTCTCCACGGCA-1"	"G"
"TATGTTCTCGGTTCCT-1"	"G"
"TATTGCTAGAAATCTG-1"	"G"
"TATTGCTAGACCATAA-1"	"A"
"TATTGCTAGCTATCCA-1"	"A"
"TATTGCTAGGGTTCTT-1"	"G"
"TATTGCTCAACTACTG-1"	"A"
"TATTGCTCAGTTCGGC-1"	"A"
"TATTGCTCATTAAGGA-1"	"A"
"TATTGCTGTAACCATC-1"	"A"
"TATTGCTGTGAATACA-1"	"G"
"TATTGCTGTGGACGAT-1"	"A"
"TATTGCTGTTTCCACC-1"	"G"
"TATTGCTTCCTCCATG-1"	"A"
"TCAAAGCAGAAAGGGT-1"	"A"
"TCAAAGCAGCCATGGA-1"	"A"
"TCAAAGCAGCTGATTC-1"	"G"
"TCAAAGCAGGATCCTT-1"	"A"
"TCAAAGCAGGTTGTGG-1"	"G"
"TCAAAGCAGTTCCAGT-1"	"G"
"TCAAAGCCAAGTCTCA-1"	"G"
"TCAAAGCCAGTCCTGG-1"	"A"
"TCAAAGCCATCCATAG-1"	"G"
"TCAAAGCGTGAATGGC-1"	"G"
"TCAAAGCTCGATAGGG-1"	"G"
"TCAAGACAGACGAAAG-1"	"G"
"TCAAGACAGGCACTAG-1"	"A"
"TCAAGACAGGTGTTGG-1"	"A"
"TCAAGACAGTTAGCGG-1"	"A"
"TCAAGACCAAGCACTT-1"	"G"
"TCAAGACCACGAACGA-1"	"A"
"TCAAGACGTAAGTCTC-1"	"A"
"TCAAGACGTCCAAGTT-1"	"A"
"TCAAGACGTTTGTGAC-1"	"G"
"TCAAGACTCCGGCTGA-1"	"A"
"TCAAGACTCGGATGTT-1"	"G"
"TCAAGACTCGGCAATT-1"	"A"
"TCAAGACTCGTATAGC-1"	"G"
"TCAAGACTCTCCTTAA-1"	"G"
"TCAAGCAAGGCTAAAT-1"	"A"
"TCAAGCAAGTGCTGAG-1"	"G"
"TCAAGCAAGTTGACAA-1"	"A"
"TCAAGCACAACAACTC-1"	"G"
"TCAAGCACAACGACAG-1"	"A"
"TCAAGCACAGTTGGAG-1"	"G"
"TCAAGCAGTAGGTGAC-1"	"G"
"TCAAGCAGTATCTCAG-1"	"A"
"TCAAGCAGTCCTTATT-1"	"G"
"TCAAGCAGTCTGTTGA-1"	"G"
"TCAAGCAGTGGACGAT-1"	"A"
"TCAAGCAGTGTCGTCG-1"	"G"
"TCAAGCAGTTCCATCC-1"	"A"
"TCAAGCAGTTTCTCTA-1"	"G"
"TCAAGCAGTTTGTACG-1"	"G"
"TCAAGCATCGATAGGG-1"	"A"
"TCAAGCATCGCCAGAC-1"	"A"
"TCAAGGTAGAACGTCG-1"	"A"
"TCAAGGTAGATTCCGT-1"	"A"
"TCAAGGTAGCAACTGG-1"	"A"
"TCAAGGTAGCCTATAC-1"	"A"
"TCAAGGTAGGCTAAAT-1"	"A"
"TCAAGGTCAAAGCTTC-1"	"G"
"TCAAGGTCAAGCCCTG-1"	"A"
"TCAAGGTCAATGTGCT-1"	"A"
"TCAAGGTCACTCAGCG-1"	"G"
"TCAAGGTGTATGGATA-1"	"G"
"TCAAGGTGTCACAGGA-1"	"G"
"TCAAGGTGTCAGTGTT-1"	"A"
"TCAAGGTGTTCTTAGG-1"	"G"
"TCAAGGTTCAAACCAC-1"	"A"
"TCAAGGTTCCTAAGTG-1"	"A"
"TCAAGGTTCCTAGAGT-1"	"A"
"TCAAGGTTCCTGTAGA-1"	"G"
"TCAAGGTTCGCACAAT-1"	"A"
"TCAAGGTTCGCAGATT-1"	"A"
"TCAAGGTTCGTAGCGC-1"	"G"
"TCAATTCAGACGCCCT-1"	"G"
"TCAATTCAGCTCGTTA-1"	"A"
"TCAATTCAGTAACACA-1"	"G"
"TCAATTCCAGGATAGC-1"	"A"
"TCAATTCGTACGTATC-1"	"A"
"TCAATTCGTACTTGAC-1"	"A"
"TCAATTCGTAGTACAA-1"	"G"
"TCAATTCGTGCCCAGT-1"	"G"
"TCAATTCTCAATTGGC-1"	"G"
"TCAATTCTCCTCATTA-1"	"A"
"TCAATTCTCGGTCTAA-1"	"A"
"TCACAAGAGGCAATTA-1"	"A"
"TCACAAGAGGGTGTTG-1"	"A"
"TCACAAGCACAGCTTA-1"	"A"
"TCACAAGCATACTGCA-1"	"A"
"TCACAAGGTAGCGGTA-1"	"G"
"TCACAAGGTCACAGGA-1"	"A"
"TCACAAGGTCCCGTGA-1"	"G"
"TCACAAGGTGCTTCCT-1"	"A"
"TCACAAGTCACAACAC-1"	"A"
"TCACAAGTCGAGTTAC-1"	"G"
"TCACAAGTCGGTCTCT-1"	"G"
"TCACAGAAGACCAATA-1"	"G"
"TCACAGAAGACGAAAG-1"	"A"
"TCACAGAAGAGAGTAG-1"	"G"
"TCACAGAAGCGAGAAA-1"	"G"
"TCACAGAAGCTTTCCC-1"	"A"
"TCACAGAAGTAGCAAT-1"	"G"
"TCACAGACAAAGAGAG-1"	"A"
"TCACAGACAGTCCTGG-1"	"G"
"TCACAGACATGTGGGA-1"	"A"
"TCACAGAGTTCCAGTA-1"	"A"
"TCACAGAGTTCCCAAA-1"	"G"
"TCACAGAGTTCTGATG-1"	"G"
"TCACAGATCCTCCTGA-1"	"A"
"TCACAGATCGGTTCCT-1"	"A"
"TCACAGATCTGTTGCC-1"	"A"
"TCACCACCACGATATC-1"	"G"
"TCACCACCATGGTATC-1"	"G"
"TCACCACGTACCGGCT-1"	"A"
"TCACCACGTAGAATAC-1"	"G"
"TCACCACGTCGCTAGC-1"	"A"
"TCACCACTCGATTACG-1"	"A"
"TCACCACTCGCTTGAA-1"	"A"
"TCACCACTCGGCAATT-1"	"A"
"TCACCACTCTCAGATG-1"	"G"
"TCACCTGAGGCAGTGT-1"	"A"
"TCACCTGAGTGCACAG-1"	"A"
"TCACCTGCAAGGACCA-1"	"A"
"TCACCTGCACTGATAC-1"	"G"
"TCACCTGCAGGTGTCC-1"	"A"
"TCACCTGCATATAGAG-1"	"A"
"TCACCTGGTAGCCATT-1"	"G"
"TCACCTGTCCACGCTT-1"	"A"
"TCACCTGTCGAGAACG-1"	"A"
"TCACCTGTCGCCACTT-1"	"A"
"TCACCTGTCGTTCTAT-1"	"A"
"TCACTCGAGAATATCG-1"	"G"
"TCACTCGAGCAACTGG-1"	"G"
"TCACTCGAGCGAGCTA-1"	"A"
"TCACTCGAGCGTCTGC-1"	"A"
"TCACTCGAGTGATAAC-1"	"G"
"TCACTCGCACGCTGTG-1"	"A"
"TCACTCGGTATCCCTC-1"	"A"
"TCACTCGGTCCTTATT-1"	"A"
"TCACTCGTCAAGGCAG-1"	"A"
"TCACTCGTCAGGCGCT-1"	"A"
"TCACTCGTCATCGCCT-1"	"G"
"TCACTCGTCCCGATTC-1"	"G"
"TCACTCGTCTGATCCC-1"	"A"
"TCAGCTCAGACAACGC-1"	"A"
"TCAGCTCAGAGAATTC-1"	"A"
"TCAGCTCAGCATTCCA-1"	"A"
"TCAGCTCAGTTGACAA-1"	"G"
"TCAGCTCCAACGGACA-1"	"G"
"TCAGCTCCACAATAAG-1"	"G"
"TCAGCTCCACGCGTTG-1"	"A"
"TCAGCTCCAGATACAA-1"	"A"
"TCAGCTCCAGTGCTCG-1"	"A"
"TCAGCTCGTAACGGTG-1"	"G"
"TCAGCTCGTCCAACCG-1"	"A"
"TCAGCTCGTTTCTCTA-1"	"G"
"TCAGCTCTCTTAACGG-1"	"A"
"TCAGGGCAGAGCTACG-1"	"A"
"TCAGGGCCACCGAATT-1"	"G"
"TCAGGGCCAGCGTCGT-1"	"A"
"TCAGGGCGTGTCCAGC-1"	"A"
"TCAGGGCTCCCGTAGG-1"	"G"
"TCAGGGCTCGTTCTAT-1"	"G"
"TCAGGGCTCTTCGTTA-1"	"A"
"TCAGGTAAGAATCAGT-1"	"A"
"TCAGGTACAAAGACGC-1"	"A"
"TCAGGTACAAGCCAGA-1"	"G"
"TCAGGTACAATTGTGC-1"	"A"
"TCAGGTACATATAGAG-1"	"G"
"TCAGGTACATGATTGC-1"	"G"
"TCAGGTAGTAGCGTTT-1"	"A"
"TCAGGTAGTAGGTAAT-1"	"A"
"TCAGGTAGTTCTTTCA-1"	"G"
"TCAGGTAGTTTGACCA-1"	"A"
"TCAGGTATCCATATCT-1"	"A"
"TCAGGTATCCGTTAGA-1"	"G"
"TCAGGTATCGACTATG-1"	"A"
"TCAGGTATCTCGTGAA-1"	"A"
"TCAGTCCAGGCCTCGT-1"	"G"
"TCAGTCCAGGTAAGCC-1"	"G"
"TCAGTCCCATAGTCCA-1"	"A"
"TCAGTCCGTTAACCAC-1"	"G"
"TCAGTCCGTTACACTG-1"	"A"
"TCAGTCCTCACCCGGA-1"	"G"
"TCAGTCCTCCCTAAAG-1"	"A"
"TCAGTCCTCGCATAAC-1"	"A"
"TCAGTTTAGACTAATG-1"	"G"
"TCAGTTTAGGCTCCTG-1"	"G"
"TCAGTTTAGGTACTCT-1"	"G"
"TCAGTTTAGTAACTCC-1"	"A"
"TCAGTTTCAACGTCCG-1"	"G"
"TCAGTTTCAACTAGAA-1"	"A"
"TCAGTTTCAATCAGGG-1"	"G"
"TCAGTTTCAGGCATTT-1"	"A"
"TCAGTTTCATTCACCC-1"	"G"
"TCAGTTTGTAGAACGC-1"	"G"
"TCAGTTTGTCGGCTGT-1"	"G"
"TCAGTTTGTTTGTAGC-1"	"G"
"TCAGTTTTCCAGAATC-1"	"A"
"TCAGTTTTCCATCATT-1"	"A"
"TCCAGAAAGAACAGGA-1"	"G"
"TCCAGAAAGACTAGGC-1"	"A"
"TCCAGAACACATCATG-1"	"A"
"TCCAGAACACGCGACT-1"	"G"
"TCCAGAACAGAGCCAA-1"	"A"
"TCCAGAACAGTAACCT-1"	"G"
"TCCAGAAGTAAACGTA-1"	"A"
"TCCAGAAGTACGGTTT-1"	"A"
"TCCAGAAGTATTCACG-1"	"A"
"TCCAGAAGTCATCGTA-1"	"A"
"TCCAGAAGTGCTTACA-1"	"A"
"TCCAGAAGTTCAGTAC-1"	"G"
"TCCAGAAGTTCTCGAA-1"	"G"
"TCCAGAATCGTGCTGG-1"	"A"
"TCCATCGAGACACTTC-1"	"G"
"TCCATCGAGCGTCTGC-1"	"G"
"TCCATCGAGGACCGAT-1"	"A"
"TCCATCGAGGGCTTCC-1"	"A"
"TCCATCGCAAGTCTCA-1"	"A"
"TCCATCGCATGCCTTC-1"	"A"
"TCCATCGGTGATCAGG-1"	"G"
"TCCATCGTCAGGAATA-1"	"G"
"TCCCACAAGCTCCGGT-1"	"A"
"TCCCACAAGGAAGGTA-1"	"G"
"TCCCACAAGGTAGGCT-1"	"A"
"TCCCACAAGGTTAGTA-1"	"G"
"TCCCACAAGTCCTTCC-1"	"G"
"TCCCACAAGTGTAATG-1"	"A"
"TCCCACACAAAGAGAG-1"	"G"
"TCCCACACAAATTGAG-1"	"A"
"TCCCACACACCTGGTG-1"	"G"
"TCCCACACAGGTCCTG-1"	"G"
"TCCCACACAGTTGGAG-1"	"A"
"TCCCACACATCATAGC-1"	"G"
"TCCCACACATTGATGC-1"	"A"
"TCCCACAGTTGTCGGC-1"	"G"
"TCCCACATCCTAAGTG-1"	"A"
"TCCGACTAGGTTCGAG-1"	"A"
"TCCGACTAGTAGTCGG-1"	"G"
"TCCGACTAGTCGCCTG-1"	"G"
"TCCGACTAGTGGACGT-1"	"A"
"TCCGACTAGTGTCACT-1"	"A"
"TCCGACTAGTGTGTAA-1"	"A"
"TCCGACTCATCCCTTG-1"	"G"
"TCCGACTCATTCGTCC-1"	"G"
"TCCGACTGTATCTAGC-1"	"G"
"TCCGACTGTCGAGGTA-1"	"A"
"TCCGACTGTCTGGGCT-1"	"A"
"TCCGACTGTTTGCCCT-1"	"G"
"TCCGACTTCCACCTAC-1"	"G"
"TCCGACTTCGAGTGTT-1"	"A"
"TCCGACTTCGCTTCAC-1"	"A"
"TCCGACTTCGTGTGCG-1"	"A"
"TCGAGCGAGCACCATT-1"	"A"
"TCGAGCGAGTGAAGGA-1"	"G"
"TCGAGCGCAGGCTACC-1"	"A"
"TCGAGCGGTACTATGC-1"	"G"
"TCGAGCGGTCACTCTC-1"	"G"
"TCGAGCGGTTCTCGAA-1"	"A"
"TCGAGCGGTTGGCTAT-1"	"A"
"TCGAGCGTCCAACGCG-1"	"A"
"TCGAGCGTCTGCGTCT-1"	"G"
"TCGAGCGTCTTACCTA-1"	"A"
"TCGATTTAGACCATAA-1"	"A"
"TCGATTTCAAGGTCGA-1"	"G"
"TCGATTTCAGCAATGG-1"	"A"
"TCGATTTCATCGGCTG-1"	"G"
"TCGATTTGTGAGTAAT-1"	"G"
"TCGATTTGTTATCGAC-1"	"G"
"TCGATTTTCGAGCGCT-1"	"G"
"TCGATTTTCGCACAAT-1"	"G"
"TCGATTTTCTCGCGGA-1"	"A"
"TCGATTTTCTTAAGCG-1"	"G"
"TCGCAGGAGTACCACT-1"	"G"
"TCGCAGGCACCTATTT-1"	"A"
"TCGCAGGCAGGCAGAT-1"	"A"
"TCGCAGGCATTCTTTG-1"	"A"
"TCGCAGGGTACGTAGG-1"	"G"
"TCGCAGGGTTACTTTC-1"	"G"
"TCGCAGGGTTAGTAGA-1"	"G"
"TCGCAGGTCCTAGAGT-1"	"A"
"TCGCAGGTCTGAGTAC-1"	"G"
"TCGCCTAAGCCTATAC-1"	"G"
"TCGCCTAAGGCTCAGA-1"	"G"
"TCGCCTAAGGGCATTG-1"	"A"
"TCGCCTACACTCGTGG-1"	"G"
"TCGCCTACAGGATGTG-1"	"A"
"TCGCCTACATCATCGA-1"	"G"
"TCGCCTACATTACTCT-1"	"A"
"TCGCCTAGTAACGTAA-1"	"G"
"TCGCCTAGTCAACGGA-1"	"A"
"TCGCCTAGTGCTTGAT-1"	"A"
"TCGCCTAGTTTCGACA-1"	"A"
"TCGCCTATCATGAACC-1"	"A"
"TCGCCTATCGATATGC-1"	"G"
"TCGCCTATCGATGTAC-1"	"G"
"TCGCCTATCGGGTCCA-1"	"G"
"TCGGGACAGCAGAATT-1"	"G"
"TCGGGACAGCATGATA-1"	"G"
"TCGGGACCAAGCAGGT-1"	"G"
"TCGGGACCACTCGGAC-1"	"A"
"TCGGGACCACTTATGG-1"	"G"
"TCGGGACGTAGAGAGA-1"	"G"
"TCGGGACGTATTCGAC-1"	"A"
"TCGGGACGTGGTAAGC-1"	"A"
"TCGGGACTCAGTTGAC-1"	"G"
"TCGTTCGAGACTTGAA-1"	"G"
"TCGTTCGAGAGCGGTT-1"	"G"
"TCGTTCGAGCCCATGC-1"	"A"
"TCGTTCGAGGCACCTC-1"	"A"
"TCGTTCGAGTAGTTCC-1"	"A"
"TCGTTCGAGTTACACC-1"	"G"
"TCGTTCGCACTCAGCG-1"	"A"
"TCGTTCGCATCCTGGG-1"	"G"
"TCGTTCGCATTGCGAT-1"	"A"
"TCGTTCGGTATTCACG-1"	"A"
"TCGTTCGGTCCGTGCA-1"	"A"
"TCGTTCGGTGCACTTA-1"	"A"
"TCGTTCGTCCCAGCAG-1"	"G"
"TCGTTCGTCCGGGCAT-1"	"A"
"TCTAGTTAGAGAGGTA-1"	"G"
"TCTAGTTAGAGGCGGA-1"	"G"
"TCTAGTTAGATCCGAG-1"	"G"
"TCTAGTTAGGAGTCTG-1"	"A"
"TCTAGTTCAACTACTG-1"	"A"
"TCTAGTTCACATGATC-1"	"G"
"TCTAGTTCACTGTAAC-1"	"A"
"TCTAGTTCATGGCCGT-1"	"G"
"TCTAGTTGTAGCCATT-1"	"A"
"TCTAGTTTCAGATACC-1"	"G"
"TCTAGTTTCCAGGGAA-1"	"G"
"TCTAGTTTCCATAGGT-1"	"G"
"TCTAGTTTCGACTGGC-1"	"A"
"TCTAGTTTCGAGGTAG-1"	"A"
"TCTAGTTTCGTGAGTT-1"	"A"
"TCTATTGAGACTCGGA-1"	"A"
"TCTATTGAGAGGCGGA-1"	"A"
"TCTATTGAGGGTTCTT-1"	"A"
"TCTATTGAGTGCAACG-1"	"G"
"TCTATTGCACCTGAAT-1"	"A"
"TCTATTGCACGATATC-1"	"G"
"TCTATTGCACTCAAGT-1"	"A"
"TCTATTGCAGCAGGTA-1"	"A"
"TCTATTGCATTGCCTC-1"	"G"
"TCTATTGGTAACCCAT-1"	"G"
"TCTATTGGTACCAAGG-1"	"A"
"TCTATTGGTAGTTTGC-1"	"G"
"TCTATTGGTCAGTGCC-1"	"A"
"TCTATTGGTCATCGTA-1"	"A"
"TCTATTGTCAGGGTTT-1"	"A"
"TCTATTGTCAGTTGAC-1"	"A"
"TCTATTGTCGATGCAT-1"	"A"
"TCTATTGTCTCTATTG-1"	"A"
"TCTATTGTCTGGAAGG-1"	"A"
"TCTCAGCAGACAGCTG-1"	"G"
"TCTCAGCAGTGTAATG-1"	"G"
"TCTCAGCCACAGCCAC-1"	"A"
"TCTCAGCCACAGGAAC-1"	"G"
"TCTCAGCCACTAGGAG-1"	"A"
"TCTCAGCCATGGTAAA-1"	"G"
"TCTCAGCGTATGAAGT-1"	"A"
"TCTCAGCGTCTGTTGA-1"	"A"
"TCTCAGCGTGAGGGTT-1"	"G"
"TCTCAGCTCAACGTGT-1"	"A"
"TCTCAGCTCCATAGGT-1"	"A"
"TCTCAGCTCCGGGCAT-1"	"A"
"TCTCAGCTCTCTGCAC-1"	"A"
"TCTCTGGAGTTGTCCA-1"	"G"
"TCTCTGGCACACACAT-1"	"G"
"TCTCTGGCAGCACATT-1"	"A"
"TCTCTGGCATCTGCAA-1"	"A"
"TCTCTGGTCACCCGGA-1"	"A"
"TCTCTGGTCATGTTCT-1"	"A"
"TCTCTGGTCCGGACTG-1"	"G"
"TCTCTGGTCCGTGCAG-1"	"G"
"TCTCTGGTCCGTTTCG-1"	"A"
"TCTCTGGTCCTAGAGT-1"	"A"
"TGAATCGAGACGCCAA-1"	"G"
"TGAATCGAGCATACCT-1"	"G"
"TGAATCGAGGGCGAAG-1"	"G"
"TGAATCGCAAGTAATG-1"	"G"
"TGAATCGCACGCGTTG-1"	"A"
"TGAATCGCATCGACCG-1"	"A"
"TGAATCGCATGTGAGG-1"	"A"
"TGAATCGCATTATGGC-1"	"G"
"TGAATCGGTGTCTACA-1"	"A"
"TGAATCGTCGTTGTTT-1"	"A"
"TGAATCGTCTATAGGC-1"	"A"
"TGAATCGTCTGTTTAC-1"	"A"
"TGACAACAGCTATCCA-1"	"G"
"TGACAACAGTTCCCGG-1"	"G"
"TGACAACCACGTTGTA-1"	"G"
"TGACAACGTCAGACGA-1"	"G"
"TGACAACGTCATGAGG-1"	"A"
"TGACAACGTTGGACGA-1"	"A"
"TGACAACTCACGTGTA-1"	"A"
"TGACAACTCTGTTGCC-1"	"G"
"TGACTCCAGACTAGGC-1"	"G"
"TGACTCCAGAGAATTC-1"	"G"
"TGACTCCAGATTAGAC-1"	"A"
"TGACTCCAGGAGACTC-1"	"A"
"TGACTCCAGGTACTCT-1"	"A"
"TGACTCCAGTGAACCG-1"	"G"
"TGACTCCCACAAGTGG-1"	"G"
"TGACTCCCAGTCAGAG-1"	"G"
"TGACTCCGTACCAAGG-1"	"A"
"TGACTCCGTACGAGAC-1"	"A"
"TGACTCCGTCCACCAG-1"	"G"
"TGACTCCGTCCGCTTT-1"	"G"
"TGACTCCGTGCATTGT-1"	"A"
"TGACTCCTCCAGGCCA-1"	"A"
"TGACTCCTCGCAACTA-1"	"A"
"TGACTCCTCGTCCCTA-1"	"A"
"TGACTCCTCTTCCGTG-1"	"A"
"TGAGCCGAGAATCAAC-1"	"G"
"TGAGCCGAGCAGAGCT-1"	"G"
"TGAGCCGAGTTCAACC-1"	"G"
"TGAGCCGCAAGTCCTA-1"	"A"
"TGAGCCGCAGGATAGC-1"	"G"
"TGAGCCGCATAGATAG-1"	"A"
"TGAGCCGCATCCCTTG-1"	"G"
"TGAGCCGCATGCACTA-1"	"A"
"TGAGCCGGTTAGCTCA-1"	"A"
"TGAGCCGGTTCCAGTA-1"	"A"
"TGAGCCGTCCGTGCAG-1"	"G"
"TGAGCCGTCGCCACTT-1"	"G"
"TGAGTCAAGAGGCAGG-1"	"G"
"TGAGTCAAGATGCGCA-1"	"G"
"TGAGTCAAGCGGACAT-1"	"G"
"TGAGTCACAGAATGCG-1"	"G"
"TGAGTCACAGGCATTT-1"	"A"
"TGAGTCACATCTGCAA-1"	"G"
"TGAGTCACATTGCGAT-1"	"A"
"TGAGTCAGTATGGATA-1"	"A"
"TGAGTCAGTCATGAGG-1"	"G"
"TGAGTCAGTTATCGAC-1"	"G"
"TGAGTCATCCGGACTG-1"	"G"
"TGAGTCATCGCAAACT-1"	"A"
"TGATCAGAGACCCTAT-1"	"A"
"TGATCAGAGGAGAACA-1"	"G"
"TGATCAGAGGATGTCG-1"	"G"
"TGATCAGAGGTTACAA-1"	"G"
"TGATCAGCAAAGCTGG-1"	"G"
"TGATCAGCAAGCGAAC-1"	"A"
"TGATCAGCACCCTTAC-1"	"G"
"TGATCAGCAGCAATGG-1"	"A"
"TGATCAGCAGGCAAGT-1"	"A"
"TGATCAGCAGTTGCAT-1"	"A"
"TGATCAGCATATAGAG-1"	"A"
"TGATCAGCATCATCGA-1"	"G"
"TGATCAGGTGAGTAAT-1"	"G"
"TGATCAGGTTTCAGCA-1"	"G"
"TGATCAGTCAGTGTAC-1"	"G"
"TGATCAGTCCATATCT-1"	"A"
"TGATCAGTCCCGCAAG-1"	"G"
"TGATCAGTCGACCCGA-1"	"A"
"TGATGCAAGCCCATGC-1"	"G"
"TGATGCAAGGCATGCA-1"	"G"
"TGATGCACAAGAGATT-1"	"G"
"TGATGCACAGTAAGAT-1"	"A"
"TGATGCACATAGCCAT-1"	"A"
"TGATGCAGTAACCCAT-1"	"A"
"TGATGCAGTATTCGAC-1"	"G"
"TGATGCAGTCACATTG-1"	"A"
"TGATGCAGTCTGTTGA-1"	"A"
"TGATGCATCAGGAATA-1"	"G"
"TGATGCATCCCGATTC-1"	"A"
"TGATGCATCTCTTAAC-1"	"G"
"TGATGCATCTTATCAC-1"	"A"
"TGATGCATCTTCCGTG-1"	"A"
"TGATTTCAGCGCATTT-1"	"A"
"TGATTTCAGGCAAGCT-1"	"A"
"TGATTTCCACTGGGCT-1"	"A"
"TGATTTCGTATTCTGG-1"	"A"
"TGATTTCGTGACCAGA-1"	"A"
"TGATTTCGTGGAAAGA-1"	"A"
"TGATTTCTCAATTCCT-1"	"G"
"TGCACCTAGAGCTACG-1"	"A"
"TGCACCTAGCAGAGCT-1"	"A"
"TGCACCTAGCGATACG-1"	"A"
"TGCACCTAGGAGTACC-1"	"A"
"TGCACCTAGGATGCCA-1"	"G"
"TGCACCTAGGTGTTGG-1"	"G"
"TGCACCTAGTCGACCC-1"	"A"
"TGCACCTCAACGGACA-1"	"A"
"TGCACCTCAAGCGAAC-1"	"A"
"TGCACCTCAGTATCTG-1"	"G"
"TGCACCTGTAACATAG-1"	"A"
"TGCACCTGTATTCACG-1"	"G"
"TGCACCTGTATTTGCG-1"	"A"
"TGCACCTGTCAACAGG-1"	"G"
"TGCACCTGTTTAAGGA-1"	"A"
"TGCACCTGTTTCTTAC-1"	"A"
"TGCACCTTCGACTTAG-1"	"A"
"TGCACCTTCTATAGGC-1"	"G"
"TGCACCTTCTATATCC-1"	"A"
"TGCACCTTCTCCAACC-1"	"A"
"TGCATGAAGAGAAGCA-1"	"A"
"TGCATGACACGTTGTA-1"	"G"
"TGCATGACAGTTCGGC-1"	"G"
"TGCATGACATCGTGAT-1"	"G"
"TGCATGACATTAGCAC-1"	"G"
"TGCATGAGTAACCCAT-1"	"A"
"TGCATGAGTACCTATG-1"	"G"
"TGCATGAGTAGCATGG-1"	"G"
"TGCATGAGTGCAAGCA-1"	"A"
"TGCATGAGTTACGAAA-1"	"A"
"TGCATGAGTTGGCGAA-1"	"G"
"TGCATGATCAAGAGGC-1"	"A"
"TGCATGATCAGTCAAC-1"	"G"
"TGCATGATCATCGCTC-1"	"G"
"TGCATGATCCCGTATC-1"	"G"
"TGCATTTAGCGTAGCA-1"	"G"
"TGCATTTAGCTGATTC-1"	"A"
"TGCATTTAGGGTCCCT-1"	"A"
"TGCATTTAGTATGCTC-1"	"G"
"TGCATTTAGTCACGCC-1"	"A"
"TGCATTTCAGATGGCA-1"	"G"
"TGCATTTCAGGATAGC-1"	"A"
"TGCATTTCATTACCTT-1"	"G"
"TGCATTTGTACGAGAC-1"	"A"
"TGCATTTGTCACCCGA-1"	"A"
"TGCATTTGTCAGAGTG-1"	"G"
"TGCATTTGTCTCAAAC-1"	"A"
"TGCATTTGTTTGCGAT-1"	"A"
"TGCATTTTCCATTGAG-1"	"A"
"TGCCTCAAGACCGCAA-1"	"A"
"TGCCTCAAGAGGAATG-1"	"A"
"TGCCTCAAGGATTTGA-1"	"A"
"TGCCTCAAGGGTTCTT-1"	"G"
"TGCCTCACACAGGAAC-1"	"G"
"TGCCTCACACCGAAAG-1"	"G"
"TGCCTCACACGTTGTA-1"	"G"
"TGCCTCACATCATGTG-1"	"G"
"TGCCTCAGTGCTTCCT-1"	"A"
"TGCCTCATCACCGCGA-1"	"G"
"TGCCTCATCGGATGTT-1"	"A"
"TGCCTCATCGGGTCCA-1"	"A"
"TGCCTCATCTGAGTCA-1"	"A"
"TGCCTCATCTTAACGG-1"	"A"
"TGCCTGTAGAATGCTA-1"	"A"
"TGCCTGTCACTCAAGT-1"	"A"
"TGCCTGTGTAACACTC-1"	"A"
"TGCCTGTGTTGCAGAG-1"	"G"
"TGCCTGTTCAGCACTA-1"	"A"
"TGCCTGTTCCGATTGA-1"	"G"
"TGCCTGTTCGAGGTCC-1"	"A"
"TGCCTGTTCGTGATAC-1"	"A"
"TGCCTGTTCTCCAACC-1"	"G"
"TGCCTGTTCTGTGTCC-1"	"A"
"TGCCTGTTCTTCGTTA-1"	"A"
"TGCGTAAAGAACTCCT-1"	"A"
"TGCGTAAAGCATTGGG-1"	"G"
"TGCGTAAAGGTTGTGG-1"	"G"
"TGCGTAAAGTCTGGGA-1"	"G"
"TGCGTAACAAGCAACG-1"	"G"
"TGCGTAACAAGTAATG-1"	"A"
"TGCGTAACACTCGGAC-1"	"A"
"TGCGTAACATAGATAG-1"	"A"
"TGCGTAAGTACGGAGT-1"	"A"
"TGCGTAAGTACTTCAG-1"	"G"
"TGCGTAAGTGACCAGA-1"	"A"
"TGCGTAAGTGATGCGA-1"	"A"
"TGCGTAAGTGCAACAG-1"	"G"
"TGCGTAAGTGCATTCA-1"	"A"
"TGCGTAAGTGTGCTTA-1"	"G"
"TGCGTAATCCACGAGC-1"	"G"
"TGCGTAATCCTCAAGA-1"	"A"
"TGCGTAATCCTGTGGG-1"	"A"
"TGCGTAATCGAAGCCC-1"	"A"
"TGCGTAATCGCAAGCC-1"	"A"
"TGCGTAATCGGTACTA-1"	"A"
"TGCGTAATCGGTAGGA-1"	"A"
"TGCTATTAGACAGTGC-1"	"A"
"TGCTATTAGAGCGGTT-1"	"G"
"TGCTATTCAATAGCGG-1"	"A"
"TGCTATTCACATTCTT-1"	"A"
"TGCTATTCATGGTAAA-1"	"A"
"TGCTATTGTAATGCCT-1"	"A"
"TGCTATTGTATATGGA-1"	"A"
"TGCTATTGTGGGTAGT-1"	"A"
"TGCTATTGTTTGTACG-1"	"A"
"TGCTCACAGATCCGAG-1"	"A"
"TGCTCACAGCGTATCT-1"	"A"
"TGCTCACAGTGAAGGA-1"	"G"
"TGCTCACAGTGATATG-1"	"A"
"TGCTCACCACGAACGA-1"	"G"
"TGCTCACCAGTCCTGG-1"	"A"
"TGCTCACCAGTTAAAG-1"	"G"
"TGCTCACCATTATGGC-1"	"A"
"TGCTCACGTGCTGAAG-1"	"G"
"TGCTCACGTTCTTTGT-1"	"A"
"TGCTCACTCGGGACAA-1"	"A"
"TGCTCGTAGAATCAGT-1"	"A"
"TGCTCGTAGTTGAATG-1"	"G"
"TGCTCGTCAAATTGAG-1"	"G"
"TGCTCGTCACAGTTAC-1"	"A"
"TGCTCGTCATAGGCGA-1"	"A"
"TGCTCGTCATCCCGGA-1"	"A"
"TGCTCGTCATGCCTTC-1"	"A"
"TGCTCGTGTTCCAATG-1"	"G"
"TGCTCGTGTTTAGGAA-1"	"A"
"TGCTCGTTCAGTGTGT-1"	"A"
"TGCTCGTTCGCTATAG-1"	"A"
"TGCTCGTTCGTCCCTA-1"	"A"
"TGCTCGTTCTAGCAAC-1"	"A"
"TGCTCGTTCTGTTGCC-1"	"A"
"TGCTTCGAGCGATACG-1"	"A"
"TGCTTCGAGGACTAGC-1"	"G"
"TGCTTCGAGGGTGTTG-1"	"A"
"TGCTTCGAGTCTTAGC-1"	"A"
"TGCTTCGCAATAGTGA-1"	"A"
"TGCTTCGCAATGAAAC-1"	"G"
"TGCTTCGGTTGCCTGG-1"	"A"
"TGCTTCGTCGCGATGC-1"	"G"
"TGCTTCGTCGTGCTGG-1"	"A"
"TGCTTTAAGCTCGGCT-1"	"G"
"TGCTTTACAAGCAACG-1"	"A"
"TGCTTTACAATCATCG-1"	"G"
"TGCTTTACACCGTCTT-1"	"A"
"TGCTTTAGTAAAGGCC-1"	"G"
"TGCTTTAGTCATCGTA-1"	"G"
"TGCTTTAGTGGTTCTA-1"	"G"
"TGCTTTATCAGCACGC-1"	"A"
"TGCTTTATCCCGATTC-1"	"A"
"TGCTTTATCTCCTTAA-1"	"A"
"TGCTTTATCTGGCGCA-1"	"A"
"TGCTTTATCTGGGCGT-1"	"G"
"TGCTTTATCTGGTACA-1"	"G"
"TGGAAGGAGACTAGCG-1"	"A"
"TGGAAGGAGCTAGCAG-1"	"G"
"TGGAAGGCAATGATGA-1"	"A"
"TGGAAGGCACACACAT-1"	"A"
"TGGAAGGCAGATGGCA-1"	"A"
"TGGAAGGCAGGTCCTG-1"	"A"
"TGGAAGGCATCTCACC-1"	"A"
"TGGAAGGCATGGATGG-1"	"G"
"TGGAAGGCATGGCCCA-1"	"G"
"TGGAAGGCATTGTGAC-1"	"A"
"TGGAAGGGTCCTCAGG-1"	"A"
"TGGAAGGGTGGACAGT-1"	"A"
"TGGAAGGGTGGTTCTA-1"	"A"
"TGGAAGGGTGTCTACA-1"	"A"
"TGGAAGGTCCAAGAGG-1"	"A"
"TGGAAGGTCGTGCTGG-1"	"A"
"TGGACATAGATCTCAC-1"	"G"
"TGGACATAGCCTATAC-1"	"A"
"TGGACATAGCTAGCAG-1"	"A"
"TGGACATAGGGTCCCT-1"	"A"
"TGGACATCAAGCAATA-1"	"A"
"TGGACATCAAGGAGGG-1"	"G"
"TGGACATCACGGTTAT-1"	"G"
"TGGACATCATGCGACC-1"	"G"
"TGGACATGTCCAGACC-1"	"G"
"TGGACATGTGTTAGAA-1"	"G"
"TGGACATTCGTCCCTA-1"	"A"
"TGGCAATAGAGCTGTG-1"	"G"
"TGGCAATAGGAGGCGA-1"	"A"
"TGGCAATAGGAGTACC-1"	"A"
"TGGCAATCAAGCGTCC-1"	"G"
"TGGCAATCACCTGAAT-1"	"G"
"TGGCAATCATCATGTG-1"	"A"
"TGGCAATGTCTCTGGG-1"	"A"
"TGGCAATGTGCGCATC-1"	"A"
"TGGCAATGTTACGCTA-1"	"A"
"TGGCAATTCACGATTG-1"	"A"
"TGGCAATTCGATAGGG-1"	"G"
"TGGCAATTCGCTCTAC-1"	"G"
"TGGCCTTAGAACTCCT-1"	"A"
"TGGCCTTAGCAACTGG-1"	"A"
"TGGCCTTAGCGTAGCA-1"	"A"
"TGGCCTTAGCTACGCC-1"	"G"
"TGGCCTTAGGTACTCT-1"	"A"
"TGGCCTTAGTAGCAAT-1"	"G"
"TGGCCTTAGTATGGGC-1"	"G"
"TGGCCTTAGTCAGGAC-1"	"A"
"TGGCCTTAGTCCCTCT-1"	"G"
"TGGCCTTCAACACGGA-1"	"G"
"TGGCCTTCATCAGAAA-1"	"G"
"TGGCCTTCATCGCTAA-1"	"G"
"TGGCCTTCATTTGGCA-1"	"A"
"TGGCCTTGTCATTGCA-1"	"G"
"TGGCCTTGTTTCAGCA-1"	"G"
"TGGCCTTTCCGGGCAT-1"	"A"
"TGGCCTTTCTGAGTCA-1"	"A"
"TGGCGCAAGCTCCATA-1"	"G"
"TGGCGCAAGTCGTATC-1"	"A"
"TGGCGCACAACGGGTA-1"	"G"
"TGGCGCACAAGCAGGT-1"	"A"
"TGGCGCACAATGGTCT-1"	"A"
"TGGCGCACAATGTAAG-1"	"G"
"TGGCGCACATTAACGC-1"	"G"
"TGGCGCAGTGCAGACA-1"	"A"
"TGGCGCAGTTCCCAAA-1"	"A"
"TGGCGCAGTTCTTTGT-1"	"G"
"TGGCGCAGTTTCTACT-1"	"A"
"TGGCGCATCAAGAGGC-1"	"G"
"TGGCGCATCAAGGCAG-1"	"A"
"TGGCGCATCCGGCTGA-1"	"G"
"TGGGTGCAGAAGCCGT-1"	"A"
"TGGGTGCAGACTAGCG-1"	"G"
"TGGGTGCAGATGCGAC-1"	"A"
"TGGGTGCAGCATTGGG-1"	"A"
"TGGGTGCCATTAACGC-1"	"A"
"TGGGTGCGTATCTAGC-1"	"G"
"TGGGTGCGTTCAGTTG-1"	"G"
"TGGGTGCGTTCTACGA-1"	"A"
"TGGGTGCTCCTGGGAC-1"	"A"
"TGGGTGCTCGCTGATA-1"	"G"
"TGGGTTAAGAGCACTG-1"	"G"
"TGGGTTAAGGCAAGGG-1"	"A"
"TGGGTTAAGGCAGTGT-1"	"A"
"TGGGTTAAGTCTCTAG-1"	"A"
"TGGGTTACAAACTACC-1"	"G"
"TGGGTTACAATGCATC-1"	"A"
"TGGGTTACACGCTCAG-1"	"G"
"TGGGTTACATGGCCTG-1"	"G"
"TGGGTTAGTCGCTAGC-1"	"A"
"TGGGTTATCAGAATGA-1"	"G"
"TGGGTTATCCGGCGAT-1"	"A"
"TGGTCAAAGGAGTAGA-1"	"A"
"TGGTCAACAGGTTATC-1"	"G"
"TGGTCAACATCCTCGT-1"	"A"
"TGGTCAACATCGGCCA-1"	"A"
"TGGTCAACATTAAGGA-1"	"A"
"TGGTCAAGTAGTCCAT-1"	"A"
"TGGTCAAGTCGTAGTT-1"	"A"
"TGGTCAAGTCTGTTGA-1"	"A"
"TGGTCAAGTGCACTTA-1"	"A"
"TGGTCAAGTTCTGAGT-1"	"G"
"TGGTCAAGTTTAAGCC-1"	"G"
"TGGTCAATCACATCCC-1"	"G"
"TGGTCAATCACCGCGA-1"	"G"
"TGGTCCTAGAACTCCT-1"	"G"
"TGGTCCTAGTAGAAGG-1"	"A"
"TGGTCCTCAGCGTGAA-1"	"G"
"TGGTCCTCATTCTCGC-1"	"G"
"TGGTCCTGTACTTCAG-1"	"G"
"TGGTCCTGTCATAAGA-1"	"A"
"TGGTCCTTCAGTCACA-1"	"A"
"TGGTCCTTCCGCCTAT-1"	"G"
"TGTAAGCAGTCCCTCT-1"	"G"
"TGTAAGCCACTACACA-1"	"A"
"TGTAAGCCAGGATGTG-1"	"A"
"TGTAAGCGTCAACGGA-1"	"G"
"TGTAAGCGTCTAAGAA-1"	"A"
"TGTAAGCGTGATGTGG-1"	"A"
"TGTAAGCGTGCAGACA-1"	"G"
"TGTAAGCGTTACTACG-1"	"G"
"TGTAAGCTCCAGGGAA-1"	"G"
"TGTAAGCTCCGAGGAA-1"	"A"
"TGTAAGCTCCTTTGCG-1"	"A"
"TGTAAGCTCGAACCGC-1"	"A"
"TGTAAGCTCTCGCGTT-1"	"A"
"TGTAAGCTCTTAATCC-1"	"G"
"TGTACAGAGAAGGGCG-1"	"G"
"TGTACAGAGTCTCGAT-1"	"G"
"TGTACAGAGTTCCCGG-1"	"G"
"TGTACAGGTCGACTGC-1"	"A"
"TGTACAGTCCAACCTC-1"	"G"
"TGTACAGTCCAGAGAG-1"	"A"
"TGTACAGTCCTATCCG-1"	"A"
"TGTACAGTCGTGTGCG-1"	"G"
"TGTACAGTCTGAGTAC-1"	"A"
"TGTACGAAGACGCCCT-1"	"A"
"TGTACGAAGAGGCCTA-1"	"G"
"TGTACGAAGCATTCCA-1"	"A"
"TGTACGAAGCGTCTGC-1"	"G"
"TGTACGAAGCGTTAGG-1"	"A"
"TGTACGAAGTGGGACT-1"	"G"
"TGTACGACACTTACAG-1"	"A"
"TGTACGAGTAGGTCTT-1"	"A"
"TGTACGAGTATCCTTT-1"	"G"
"TGTACGAGTGAGGGTT-1"	"G"
"TGTACGAGTTCCATCC-1"	"A"
"TGTACGATCAGGGTTT-1"	"A"
"TGTACGATCCGCGATG-1"	"G"
"TGTACGATCTCTGCGT-1"	"A"
"TGTAGCAAGGCGCTTC-1"	"G"
"TGTAGCAAGTCATACC-1"	"A"
"TGTAGCAAGTCCCGCA-1"	"G"
"TGTAGCAAGTGAGCTG-1"	"G"
"TGTAGCAAGTGAGTTA-1"	"A"
"TGTAGCACACCAAGGA-1"	"A"
"TGTAGCACACGGCCAT-1"	"G"
"TGTAGCACATTACTTC-1"	"A"
"TGTAGCAGTAGCGGTA-1"	"G"
"TGTAGCAGTTGAAGCG-1"	"A"
"TGTAGCATCAAACCCA-1"	"A"
"TGTAGCATCATGAACC-1"	"G"
"TGTAGCATCCGCTCTA-1"	"G"
"TGTAGCATCCGGCGAT-1"	"G"
"TGTAGCATCGTGCTGG-1"	"G"
"TGTAGCATCGTGGCGT-1"	"A"
"TGTAGCATCTCTTAAC-1"	"G"
"TGTAGCATCTGACATG-1"	"A"
"TGTGACAAGACTTCCA-1"	"G"
"TGTGACAAGCGAGCTA-1"	"G"
"TGTGACAAGGATGTAT-1"	"A"
"TGTGACACAAATTCCG-1"	"A"
"TGTGACACAATTCAGC-1"	"G"
"TGTGACACACATTCTT-1"	"A"
"TGTGACAGTAGGTAAT-1"	"A"
"TGTGACAGTAGGTCTT-1"	"A"
"TGTGACAGTCGTAGTT-1"	"A"
"TGTGACAGTCTAAGAA-1"	"A"
"TGTGACAGTCTGAGCC-1"	"A"
"TGTGACAGTTTAAGGA-1"	"A"
"TGTGACATCCGCCTAT-1"	"G"
"TGTGACATCCTGGGAC-1"	"G"
"TGTGACATCGAGGCTC-1"	"A"
"TGTGACATCGTCTTAT-1"	"G"
"TGTGGCGAGAGCTACG-1"	"A"
"TGTGGCGAGAGGCCTA-1"	"A"
"TGTGGCGAGGCCAGTA-1"	"G"
"TGTGGCGCAACGCAAG-1"	"G"
"TGTGGCGCATTACCTT-1"	"G"
"TGTGGCGGTCCGTGCA-1"	"A"
"TGTGGCGGTCTCAAAC-1"	"G"
"TGTGGCGGTCTGTGTA-1"	"A"
"TGTGGCGGTTGCAGCC-1"	"A"
"TGTGGCGTCCTCCATG-1"	"G"
"TGTGGCGTCCTGTGGG-1"	"G"
"TGTGGCGTCTCATATC-1"	"G"
"TGTGGCGTCTGTGTCC-1"	"G"
"TGTGTCCAGCATACCT-1"	"G"
"TGTGTCCAGTCCGTGC-1"	"G"
"TGTGTCCCATCAACTG-1"	"G"
"TGTGTCCCATTTCACT-1"	"G"
"TGTGTCCGTCCTATTT-1"	"A"
"TGTGTCCGTGGTCGAA-1"	"A"
"TGTGTCCTCAGGAAGC-1"	"A"
"TGTGTCCTCAGTGTAC-1"	"G"
"TGTGTCCTCCATGTTT-1"	"G"
"TGTGTCCTCGTGAGTT-1"	"A"
"TGTGTCCTCGTGTGCG-1"	"G"
"TGTGTCCTCTATAGGC-1"	"A"
"TGTTAGGAGCATGATA-1"	"G"
"TGTTAGGAGGAGTCTG-1"	"G"
"TGTTAGGCAAAGCTTC-1"	"A"
"TGTTAGGCAAGTAACA-1"	"G"
"TGTTAGGCACGGTTAT-1"	"A"
"TGTTAGGCACTCAGCG-1"	"A"
"TGTTAGGCAGAGTCGA-1"	"A"
"TGTTAGGGTAATGTGA-1"	"A"
"TGTTAGGGTAGACACG-1"	"A"
"TGTTAGGGTAGTCTGT-1"	"A"
"TGTTAGGGTGGACAGT-1"	"A"
"TGTTAGGTCGCTAGTA-1"	"G"
"TGTTAGGTCGGGACAA-1"	"A"
"TTAACGGAGTACCTCA-1"	"A"
"TTAACGGGTACCCATA-1"	"A"
"TTAACGGGTACGGAGT-1"	"G"
"TTAACGGGTAGAAAGG-1"	"G"
"TTAACGGGTCAGAAAT-1"	"A"
"TTAACGGGTGCTAGTT-1"	"A"
"TTAACGGGTGCTTTGA-1"	"G"
"TTAACGGGTTGCAGAG-1"	"G"
"TTAACGGTCTGAGTCA-1"	"A"
"TTACCCGAGACACGGT-1"	"A"
"TTACCCGCACAGGAAC-1"	"A"
"TTACCCGCACATCATG-1"	"A"
"TTACCCGCACCGTCTT-1"	"A"
"TTACCCGCACGCGATC-1"	"A"
"TTACCCGCAGTTAAAG-1"	"A"
"TTACCCGCATACTGCA-1"	"G"
"TTACCCGCATCAGCTA-1"	"G"
"TTACCCGGTAACCGAG-1"	"A"
"TTACCCGGTAAGTCTC-1"	"G"
"TTACCCGGTACGGATG-1"	"A"
"TTACCCGGTATTCGAC-1"	"G"
"TTACCCGGTCAACAGG-1"	"G"
"TTACCCGGTCCGAGCT-1"	"A"
"TTACCCGGTCTTAGCA-1"	"A"
"TTACCCGGTGTCCCAG-1"	"A"
"TTACCCGTCACCGCGA-1"	"A"
"TTACCCGTCGGGCTCA-1"	"A"
"TTACCCGTCTGTGTCC-1"	"G"
"TTACCGCAGCCTATAC-1"	"A"
"TTACCGCAGTACGCGA-1"	"A"
"TTACCGCCACTGAAGG-1"	"A"
"TTACCGCCATCCCGGA-1"	"A"
"TTACCGCCATCGAGTT-1"	"A"
"TTACCGCGTACCCACG-1"	"A"
"TTACCGCGTCAGGTGA-1"	"A"
"TTACCGCGTTTAGACC-1"	"G"
"TTACCGCTCAAGGCCC-1"	"A"
"TTACCGCTCCCAGCGA-1"	"A"
"TTACCGCTCGTGAACT-1"	"A"
"TTACGGAAGCTGAATA-1"	"A"
"TTACGGAAGGGTCCCT-1"	"A"
"TTACGGAAGGTTCGTT-1"	"A"
"TTACGGACAAACCCTA-1"	"G"
"TTACGGACAACGCACC-1"	"A"
"TTACGGACACGCTAAT-1"	"G"
"TTACGGACATTGTTCT-1"	"G"
"TTACGGAGTAATGTGA-1"	"G"
"TTACGGAGTCACATTG-1"	"A"
"TTACGGAGTCATAGCT-1"	"G"
"TTACGGAGTCCTTCAC-1"	"A"
"TTACGGAGTGCAAGAC-1"	"G"
"TTACGGAGTTGAAGCG-1"	"G"
"TTACGGATCCATCATT-1"	"A"
"TTACGTTAGAGCCTGA-1"	"G"
"TTACGTTAGCCTATAC-1"	"A"
"TTACGTTAGCGTATCT-1"	"A"
"TTACGTTAGGGAGTTC-1"	"A"
"TTACGTTAGTTCTCCC-1"	"G"
"TTACGTTCAGTAGGCA-1"	"A"
"TTACGTTGTATGTTCG-1"	"G"
"TTACGTTTCAACGTGT-1"	"A"
"TTACGTTTCAGTCTTT-1"	"A"
"TTACGTTTCCATATCT-1"	"A"
"TTACGTTTCGGTAGGA-1"	"G"
"TTACTCAAGAGGAACA-1"	"A"
"TTACTCAAGATCGCCC-1"	"G"
"TTACTCAAGCAGAGCT-1"	"G"
"TTACTCAAGCTTACCA-1"	"A"
"TTACTCAAGTACAACA-1"	"A"
"TTACTCACAAGACTTC-1"	"A"
"TTACTCACAATTGTGC-1"	"A"
"TTACTCACACAGTTAC-1"	"A"
"TTACTCACACGCGATC-1"	"A"
"TTACTCAGTAACGGTG-1"	"A"
"TTACTCAGTGAGTCGA-1"	"A"
"TTACTCAGTGCAACAG-1"	"A"
"TTACTCAGTGTGCTTA-1"	"A"
"TTACTCAGTTCTGATG-1"	"A"
"TTACTCAGTTTCCACC-1"	"A"
"TTACTCAGTTTGCCAA-1"	"A"
"TTACTCATCGCTCTAC-1"	"A"
"TTACTCATCGTGAGTT-1"	"A"
"TTACTCATCGTTACAG-1"	"A"
"TTACTCATCTGTGTGA-1"	"A"
"TTACTTGAGCAATAAC-1"	"A"
"TTACTTGAGGTAAGTT-1"	"G"
"TTACTTGCAAGAGATT-1"	"G"
"TTACTTGCAATTCGTG-1"	"A"
"TTACTTGCACGTGAAG-1"	"A"
"TTACTTGCACTCCACT-1"	"A"
"TTACTTGCACTGATTG-1"	"A"
"TTACTTGCAGAACGAC-1"	"G"
"TTACTTGCAGACTAAA-1"	"G"
"TTACTTGCAGATAAGT-1"	"G"
"TTACTTGCAGGACCTC-1"	"A"
"TTACTTGCAGGTTATC-1"	"G"
"TTACTTGCATGGGTGA-1"	"A"
"TTACTTGGTACGAGAC-1"	"G"
"TTACTTGGTAGACGCA-1"	"G"
"TTACTTGGTATTCACG-1"	"G"
"TTACTTGGTATTGTCG-1"	"A"
"TTACTTGTCCAGTTAG-1"	"G"
"TTACTTGTCGGTCTAA-1"	"G"
"TTAGCGAAGAGGTGGG-1"	"A"
"TTAGCGACATCACAAC-1"	"G"
"TTAGCGACATGTGAGG-1"	"G"
"TTAGCGAGTAACGGAC-1"	"A"
"TTAGCGAGTGATAGAT-1"	"G"
"TTAGCGAGTGTCCTTC-1"	"G"
"TTAGCGAGTTCATTTC-1"	"G"
"TTAGCGAGTTCCGCGA-1"	"A"
"TTAGCGATCCCGAAGC-1"	"A"
"TTAGCGATCCGATTGA-1"	"G"
"TTAGCGATCGTGGTAT-1"	"G"
"TTAGCGATCTCCCTTT-1"	"G"
"TTAGCGATCTGGAAGG-1"	"G"
"TTAGCTTAGAGAATTC-1"	"G"
"TTAGCTTAGTGCTGAG-1"	"G"
"TTAGCTTCACTCCCAT-1"	"A"
"TTAGCTTCAGCACATT-1"	"G"
"TTAGCTTCAGGGCTTC-1"	"A"
"TTAGCTTGTACATGGG-1"	"G"
"TTAGCTTGTATTCTCT-1"	"A"
"TTAGCTTGTCATCGTA-1"	"A"
"TTAGCTTGTTGCCGCA-1"	"G"
"TTAGCTTTCGAGGCTC-1"	"A"
"TTAGGTGAGGCCAATG-1"	"G"
"TTAGGTGAGTACAGTA-1"	"A"
"TTAGGTGCAATAGTGA-1"	"A"
"TTAGGTGCAGGTCCTG-1"	"G"
"TTAGGTGCATCGACGC-1"	"A"
"TTAGGTGCATGCACTA-1"	"G"
"TTAGGTGGTTTAAGCC-1"	"G"
"TTAGGTGGTTTGCCAA-1"	"A"
"TTAGGTGTCACACGTA-1"	"G"
"TTAGGTGTCACTCGGG-1"	"A"
"TTAGGTGTCCCAGCGA-1"	"G"
"TTAGGTGTCCCTAAAG-1"	"A"
"TTATGTCAGGGCATTG-1"	"A"
"TTATGTCCACGTTGTA-1"	"A"
"TTATGTCCACTGATAC-1"	"A"
"TTATGTCGTAACGGAC-1"	"A"
"TTATGTCGTACTTCAG-1"	"G"
"TTATGTCGTGATGCTT-1"	"A"
"TTATGTCGTTCCATCC-1"	"G"
"TTATGTCGTTCCCTTG-1"	"A"
"TTATGTCGTTTCTACT-1"	"G"
"TTATGTCTCAGAGTGG-1"	"A"
"TTATGTCTCCTTTGCG-1"	"G"
"TTATGTCTCGAGGTAG-1"	"G"
"TTATGTCTCGTCGCAG-1"	"G"
"TTATGTCTCTCTTAAC-1"	"A"
"TTCAACTAGCCTATAC-1"	"G"
"TTCAACTAGCGTCTGC-1"	"G"
"TTCAACTAGTCTCCAA-1"	"A"
"TTCAACTAGTGCACAG-1"	"A"
"TTCAACTAGTTACACC-1"	"A"
"TTCAACTCACCTATTT-1"	"G"
"TTCAACTGTCGATAGG-1"	"A"
"TTCAACTGTGACGCAA-1"	"A"
"TTCAACTGTTGGCTAT-1"	"A"
"TTCAACTTCACACGTA-1"	"G"
"TTCAACTTCAGGAAGC-1"	"G"
"TTCAACTTCCCTAAAG-1"	"G"
"TTCAACTTCCTCCAGT-1"	"G"
"TTCAACTTCGAGTGTT-1"	"G"
"TTCAACTTCGGAAAGC-1"	"A"
"TTCATCAAGAGCCTGA-1"	"G"
"TTCATCAAGATACCAA-1"	"A"
"TTCATCAAGGCCAGTA-1"	"A"
"TTCATCAAGGCTTAAA-1"	"A"
"TTCATCAAGTCGTATC-1"	"G"
"TTCATCACAAATGCTC-1"	"A"
"TTCATCACATGGAGGT-1"	"A"
"TTCATCACATTCCCGT-1"	"G"
"TTCATCAGTAAACGGC-1"	"G"
"TTCATCAGTATGGTTC-1"	"G"
"TTCATCAGTCACAGTT-1"	"A"
"TTCATCAGTTATAGAG-1"	"A"
"TTCATCATCAGAATGA-1"	"G"
"TTCATCATCAGGGTTT-1"	"A"
"TTCATCATCCTGACCT-1"	"G"
"TTCATCATCGATGCAT-1"	"A"
"TTCATTGAGACACGGT-1"	"G"
"TTCATTGAGAGAGTAG-1"	"G"
"TTCATTGAGCAGAAAG-1"	"G"
"TTCATTGAGGTCGTTT-1"	"A"
"TTCATTGAGTGATATG-1"	"A"
"TTCATTGCAGGCAGAT-1"	"A"
"TTCATTGCATAAAGTG-1"	"A"
"TTCATTGGTATGTCCA-1"	"A"
"TTCATTGGTCCCGAGT-1"	"A"
"TTCATTGGTCCTATTT-1"	"G"
"TTCATTGGTGCTTTGA-1"	"G"
"TTCATTGGTGGACAGT-1"	"G"
"TTCATTGGTTATAGAG-1"	"A"
"TTCATTGGTTATGCAC-1"	"G"
"TTCATTGGTTCCGGCA-1"	"G"
"TTCATTGGTTTGCCCT-1"	"A"
"TTCATTGTCAGGCCGT-1"	"A"
"TTCATTGTCCATAGGT-1"	"G"
"TTCATTGTCCCAGCGA-1"	"A"
"TTCGATTAGTCAACTC-1"	"G"
"TTCGATTCAAATGCTC-1"	"A"
"TTCGATTCAAGATGCG-1"	"G"
"TTCGATTCAATCACTG-1"	"G"
"TTCGATTCACAGCCAC-1"	"A"
"TTCGATTGTATCACAC-1"	"G"
"TTCGATTGTGCGCTCA-1"	"G"
"TTCGATTGTGCTAGTT-1"	"A"
"TTCGATTTCCTTTGCG-1"	"A"
"TTCGATTTCGCTAGTA-1"	"A"
"TTCGATTTCGGGAATG-1"	"G"
"TTCGATTTCTATATCC-1"	"A"
"TTCGCGTAGACTAGCG-1"	"A"
"TTCGCGTAGATGAGGA-1"	"A"
"TTCGCGTAGCGATACG-1"	"A"
"TTCGCGTAGGTTGTTC-1"	"G"
"TTCGCGTCAAACAGTA-1"	"A"
"TTCGCGTCAAGCACTT-1"	"A"
"TTCGCGTCAATGCCAT-1"	"A"
"TTCGCGTCATTTAGGC-1"	"A"
"TTCGCGTGTAACCATC-1"	"G"
"TTCGCGTGTACGACCC-1"	"A"
"TTCGCGTGTAGTAACA-1"	"G"
"TTCGCGTGTATGCTAC-1"	"G"
"TTCGCGTGTATTGTGC-1"	"A"
"TTCGCGTGTCTCTGGG-1"	"G"
"TTCGCGTGTGGCCTTG-1"	"G"
"TTCGCGTGTGTCCCAG-1"	"G"
"TTCGCGTGTTAGCTCA-1"	"A"
"TTCGCGTTCAAACCCA-1"	"A"
"TTCGCGTTCCATGACA-1"	"G"
"TTCGCGTTCGCGTGAC-1"	"G"
"TTCGCGTTCGGATGTT-1"	"A"
"TTCGGTCAGATGGCAC-1"	"A"
"TTCGGTCCAATGGTAA-1"	"A"
"TTCGGTCGTAACGGAC-1"	"A"
"TTCGGTCGTGTGACCC-1"	"G"
"TTCGGTCTCAGTCAAC-1"	"A"
"TTCGGTCTCTCTCAAT-1"	"G"
"TTCGGTCTCTTCCGTG-1"	"G"
"TTCGTTAAGAACAGGA-1"	"A"
"TTCGTTAAGAACGTTA-1"	"G"
"TTCGTTAAGATGCGAC-1"	"G"
"TTCGTTAAGCTCGGCT-1"	"G"
"TTCGTTACAGTATCTG-1"	"A"
"TTCGTTAGTATCCCTC-1"	"A"
"TTCGTTAGTCAGCAAG-1"	"A"
"TTCGTTAGTCAGCTTA-1"	"A"
"TTCGTTAGTGCATCAT-1"	"G"
"TTCGTTAGTTACGAAA-1"	"A"
"TTCGTTAGTTGCAGAG-1"	"A"
"TTCGTTATCTGGAAGG-1"	"A"
"TTCGTTATCTTACTCA-1"	"A"
"TTCTAACAGAATACTG-1"	"A"
"TTCTAACAGACAACGC-1"	"G"
"TTCTAACAGACTTGAA-1"	"G"
"TTCTAACAGCCATGGA-1"	"G"
"TTCTAACAGGGAAATG-1"	"A"
"TTCTAACAGTACAGTA-1"	"A"
"TTCTAACAGTATAGTG-1"	"A"
"TTCTAACCAACGTAGG-1"	"G"
"TTCTAACCAAGTTCGT-1"	"G"
"TTCTAACCAGCGTACC-1"	"G"
"TTCTAACCATCATCGA-1"	"G"
"TTCTAACCATTACACG-1"	"G"
"TTCTAACGTACCCATA-1"	"G"
"TTCTAACGTATCCCTC-1"	"A"
"TTCTAACTCAGAATGA-1"	"G"
"TTCTAACTCCTGTAGA-1"	"A"
"TTCTAACTCGGAGTTT-1"	"A"
"TTCTGTAAGAAGCCTG-1"	"A"
"TTCTGTAAGACCCATT-1"	"G"
"TTCTGTAAGCGCATTT-1"	"A"
"TTCTGTAAGCGTAGCA-1"	"G"
"TTCTGTACATTCACCC-1"	"A"
"TTCTGTAGTGCAAGAC-1"	"G"
"TTCTGTAGTTACCCAA-1"	"A"
"TTCTGTAGTTCCCGGA-1"	"A"
"TTCTGTAGTTGTGAGG-1"	"G"
"TTCTGTAGTTTAAGCC-1"	"G"
"TTCTGTATCGGATGTT-1"	"A"
"TTCTGTATCGTTCAGA-1"	"A"
"TTCTGTATCTCTTAAC-1"	"A"
"TTCTGTATCTGACATG-1"	"G"
"TTCTGTATCTTCTCTC-1"	"A"
"TTGACGAAGGATGCCA-1"	"A"
"TTGACGAAGTCTCTAG-1"	"G"
"TTGACGAAGTGAGCTG-1"	"G"
"TTGACGACAACGTCGC-1"	"G"
"TTGACGACATATACGC-1"	"A"
"TTGACGACATCGGCCA-1"	"A"
"TTGACGAGTATCACAC-1"	"G"
"TTGACGAGTGTTTCTT-1"	"A"
"TTGACGATCAAGAGAT-1"	"G"
"TTGAGCAAGAGACTCG-1"	"A"
"TTGAGCAAGAGAGTTT-1"	"A"
"TTGAGCAAGCGCATTT-1"	"G"
"TTGAGCAAGTCACACT-1"	"G"
"TTGAGCAAGTCATCTG-1"	"G"
"TTGAGCAAGTCGCCTG-1"	"A"
"TTGAGCAAGTTCAAGA-1"	"G"
"TTGAGCACAAGACTAA-1"	"A"
"TTGAGCACATTTGGTG-1"	"A"
"TTGAGCAGTGAGTTGG-1"	"A"
"TTGAGCAGTTAACTCG-1"	"G"
"TTGAGCAGTTCTACCC-1"	"G"
"TTGAGTGAGAACCATA-1"	"G"
"TTGAGTGAGAATACTG-1"	"G"
"TTGAGTGAGCAGTAGC-1"	"A"
"TTGAGTGCACTCCCAT-1"	"A"
"TTGAGTGGTAATGCAA-1"	"A"
"TTGAGTGGTCAGCAAG-1"	"G"
"TTGAGTGGTTCTTTCA-1"	"G"
"TTGAGTGTCCAATAGC-1"	"A"
"TTGAGTGTCCAGGCCA-1"	"G"
"TTGAGTGTCCAGGGAA-1"	"A"
"TTGAGTGTCTCGTAGA-1"	"A"
"TTGAGTGTCTGAGTAC-1"	"G"
"TTGCACCAGGATATCA-1"	"A"
"TTGCACCCACCACCAG-1"	"G"
"TTGCACCCACGTTGTA-1"	"A"
"TTGCACCCATAGATAG-1"	"G"
"TTGCACCGTTCTGAAC-1"	"A"
"TTGCACCGTTGGCTAT-1"	"A"
"TTGCACCTCGGGCTCA-1"	"A"
"TTGCACCTCTACATCT-1"	"G"
"TTGCACCTCTTCCACG-1"	"A"
"TTGCACCTCTTTCGAT-1"	"A"
"TTGCAGAAGCTGAATA-1"	"A"
"TTGCAGAAGGTTGTGG-1"	"A"
"TTGCAGACATCCGTGG-1"	"A"
"TTGCAGAGTATCACAC-1"	"A"
"TTGCAGATCCCTACCA-1"	"A"
"TTGCAGATCCGGACTG-1"	"A"
"TTGCCCAAGAGAACCC-1"	"A"
"TTGCCCAAGGCCTAAG-1"	"G"
"TTGCCCAAGTTGGAAT-1"	"G"
"TTGCCCACAAAGCTTC-1"	"G"
"TTGCCCACAACTCAAC-1"	"A"
"TTGCCCACACAGTAGG-1"	"A"
"TTGCCCACACATATCG-1"	"A"
"TTGCCCAGTAACTGAA-1"	"G"
"TTGCCCAGTAGTTTGC-1"	"A"
"TTGCCCAGTATTCACG-1"	"G"
"TTGCCCAGTGGACCAA-1"	"G"
"TTGCCCAGTTCGGGAA-1"	"A"
"TTGCCCATCAGGTCTA-1"	"G"
"TTGCCCATCCGAGGAA-1"	"A"
"TTGCCCATCGTCCCTA-1"	"A"
"TTGCGAAAGACGCCAA-1"	"G"
"TTGCGAAAGCGTAGCA-1"	"G"
"TTGCGAACAAGCTTTG-1"	"A"
"TTGCGAACACGCGTTG-1"	"A"
"TTGCGAAGTCTCTGCT-1"	"G"
"TTGCGAAGTCTGTTGA-1"	"A"
"TTGCGAAGTGCCGGTT-1"	"A"
"TTGCGAAGTTCATTTC-1"	"A"
"TTGCGAATCACACGTA-1"	"G"
"TTGCGAATCCCTATTA-1"	"A"
"TTGCGAATCCTCCAGT-1"	"G"
"TTGCGGGAGACTTCCA-1"	"G"
"TTGCGGGAGCTGATTC-1"	"A"
"TTGCGGGAGGAAGAAC-1"	"G"
"TTGCGGGAGGATTAAC-1"	"A"
"TTGCGGGCAAGACTAA-1"	"G"
"TTGCGGGGTACAAATG-1"	"A"
"TTGCGGGGTATGGATA-1"	"A"
"TTGCGGGGTCTTAGCA-1"	"A"
"TTGCGGGGTGTCCCAG-1"	"G"
"TTGCGGGGTTCTGAAC-1"	"A"
"TTGCGGGTCAACACGT-1"	"A"
"TTGCGGGTCCATCATT-1"	"A"
"TTGCGGGTCGATATGC-1"	"G"
"TTGCGGGTCGCCGAAC-1"	"A"
"TTGCGGGTCTATTTCG-1"	"A"
"TTGCGGGTCTTCACTA-1"	"G"
"TTGCTATAGAAGCCTG-1"	"A"
"TTGCTATAGGCCTAAG-1"	"G"
"TTGCTATAGTCAGCCC-1"	"A"
"TTGCTATCAAATAGTG-1"	"G"
"TTGCTATCAAGGAAGA-1"	"A"
"TTGCTATGTACAAGCG-1"	"G"
"TTGCTATGTCAGACGA-1"	"A"
"TTGCTATGTCGTAGTT-1"	"A"
"TTGCTATGTGCATTCA-1"	"A"
"TTGCTATGTGCTGTGC-1"	"A"
"TTGCTATGTTCCATCC-1"	"A"
"TTGCTATGTTCCCTTG-1"	"A"
"TTGCTATTCACACGTA-1"	"A"
"TTGCTATTCCTGAAAC-1"	"A"
"TTGCTTAAGAAAGCAG-1"	"G"
"TTGCTTAAGGCTAAAT-1"	"G"
"TTGCTTAAGTGAGTGC-1"	"G"
"TTGCTTACAAATGCTC-1"	"A"
"TTGCTTACACCGTTGG-1"	"G"
"TTGCTTACAGTCCTGG-1"	"G"
"TTGCTTAGTAGAGAGA-1"	"G"
"TTGCTTAGTTCTTTCA-1"	"A"
"TTGCTTATCAGAGTGG-1"	"G"
"TTGCTTATCATACTTC-1"	"A"
"TTGGTCCAGAGTTCGG-1"	"G"
"TTGGTCCCACACATGT-1"	"A"
"TTGGTCCGTGAGCTAG-1"	"G"
"TTGGTCCGTGATGCTT-1"	"A"
"TTGGTCCGTTTCCACC-1"	"G"
"TTGGTCCGTTTCGACA-1"	"A"
"TTGGTCCTCCATACCC-1"	"G"
"TTGGTCCTCTACTGCC-1"	"A"
"TTGGTCCTCTCAGATG-1"	"G"
"TTGTCTAAGAAATACC-1"	"G"
"TTGTCTAAGGGCATTG-1"	"A"
"TTGTCTAAGGTACACG-1"	"A"
"TTGTCTACAAAGCATA-1"	"A"
"TTGTCTACACGGCCAT-1"	"A"
"TTGTCTACAGCGTGAA-1"	"A"
"TTGTCTACAGTATCTG-1"	"A"
"TTGTCTAGTAAACGTA-1"	"A"
"TTGTCTAGTATTCACG-1"	"G"
"TTGTCTAGTCATGAGG-1"	"G"
"TTGTCTAGTCGACTGC-1"	"A"
"TTGTCTAGTTTCTACT-1"	"A"
"TTGTCTATCACGTCAA-1"	"A"
"TTGTCTATCTCGACAA-1"	"G"
"TTGTCTATCTGAAAGA-1"	"G"
"TTGTCTATCTTATCAC-1"	"G"
"TTGTTCAAGAAATTCG-1"	"A"
"TTGTTCAAGACCCTAT-1"	"G"
"TTGTTCAAGACCTATC-1"	"G"
"TTGTTCAAGAGTGGTC-1"	"G"
"TTGTTCACAAACCTAC-1"	"A"
"TTGTTCACAATCACTG-1"	"A"
"TTGTTCACACGTTACA-1"	"A"
"TTGTTCACAGAACGAC-1"	"G"
"TTGTTCAGTAAGCCGA-1"	"A"
"TTGTTCAGTCCAACCG-1"	"G"
"TTGTTCAGTGATGCTT-1"	"A"
"TTGTTCAGTGCATTCA-1"	"A"
"TTGTTCATCACTAGGT-1"	"G"
"TTGTTCATCGAGAACG-1"	"A"
"TTGTTCATCGTCAACA-1"	"G"
"TTGTTCATCTCATATC-1"	"G"
"TTGTTGTAGATATGTG-1"	"G"
"TTGTTGTAGCCCATTA-1"	"A"
"TTGTTGTAGGCACCTC-1"	"G"
"TTGTTGTCAAGGATGC-1"	"A"
"TTGTTGTCAGAGCCAA-1"	"A"
"TTGTTGTCATGACTGT-1"	"G"
"TTGTTGTGTTTAGAAG-1"	"G"
"TTGTTGTTCGGTTGTA-1"	"A"
"TTGTTGTTCTATTTCG-1"	"A"
"TTTACGTAGCATTCCA-1"	"A"
"TTTACGTCATGGCCGT-1"	"G"
"TTTACGTGTGCAAAGC-1"	"G"
"TTTACGTGTTACCCAA-1"	"G"
"TTTACGTGTTCACGTA-1"	"G"
"TTTACGTTCAAAGTAG-1"	"A"
"TTTACGTTCTGATCCC-1"	"A"
"TTTGAGGAGAGGAACA-1"	"A"
"TTTGAGGAGCATTCCA-1"	"A"
"TTTGAGGAGGCTTTAC-1"	"A"
"TTTGAGGCACGCGCAT-1"	"G"
"TTTGAGGCATCGGCTG-1"	"G"
"TTTGAGGCATTTGGTG-1"	"G"
"TTTGAGGGTACTATGC-1"	"A"
"TTTGAGGGTAGTGATA-1"	"G"
"TTTGAGGGTGGAAAGA-1"	"A"
"TTTGAGGGTTTCGACA-1"	"A"
"TTTGAGGTCAAATGGA-1"	"G"
"TTTGAGGTCCCTACGT-1"	"A"
"TTTGAGGTCGAAGCCC-1"	"A"
"TTTGAGGTCGGGACAA-1"	"G"
"TTTGAGGTCGTATAGC-1"	"G"
"TTTGCGCAGAATACTG-1"	"A"
"TTTGCGCAGCTACGTT-1"	"A"
"TTTGCGCAGTTTACGC-1"	"G"
"TTTGCGCCAAACCGAG-1"	"A"
"TTTGCGCCAAATGTCC-1"	"A"
"TTTGCGCCACAAGTGG-1"	"A"
"TTTGCGCGTACTTGAC-1"	"G"
"TTTGCGCGTATTCTTC-1"	"A"
"TTTGCGCGTTAACCAC-1"	"A"
"TTTGCGCGTTAAGTCC-1"	"G"
"TTTGCGCGTTACGCTA-1"	"A"
"TTTGCGCTCACATTCT-1"	"A"
"TTTGCGCTCCAATCCC-1"	"G"
"TTTGCGCTCCATGACA-1"	"G"
"TTTGCGCTCCGTTTCG-1"	"G"
"TTTGCGCTCGCAACTA-1"	"A"
"TTTGCGCTCGGGCTCA-1"	"G"
"TTTGCGCTCTTGTGCC-1"	"G"
"TTTGGCCAGAGGTGGG-1"	"A"
"TTTGGCCAGCTATCGT-1"	"A"
"TTTGGCCAGGGCGAAG-1"	"G"
"TTTGGCCAGGGTTCTT-1"	"G"
"TTTGGCCAGGTTGTGG-1"	"A"
"TTTGGCCAGTGGTGTG-1"	"G"
"TTTGGCCCAAAGAAGG-1"	"A"
"TTTGGCCCAACAACTC-1"	"G"
"TTTGGCCCAAGGAGGG-1"	"G"
"TTTGGCCCAGGGTACA-1"	"G"
"TTTGGCCCATGGGTGA-1"	"G"
"TTTGGCCGTATTCTTC-1"	"G"
"TTTGGCCGTGAATGTA-1"	"A"
"TTTGGCCTCTTCTCTC-1"	"A"
"TTTGGTTAGCAGGAGG-1"	"G"
"TTTGGTTAGCGAGAAA-1"	"A"
"TTTGGTTAGGATGTCG-1"	"G"
"TTTGGTTAGTACCTCA-1"	"A"
"TTTGGTTCATGCCCTT-1"	"G"
"TTTGGTTCATTCACGA-1"	"G"
"TTTGGTTGTCAGAAAT-1"	"G"
"TTTGGTTGTCATGAGG-1"	"A"
"TTTGGTTGTGTACGCC-1"	"G"
"TTTGGTTTCACGATTG-1"	"G"
"TTTGGTTTCAGTTGAC-1"	"A"
"TTTGGTTTCCAGAATC-1"	"G"
"TTTGGTTTCCCGTATC-1"	"A"
"TTTGGTTTCCTCCATG-1"	"A"
"TTTGGTTTCGGGAAAC-1"	"A"
"TTTGTGTAGCAATGTA-1"	"G"
"TTTGTGTCACGTTACA-1"	"G"
"TTTGTGTCAGTCCTGG-1"	"A"
"TTTGTGTCATTACTCT-1"	"G"
"TTTGTGTGTAACTGAA-1"	"A"
"TTTGTGTGTCCAAGTT-1"	"G"
"TTTGTGTGTTTGCATG-1"	"G"
"TTTGTGTGTTTGCCAA-1"	"A"
"TTTGTGTTCCCGCAAG-1"	"A"
"TTTGTGTTCCGGAAAG-1"	"A"
"TTTGTGTTCGACCCGA-1"	"A"
"TTTGTGTTCGCCACTT-1"	"G"
"TTTGTGTTCGCGATGC-1"	"A"
"TTTGTGTTCTTATCAC-1"	"G"
