"AAACGAAAGCTGGAGT-1"	"A"
"AAACGAACAGGTCCTG-1"	"A"
"AAACGAAGTCCCTAAA-1"	"A"
"AAACGAATCCCACGGA-1"	"A"
"AAACGAATCCCATAGA-1"	"A"
"AAACGAATCCTGGGAC-1"	"A"
"AAACGAATCTCGGCGA-1"	"A"
"AAACTCGAGAACGACC-1"	"G"
"AAACTCGAGCACCATT-1"	"A"
"AAACTCGAGCTCCATA-1"	"A"
"AAACTCGAGGATTGCG-1"	"G"
"AAACTCGAGTAACTCC-1"	"A"
"AAACTCGCAAACCGAG-1"	"A"
"AAACTCGGTAGATTAG-1"	"A"
"AAACTCGTCTGTGTGA-1"	"A"
"AAACTCGTCTTGTCGC-1"	"A"
"AAACTGCAGCTCGGCT-1"	"G"
"AAACTGCAGTAGTTCC-1"	"A"
"AAACTGCCAATGACTC-1"	"G"
"AAACTGCCACTGTCGG-1"	"A"
"AAACTGCCATTGTGAC-1"	"A"
"AAACTGCGTAAACGGC-1"	"G"
"AAACTGCGTAAACGTA-1"	"G"
"AAACTGCGTCATCAAC-1"	"A"
"AAACTGCGTCCCGTGA-1"	"A"
"AAACTGCGTGCAAGCA-1"	"A"
"AAACTGCGTGCAGACA-1"	"A"
"AAACTGCGTTGGTAAA-1"	"G"
"AAACTGCTCAGGATCT-1"	"G"
"AAACTGCTCGACGGAA-1"	"A"
"AAAGATGAGACGAAAG-1"	"A"
"AAAGATGAGATCCGAG-1"	"A"
"AAAGATGAGCTAGTTC-1"	"G"
"AAAGATGAGTTACACC-1"	"A"
"AAAGATGCATGTAGAA-1"	"G"
"AAAGATGGTAGTCCAT-1"	"A"
"AAAGATGGTATTCGAC-1"	"A"
"AAAGATGGTTAGCTCA-1"	"G"
"AAAGATGTCCCATAGA-1"	"A"
"AAAGATGTCGAGAAGC-1"	"G"
"AAAGATGTCGATAGCT-1"	"A"
"AAAGATGTCGCTATTT-1"	"A"
"AAAGATGTCGCTTGAA-1"	"G"
"AAAGGATCAAGTCTGT-1"	"G"
"AAAGGATCACTAAACC-1"	"A"
"AAAGGATCAGCAGGTA-1"	"G"
"AAAGGATGTGCAAGAC-1"	"A"
"AAAGGATGTGTCCAGC-1"	"A"
"AAAGGATTCACGTCAA-1"	"A"
"AAAGGATTCGAGCGCT-1"	"G"
"AAAGGATTCGGGAAAC-1"	"G"
"AAAGGGCAGAACAGGA-1"	"A"
"AAAGGGCAGAGCTCCC-1"	"G"
"AAAGGGCAGGATCCTT-1"	"A"
"AAAGGGCAGGCACTAG-1"	"G"
"AAAGGGCAGGGAAGCG-1"	"A"
"AAAGGGCCAGTAACTC-1"	"G"
"AAAGGGCCATTGTTCT-1"	"A"
"AAAGGGCGTCAAACAA-1"	"A"
"AAAGGGCTCGGTTGTA-1"	"A"
"AAATGAGAGGGACGTT-1"	"G"
"AAATGAGAGTCATACC-1"	"G"
"AAATGAGAGTTCAACC-1"	"A"
"AAATGAGCACAAACGG-1"	"G"
"AAATGAGCATACCCGG-1"	"G"
"AAATGAGCATTACCTT-1"	"A"
"AAATGAGGTATTCGCA-1"	"A"
"AAATGAGGTGGAAAGA-1"	"A"
"AAATGAGGTTTGACCA-1"	"G"
"AAATGAGTCGCCTTAC-1"	"A"
"AAATGCCAGGGTAATT-1"	"G"
"AAATGCCCATTGCCTC-1"	"A"
"AAATGCCGTAAGCCTT-1"	"G"
"AAATGCCGTAGCGAGT-1"	"A"
"AAATGCCGTATGGTTC-1"	"G"
"AAATGCCGTATTCTCT-1"	"G"
"AAATGCCGTCGTAATC-1"	"A"
"AAATGCCGTGGGTAGT-1"	"G"
"AAATGCCTCCCGTATC-1"	"A"
"AAATGCCTCGTCTTAT-1"	"G"
"AAATGCCTCTCTGTTA-1"	"A"
"AAATGCCTCTGAGTCA-1"	"A"
"AACAAAGAGCATTGGG-1"	"G"
"AACAAAGCAGCAACCC-1"	"A"
"AACAAAGGTAACTCCA-1"	"A"
"AACAAAGGTGCTGAAG-1"	"G"
"AACAAAGGTGGACAGT-1"	"A"
"AACAAAGTCACAGGGA-1"	"G"
"AACAAAGTCACCCTTG-1"	"A"
"AACAAAGTCATGAACC-1"	"G"
"AACAAAGTCTGGCACG-1"	"A"
"AACAGTCAGCGCGTTC-1"	"G"
"AACAGTCAGTCATCTG-1"	"G"
"AACAGTCCAGAACAGC-1"	"A"
"AACAGTCGTACGGTTT-1"	"G"
"AACAGTCGTAGCAGCA-1"	"G"
"AACAGTCTCAGTGTGT-1"	"G"
"AACAGTCTCGGCTATA-1"	"A"
"AACAGTCTCTCTGCGT-1"	"G"
"AACAGTCTCTTGTACT-1"	"G"
"AACATCGAGACGTCAG-1"	"A"
"AACATCGAGGGTCTGA-1"	"A"
"AACATCGAGTAACTCC-1"	"A"
"AACATCGCAATGCACT-1"	"G"
"AACATCGCATGGCCCA-1"	"G"
"AACATCGGTAACGGAC-1"	"G"
"AACATCGGTTGCCGCA-1"	"A"
"AACATCGTCGAGCGCT-1"	"G"
"AACATCGTCGGTACTA-1"	"A"
"AACATCGTCGTTTGAG-1"	"A"
"AACATCGTCTGTGTGA-1"	"A"
"AACATCGTCTTAAGCG-1"	"A"
"AACCAACAGTATAGTG-1"	"A"
"AACCAACAGTGTCGGA-1"	"A"
"AACCAACCAAAGAAGG-1"	"G"
"AACCAACCAGCTGATT-1"	"A"
"AACCAACGTATACGCT-1"	"A"
"AACCAACGTCATTGGT-1"	"G"
"AACCAACTCCCACTAC-1"	"A"
"AACCAACTCCTTACGC-1"	"G"
"AACCAACTCTACTTTG-1"	"G"
"AACCGATAGACGTCAG-1"	"A"
"AACCGATCACCGAATT-1"	"G"
"AACCGATCATGGTAAA-1"	"G"
"AACCGATGTCTGTCCT-1"	"A"
"AACCGATGTTCTACCC-1"	"A"
"AACCGATTCGGGTCCA-1"	"A"
"AACCGATTCGTGGCGT-1"	"G"
"AACCTGACAAGGAACC-1"	"G"
"AACCTGACAGGGCTTC-1"	"A"
"AACCTGACATAGTCCA-1"	"A"
"AACCTGAGTCCTTATT-1"	"G"
"AACCTGAGTCTCTGGG-1"	"A"
"AACCTGAGTGCTTTGA-1"	"A"
"AACCTGAGTGGTACTT-1"	"A"
"AACCTGATCAGAACGG-1"	"G"
"AACCTGATCTCTGCAC-1"	"A"
"AACCTTTAGAGCTGTG-1"	"A"
"AACCTTTCAGTATCTG-1"	"A"
"AACCTTTCATCCATAG-1"	"G"
"AACCTTTGTACGCAAG-1"	"A"
"AACCTTTGTACTTCAG-1"	"G"
"AACCTTTGTCCATTGA-1"	"A"
"AACCTTTGTCGTAGTT-1"	"G"
"AACCTTTGTGATGCTT-1"	"A"
"AACCTTTGTTCCCAAA-1"	"G"
"AACGAGGAGCCTTTGA-1"	"G"
"AACGAGGAGGCAAGGG-1"	"G"
"AACGAGGAGTCACGCC-1"	"G"
"AACGAGGCAAATTGAG-1"	"A"
"AACGAGGCACCTGAAT-1"	"A"
"AACGAGGCATCATCGA-1"	"A"
"AACGAGGCATTACTCT-1"	"G"
"AACGAGGCATTTAGGC-1"	"G"
"AACGAGGGTGGTGGTA-1"	"A"
"AACGAGGGTTCTACCC-1"	"G"
"AACGAGGTCCAAGTCA-1"	"A"
"AACGAGGTCGCTATTT-1"	"A"
"AACGGGAAGGATGTCG-1"	"A"
"AACGGGACAACCTCCT-1"	"A"
"AACGGGACAATCAGGG-1"	"A"
"AACGGGACACACTAGT-1"	"G"
"AACGGGAGTTTCAGCA-1"	"A"
"AACGGGATCCTGGGAC-1"	"G"
"AACGGGATCCTTACGC-1"	"A"
"AACGGGATCGCCCTTA-1"	"A"
"AACGTACCACGCGTTG-1"	"G"
"AACGTACCATAGCCAT-1"	"A"
"AACGTACCATCAACTG-1"	"G"
"AACGTACCATGCGCTG-1"	"A"
"AACGTACGTAGAAAGG-1"	"A"
"AACGTACGTAGCGGTA-1"	"A"
"AACGTACGTGAATGGC-1"	"G"
"AACGTACGTGCAGACA-1"	"G"
"AACGTACGTTTAGAAG-1"	"A"
"AACGTACTCACCGCGA-1"	"A"
"AACGTACTCACGATTG-1"	"A"
"AACGTACTCCATACGA-1"	"A"
"AACGTACTCGACTATG-1"	"A"
"AACGTACTCGACTCGG-1"	"A"
"AACGTACTCTATCCTA-1"	"A"
"AACGTACTCTGATCTT-1"	"G"
"AACTGGTAGATGAGGA-1"	"A"
"AACTGGTAGCCTATAC-1"	"A"
"AACTGGTAGTTGACAA-1"	"G"
"AACTGGTCAGGTCTGC-1"	"G"
"AACTGGTGTAGCTGTT-1"	"A"
"AACTGGTGTCTCTGGG-1"	"G"
"AACTGGTGTGCTTACA-1"	"A"
"AACTGGTTCAAACCCA-1"	"A"
"AACTGGTTCAACGTGT-1"	"G"
"AACTGGTTCATGAACC-1"	"A"
"AACTGGTTCCAACCTC-1"	"G"
"AACTGGTTCTGCCGAG-1"	"A"
"AACTGTGAGCGCGTTC-1"	"G"
"AACTGTGAGTAACATG-1"	"G"
"AACTGTGAGTCGAGCA-1"	"A"
"AACTGTGCAAGTCCTA-1"	"A"
"AACTGTGGTTCAGAAA-1"	"A"
"AACTGTGTCAGTACAC-1"	"A"
"AACTGTGTCCGCCTAT-1"	"G"
"AACTGTGTCCTGAAAC-1"	"G"
"AACTGTGTCTGTCGGG-1"	"G"
"AACTTGGCAGGTTATC-1"	"A"
"AACTTGGTCCGAGGAA-1"	"A"
"AAGATAGAGGCGTCCT-1"	"G"
"AAGATAGAGGTGATGC-1"	"A"
"AAGATAGCAAGTAATG-1"	"A"
"AAGATAGCAGGCAGAT-1"	"G"
"AAGATAGCAGTAACCT-1"	"A"
"AAGATAGGTAGATGAT-1"	"A"
"AAGATAGGTTAGGCTT-1"	"A"
"AAGATAGTCGGTTAGT-1"	"G"
"AAGGAGCCACTCAGCG-1"	"G"
"AAGGAGCCAGTTCGGC-1"	"A"
"AAGGAGCCATCAGAAA-1"	"G"
"AAGGAGCGTAAGCCTT-1"	"A"
"AAGGAGCGTGAGAGTC-1"	"A"
"AAGGAGCGTTATCGAC-1"	"A"
"AAGGAGCTCCGGCGAT-1"	"G"
"AAGGAGCTCGCTATAG-1"	"G"
"AAGGTTCAGGAAGACA-1"	"G"
"AAGGTTCAGTGAAACT-1"	"A"
"AAGGTTCCACCTGAAT-1"	"A"
"AAGGTTCCAGTCCTGG-1"	"A"
"AAGGTTCGTAGCGAGT-1"	"G"
"AAGGTTCGTAGTCCAT-1"	"G"
"AAGGTTCGTCTGCACG-1"	"A"
"AAGGTTCGTGAATCGG-1"	"G"
"AAGGTTCGTGCCCTAG-1"	"A"
"AAGGTTCTCACGTGTA-1"	"G"
"AAGGTTCTCAGCACGC-1"	"G"
"AAGGTTCTCCAATAGC-1"	"G"
"AAGGTTCTCCCACGGA-1"	"A"
"AAGGTTCTCGTGTGCG-1"	"A"
"AATACGCAGAACGCCA-1"	"G"
"AATACGCAGTCTGCTA-1"	"G"
"AATACGCCAAGAGCGT-1"	"G"
"AATACGCCAATGTGCT-1"	"A"
"AATACGCCATCAGAAA-1"	"G"
"AATACGCCATGCGCTG-1"	"A"
"AATACGCGTAGCGGTA-1"	"A"
"AATACGCGTAGGTGAC-1"	"A"
"AATACGCGTGCCCAGT-1"	"G"
"AATACGCGTGCCCTAG-1"	"A"
"AATACGCTCACGTGTA-1"	"G"
"AATACGCTCTATATCC-1"	"G"
"AATGCCAAGAAATACC-1"	"A"
"AATGCCAAGATGGGAA-1"	"A"
"AATGCCAAGCATTCCA-1"	"G"
"AATGCCAAGCCGCAAA-1"	"A"
"AATGCCAAGTCTTAGC-1"	"A"
"AATGCCACAAGGAACC-1"	"G"
"AATGCCACACTGCTTC-1"	"A"
"AATGCCACAGAGCCAA-1"	"A"
"AATGCCACAGCAAACG-1"	"A"
"AATGCCACATTCGTCC-1"	"A"
"AATGCCAGTAGAACGC-1"	"A"
"AATGCCAGTCCCGTGA-1"	"A"
"AATGCCAGTGAATACA-1"	"A"
"AATGCCAGTGTCCCAG-1"	"A"
"AATGCCAGTTTGAAGA-1"	"A"
"AATGCCATCACCCGGA-1"	"G"
"AATGCCATCCCACTTG-1"	"A"
"AATGGAAAGACAACGC-1"	"G"
"AATGGAAAGACGTCAG-1"	"A"
"AATGGAAAGATCACCT-1"	"A"
"AATGGAAAGCGAGCTA-1"	"G"
"AATGGAAAGGCGTAGT-1"	"G"
"AATGGAAAGTCATACC-1"	"A"
"AATGGAACAAGCCAGA-1"	"A"
"AATGGAACATGACTGT-1"	"A"
"AATGGAACATGTCCCT-1"	"G"
"AATGGAAGTAACCGAG-1"	"G"
"AATGGAAGTGTAGGAC-1"	"A"
"AATGGAATCTATCCTA-1"	"A"
"AATGGAATCTCTGAGA-1"	"A"
"AATGGCTAGATCGATA-1"	"A"
"AATGGCTAGGTACTCT-1"	"A"
"AATGGCTAGTGAACCG-1"	"A"
"AATGGCTCAACGGACA-1"	"G"
"AATGGCTCAAGATGCG-1"	"A"
"AATGGCTCATGTATCG-1"	"G"
"AATGGCTGTCAACAGG-1"	"A"
"AATGGCTGTCCATTGA-1"	"A"
"AATGGCTTCCACACCT-1"	"G"
"AATGGCTTCTATATCC-1"	"G"
"AATGTCGCAATAGTGA-1"	"G"
"AATGTCGCACGATTAC-1"	"G"
"AATGTCGCACGCGACT-1"	"A"
"AATGTCGCAGCACATT-1"	"A"
"AATGTCGCAGGGCTTC-1"	"A"
"AATGTCGGTGAATACA-1"	"A"
"AATGTCGGTTCAGTAC-1"	"A"
"AATGTCGTCAAGAGGC-1"	"A"
"AATGTCGTCCGGCGAT-1"	"G"
"AATGTCGTCTATTTCG-1"	"A"
"AATGTCGTCTCGTGAA-1"	"G"
"ACAAACCAGAACTAAC-1"	"G"
"ACAAACCAGTGGTGTG-1"	"G"
"ACAAACCCAAACGACG-1"	"A"
"ACAAACCCAAGCAACG-1"	"A"
"ACAAACCCACTGTTAG-1"	"G"
"ACAAACCGTACCCACG-1"	"A"
"ACAAACCGTACGGATG-1"	"G"
"ACAAACCGTATCTGCA-1"	"G"
"ACAAACCGTCGTAGTT-1"	"A"
"ACAAACCTCGGCTATA-1"	"G"
"ACAAACCTCTGCTACC-1"	"G"
"ACAAAGAAGAAGCCGT-1"	"G"
"ACAAAGACACAAACAA-1"	"A"
"ACAAAGAGTACTATGC-1"	"A"
"ACAAAGAGTCAGACGA-1"	"G"
"ACAAAGAGTCGCTACG-1"	"A"
"ACAAAGATCAGCCGAC-1"	"G"
"ACAAAGATCAGGGTTT-1"	"A"
"ACAAAGATCGTCGCAG-1"	"A"
"ACAAGCTAGAGTCCGA-1"	"A"
"ACAAGCTAGCTCGTTA-1"	"G"
"ACAAGCTAGTCCGGAA-1"	"G"
"ACAAGCTCACCGAATT-1"	"G"
"ACAAGCTCACGACGAA-1"	"A"
"ACAAGCTCAGCAATGG-1"	"A"
"ACAAGCTCAGGTAGCA-1"	"A"
"ACAAGCTGTACGGTTT-1"	"G"
"ACAAGCTGTAGGGTTG-1"	"G"
"ACAAGCTGTTGCAGAG-1"	"A"
"ACAAGCTTCTCGTAGA-1"	"A"
"ACAATCGAGAGGTCCA-1"	"A"
"ACAATCGCACGACGAA-1"	"G"
"ACAATCGCACTGATAC-1"	"A"
"ACAATCGCAGCAACAG-1"	"G"
"ACAATCGCAGCTATAC-1"	"A"
"ACAATCGCATCGACGC-1"	"A"
"ACAATCGCATTACACG-1"	"A"
"ACAGAAAAGACTCTTG-1"	"A"
"ACAGAAAAGGGAAATG-1"	"A"
"ACAGAAAAGTCTCGAT-1"	"A"
"ACAGAAACAAGTCTCA-1"	"G"
"ACAGAAACAATAGCGG-1"	"A"
"ACAGAAACACTGAAGG-1"	"G"
"ACAGAAAGTAGAGAGA-1"	"G"
"ACAGAAAGTATACGCT-1"	"A"
"ACAGAAAGTTCTTTCA-1"	"A"
"ACAGAAATCCCACTTG-1"	"G"
"ACAGAAATCCTGTAGA-1"	"G"
"ACAGAAATCTATCCTA-1"	"G"
"ACAGACTAGAAATACC-1"	"A"
"ACAGACTAGAACGTTA-1"	"A"
"ACAGACTAGAGCTCCC-1"	"G"
"ACAGACTAGATCGAGC-1"	"A"
"ACAGACTAGTGGGACT-1"	"G"
"ACAGACTCAACGTCCG-1"	"G"
"ACAGACTCACATATCG-1"	"A"
"ACAGACTCACTCGCAG-1"	"A"
"ACAGACTGTCATTGCA-1"	"G"
"ACAGACTGTGGTACTT-1"	"G"
"ACAGACTTCACAACAC-1"	"G"
"ACAGACTTCTTGTGCC-1"	"G"
"ACAGCGCAGGCAGTAC-1"	"A"
"ACAGCGCAGTCGTATC-1"	"A"
"ACAGCGCAGTTGCTTG-1"	"G"
"ACAGCGCCAACTCCCT-1"	"G"
"ACAGCGCCAAGTAACA-1"	"G"
"ACAGCGCGTAGCATGG-1"	"G"
"ACAGCGCTCGGTCAGC-1"	"G"
"ACAGCGCTCGTATAGC-1"	"G"
"ACAGCGCTCTATAGGC-1"	"A"
"ACAGGCCAGGGTTCCC-1"	"A"
"ACAGGCCAGTGGACGT-1"	"A"
"ACAGGCCCAACACGGA-1"	"A"
"ACAGGCCCAAGTCTGT-1"	"G"
"ACAGGCCCACCTGTGG-1"	"G"
"ACAGGCCCAGTGCGAA-1"	"G"
"ACAGGCCCATCACAAC-1"	"A"
"ACAGGCCGTATCGCGC-1"	"G"
"ACAGGCCGTATTCTTC-1"	"G"
"ACAGGCCGTCTGCACG-1"	"A"
"ACAGGCCGTGTTGTTG-1"	"A"
"ACAGGCCTCAGGAAGC-1"	"G"
"ACAGGCCTCAGGAATA-1"	"G"
"ACAGGCCTCCCTATTA-1"	"G"
"ACAGGCCTCCTATCAT-1"	"G"
"ACAGGCCTCGCGTTCT-1"	"G"
"ACAGGCCTCTTCTCTC-1"	"A"
"ACATGCAAGAAAGGGT-1"	"G"
"ACATGCAAGAACGCCA-1"	"A"
"ACATGCAAGATTACGA-1"	"A"
"ACATGCAAGGGTGTTG-1"	"A"
"ACATGCACAGCTGATT-1"	"A"
"ACATGCACAGTAACCT-1"	"A"
"ACATGCACATTTAGGC-1"	"A"
"ACATGCAGTAATGTAG-1"	"A"
"ACATGCAGTATACGCT-1"	"G"
"ACATGCAGTTCCGGCA-1"	"A"
"ACATGCAGTTGGAGGT-1"	"A"
"ACATGCATCGCGGCAT-1"	"A"
"ACATGCATCGGCTATA-1"	"A"
"ACATGGTAGGAGTCTG-1"	"A"
"ACATGGTGTCTGTGTA-1"	"A"
"ACATGGTGTCTGTTGA-1"	"G"
"ACATGGTGTTTCAGCA-1"	"G"
"ACATGGTTCCGCTCTA-1"	"A"
"ACCAAACAGCTACGTT-1"	"A"
"ACCAAACAGTCCGATT-1"	"G"
"ACCAAACAGTGATATG-1"	"A"
"ACCAAACAGTTATGAG-1"	"G"
"ACCAAACGTGCACCCA-1"	"A"
"ACCAAACGTGGAAAGA-1"	"G"
"ACCAAACTCAGGTCTA-1"	"G"
"ACCAAACTCCAACCTC-1"	"G"
"ACCAAACTCCGTGCGA-1"	"A"
"ACCAAACTCGACTTAG-1"	"A"
"ACCAAACTCTACTGCC-1"	"A"
"ACCATCCCAACGGACA-1"	"G"
"ACCATCCCACAGATGG-1"	"A"
"ACCATCCCACCGAATT-1"	"A"
"ACCATCCCAGAAGTGC-1"	"A"
"ACCATCCGTAACTCCA-1"	"A"
"ACCATCCGTAATGCAA-1"	"A"
"ACCATCCGTCATAGAA-1"	"G"
"ACCATCCTCGGTGATT-1"	"G"
"ACCATCCTCTATGAGC-1"	"A"
"ACCATCCTCTCGTAGA-1"	"A"
"ACCATCCTCTGCTACC-1"	"G"
"ACCCAAAAGTAGAAGG-1"	"A"
"ACCCAAAAGTCCTTCC-1"	"G"
"ACCCAAACACACATGT-1"	"A"
"ACCCAAACACATTCTT-1"	"A"
"ACCCAAACACATTGCA-1"	"G"
"ACCCAAAGTATACGCT-1"	"A"
"ACCCAAAGTGCAAAGC-1"	"A"
"ACCCAAATCACAACAC-1"	"G"
"ACCCAAATCCTAGAGT-1"	"A"
"ACCCAAATCTCAGATG-1"	"G"
"ACCGAATAGAGGCCTA-1"	"A"
"ACCGAATAGCAGGACT-1"	"G"
"ACCGAATAGGAGTACC-1"	"A"
"ACCGAATAGGCTTAAA-1"	"G"
"ACCGAATCACTGCTCT-1"	"A"
"ACCGAATCAGCACATT-1"	"A"
"ACCGAATCAGGATAGC-1"	"G"
"ACCGAATGTAGCGGTA-1"	"G"
"ACCGAATGTCAACTGT-1"	"G"
"ACCGAATGTCACATTG-1"	"A"
"ACCGAATTCAGGCCGT-1"	"G"
"ACCGCAGAGAACCATA-1"	"A"
"ACCGCAGAGCATGATA-1"	"A"
"ACCGCAGCAAGTAACA-1"	"A"
"ACCGCAGCACTCCACT-1"	"A"
"ACCGCAGCAGAACTTC-1"	"G"
"ACCGCAGGTAATGTGA-1"	"G"
"ACCGCAGGTACTTCGA-1"	"G"
"ACCGCAGGTATTCTCT-1"	"G"
"ACCGCAGGTCTGCACG-1"	"A"
"ACCGCAGGTGCATCAT-1"	"A"
"ACCGCAGGTTACGCTA-1"	"A"
"ACCGCAGGTTGAAGCG-1"	"G"
"ACCGCAGTCACTACCC-1"	"A"
"ACCGCAGTCAGGATCT-1"	"A"
"ACCGCAGTCGGGAAAC-1"	"G"
"ACCGCAGTCTTAATCC-1"	"G"
"ACCGGGTAGATCTCAC-1"	"A"
"ACCGGGTAGGCAAGGG-1"	"G"
"ACCGGGTAGGTAGGCT-1"	"A"
"ACCGGGTAGTCTCGAT-1"	"A"
"ACCGGGTAGTGTCCCG-1"	"A"
"ACCGGGTCAACTCGAT-1"	"G"
"ACCGGGTCACAGGTAG-1"	"G"
"ACCGGGTCACTGAAGG-1"	"G"
"ACCGGGTCAGCAACGA-1"	"A"
"ACCGGGTCATTACTTC-1"	"G"
"ACCGGGTGTCAGAAGC-1"	"G"
"ACCGGGTGTCCTTATT-1"	"A"
"ACCGGGTTCGCGGCAT-1"	"G"
"ACCGGGTTCGGTCTAA-1"	"A"
"ACCTGCTAGAGGAACA-1"	"G"
"ACCTGCTAGTGAGCAC-1"	"A"
"ACCTGCTAGTGATAAC-1"	"A"
"ACCTGCTGTAATGCAA-1"	"A"
"ACCTGCTGTAGTAACA-1"	"A"
"ACCTGCTGTCTGTCCT-1"	"A"
"ACCTGCTGTGCACATT-1"	"A"
"ACCTGCTGTTATCGAC-1"	"A"
"ACCTGCTTCCAGGTCG-1"	"A"
"ACCTGCTTCCTAAGTG-1"	"A"
"ACCTGCTTCGAACCGC-1"	"G"
"ACCTGCTTCGCACCTT-1"	"A"
"ACCTGCTTCTCGTGAA-1"	"G"
"ACGGATTAGAAATGGG-1"	"G"
"ACGGATTAGCTAGTTC-1"	"A"
"ACGGATTCAATTGTGC-1"	"G"
"ACGGATTGTAAGTGCG-1"	"G"
"ACGGATTGTGCCGGTT-1"	"A"
"ACGGATTGTGGTCGAA-1"	"G"
"ACGGATTGTTCCATCC-1"	"G"
"ACGGATTTCCCACGGA-1"	"G"
"ACGGATTTCGATCGCG-1"	"G"
"ACGGATTTCGCCCTTA-1"	"A"
"ACGGATTTCTGTTTAC-1"	"G"
"ACGGATTTCTTATCAC-1"	"A"
"ACGTGGCAGGAGTAGA-1"	"A"
"ACGTGGCAGTGCTGAG-1"	"A"
"ACGTGGCCAAACAGTA-1"	"A"
"ACGTGGCGTAGAACGC-1"	"A"
"ACGTGGCGTCCAAGTT-1"	"A"
"ACGTGGCGTCCGTCGA-1"	"G"
"ACGTGGCGTGGACTGA-1"	"G"
"ACGTGGCGTTTGCCAA-1"	"A"
"ACGTGGCTCAAAGTAG-1"	"A"
"ACGTGGCTCGGTCTAA-1"	"G"
"ACGTTAGAGACCATAA-1"	"A"
"ACGTTAGAGCGCATTT-1"	"A"
"ACGTTAGAGTGCAACG-1"	"A"
"ACGTTAGAGTGTCGCC-1"	"A"
"ACGTTAGCAATCATCG-1"	"A"
"ACGTTAGGTCAATCCA-1"	"G"
"ACGTTAGTCAAGTTGC-1"	"A"
"ACGTTAGTCATTCTTG-1"	"A"
"ACGTTAGTCGTGGTAT-1"	"G"
"ACTAACGAGATCTAAG-1"	"G"
"ACTAACGAGCGTTGCC-1"	"G"
"ACTAACGAGTACCTCA-1"	"A"
"ACTAACGAGTCTGGGA-1"	"A"
"ACTAACGCATGCCTTC-1"	"G"
"ACTAACGGTAAACGAT-1"	"G"
"ACTAACGGTAGCAGCA-1"	"G"
"ACTAACGGTCAACTAC-1"	"G"
"ACTAACGGTGCAACAG-1"	"G"
"ACTAACGGTGGCATAG-1"	"A"
"ACTAACGTCCAAACCA-1"	"A"
"ACTACCCAGAAAGCAG-1"	"G"
"ACTACCCAGGCGACTA-1"	"A"
"ACTACCCAGGCTAAAT-1"	"A"
"ACTACCCAGTAATGTG-1"	"A"
"ACTACCCGTATGGTTC-1"	"G"
"ACTACCCGTCACAGTT-1"	"A"
"ACTACCCGTCGATAGG-1"	"G"
"ACTACCCGTGATAGAT-1"	"A"
"ACTACCCTCTATACCT-1"	"A"
"ACTACCCTCTATCTCA-1"	"G"
"ACTACGACACCGATCG-1"	"G"
"ACTACGACAGCCGAAA-1"	"G"
"ACTACGACAGGGTAAC-1"	"A"
"ACTACGAGTCAAACAA-1"	"A"
"ACTACGAGTGAATCGG-1"	"A"
"ACTACGATCATACTTC-1"	"A"
"ACTACGATCGTTCAGA-1"	"G"
"ACTACGATCTCTGAGA-1"	"A"
"ACTACGATCTTTCGAT-1"	"G"
"ACTAGGTAGACCTATC-1"	"A"
"ACTAGGTAGCAACTGG-1"	"A"
"ACTAGGTCAACAACTC-1"	"G"
"ACTAGGTCATGGAGGT-1"	"A"
"ACTAGGTCATTGAACC-1"	"G"
"ACTAGGTGTAACTGAA-1"	"G"
"ACTAGGTGTACCTATG-1"	"G"
"ACTAGGTGTGCTTTGA-1"	"A"
"ACTAGGTTCCGGCGAT-1"	"A"
"ACTAGGTTCTGGTACA-1"	"G"
"ACTAGGTTCTTTCGAT-1"	"G"
"ACTATTCAGCACACCC-1"	"A"
"ACTATTCAGCGTCAAG-1"	"G"
"ACTATTCAGGTTCGAG-1"	"G"
"ACTATTCAGTAGAAGG-1"	"A"
"ACTATTCCAGTCAGAG-1"	"A"
"ACTATTCGTTTGCGAT-1"	"G"
"ACTCGGGAGCCTTTGA-1"	"A"
"ACTCGGGCACATAAAG-1"	"A"
"ACTCGGGCAGTGCTCG-1"	"G"
"ACTCGGGGTAGGTAAT-1"	"A"
"ACTCGGGGTCTGATTG-1"	"G"
"ACTCGGGGTCTGTCCT-1"	"A"
"ACTCGGGGTTGCAGCC-1"	"G"
"ACTCGGGTCAGGGTTT-1"	"G"
"ACTCGGGTCCAAACCA-1"	"A"
"ACTCGGGTCCATTGAG-1"	"G"
"ACTCGGGTCCCGTAGG-1"	"G"
"ACTCGGGTCGCTCTAC-1"	"A"
"ACTCGGGTCGTTCAGA-1"	"A"
"ACTGCAAAGCTTACCA-1"	"A"
"ACTGCAACATCCATAG-1"	"A"
"ACTGCAAGTAGCTGTT-1"	"G"
"ACTGCAAGTGAATCAA-1"	"A"
"ACTGCAATCCATATCT-1"	"A"
"ACTGCAATCTGAACGT-1"	"A"
"ACTGCGGAGAGCTCCC-1"	"G"
"ACTGCGGAGCGCACAA-1"	"A"
"ACTGCGGAGGTCTTGT-1"	"A"
"ACTGCGGAGGTGAACC-1"	"G"
"ACTGCGGAGTTCGACT-1"	"G"
"ACTGCGGCAAGATGCG-1"	"G"
"ACTGCGGCAATTGCCA-1"	"A"
"ACTGCGGCACCGTCTT-1"	"G"
"ACTGCGGCACGACGAA-1"	"G"
"ACTGCGGCACGCTAAT-1"	"A"
"ACTGCGGCACTCGGAC-1"	"A"
"ACTGCGGCAGAACTTC-1"	"A"
"ACTGCGGCATCGACCG-1"	"G"
"ACTGCGGGTAGCGGTA-1"	"A"
"ACTGCGGGTGCTGTGC-1"	"A"
"ACTGCGGTCGCAACTA-1"	"A"
"ACTGCGGTCGCATACA-1"	"A"
"ACTGCGGTCGGTCTCT-1"	"A"
"ACTGCGGTCTTCCAGC-1"	"A"
"ACTGTCCAGAAAGCAG-1"	"A"
"ACTGTCCAGAATACTG-1"	"A"
"ACTGTCCAGACCATAA-1"	"G"
"ACTGTCCAGAGGTACC-1"	"G"
"ACTGTCCAGCAGTAGC-1"	"G"
"ACTGTCCAGCTGAATA-1"	"G"
"ACTGTCCCACGATATC-1"	"A"
"ACTGTCCGTGCCCGAT-1"	"A"
"ACTGTCCGTGCTTTGA-1"	"A"
"ACTGTCCTCACCACAA-1"	"A"
"ACTGTCCTCCGTTTCG-1"	"A"
"ACTTCCGAGAAAGCAG-1"	"G"
"ACTTCCGAGACCCTAT-1"	"G"
"ACTTCCGAGGCAGATC-1"	"G"
"ACTTCCGAGTAACACA-1"	"A"
"ACTTCCGCACGCGACT-1"	"A"
"ACTTCCGCATAAAGTG-1"	"A"
"ACTTCCGGTAGAACGC-1"	"G"
"ACTTCCGGTAGGTAAT-1"	"G"
"ACTTCCGTCAGCACTA-1"	"A"
"ACTTCCGTCTGACATG-1"	"A"
"ACTTTCACACCTATTT-1"	"A"
"ACTTTCAGTAGTATCC-1"	"A"
"ACTTTCAGTATCACAC-1"	"G"
"ACTTTCAGTCATAGAA-1"	"A"
"ACTTTCAGTGAGGGTT-1"	"A"
"ACTTTCAGTGCTGTGC-1"	"A"
"ACTTTCAGTGTACGCC-1"	"A"
"ACTTTCATCGGTTCCT-1"	"G"
"ACTTTCATCGTCGCAG-1"	"A"
"ACTTTCATCTAGCTGA-1"	"A"
"ACTTTCATCTGTGTGA-1"	"G"
"ACTTTCATCTTCACTA-1"	"A"
"AGACAAAAGCTAACAA-1"	"G"
"AGACAAAAGGCTAAAT-1"	"G"
"AGACAAACAACGGACA-1"	"A"
"AGACAAACAGCAACAG-1"	"A"
"AGACAAACAGCGTGAA-1"	"G"
"AGACAAACAGGAGCAT-1"	"A"
"AGACAAACAGTTGGAG-1"	"G"
"AGACAAACATGATTGC-1"	"G"
"AGACAAAGTCCTCAGG-1"	"A"
"AGACAAAGTGGAAGCT-1"	"A"
"AGACAAAGTTTCTACT-1"	"G"
"AGACAAAGTTTGCATG-1"	"A"
"AGACAAATCGTTGTTT-1"	"A"
"AGACAAATCTATTGTC-1"	"G"
"AGATAGAAGCCTTTGA-1"	"A"
"AGATAGACACACATTG-1"	"G"
"AGATAGACACTTACAG-1"	"G"
"AGATAGAGTCGAGGTA-1"	"G"
"AGATAGAGTCTAAAGA-1"	"G"
"AGATAGAGTGATAGAT-1"	"A"
"AGATAGAGTGGGTAGT-1"	"G"
"AGATAGATCCAACGCG-1"	"G"
"AGATTCGAGTCGTGAG-1"	"A"
"AGATTCGAGTGATTAG-1"	"G"
"AGATTCGAGTGGGACT-1"	"G"
"AGATTCGCAAGGACCA-1"	"G"
"AGATTCGCAGTTCGGC-1"	"A"
"AGATTCGCATCTCACC-1"	"G"
"AGATTCGGTAAGTCTC-1"	"A"
"AGATTCGGTAGAGAGA-1"	"G"
"AGATTCGGTAGGTAAT-1"	"A"
"AGATTCGGTCGATAGG-1"	"A"
"AGATTCGGTGTCCCAG-1"	"G"
"AGATTCGGTTGAAGCG-1"	"G"
"AGATTCGTCCAAGAGG-1"	"G"
"AGATTCGTCGAGGCTC-1"	"A"
"AGATTCGTCTGTCGGG-1"	"G"
"AGCCAGCAGATCGATA-1"	"G"
"AGCCAGCAGGTACACG-1"	"A"
"AGCCAGCCAAGGGAGG-1"	"A"
"AGCCAGCGTATGGATA-1"	"A"
"AGCCAGCGTGTCTACA-1"	"G"
"AGCCAGCGTTTCGATG-1"	"A"
"AGCCAGCTCCATACGA-1"	"G"
"AGCCAGCTCGATAGGG-1"	"A"
"AGCCAGCTCTTTATCG-1"	"G"
"AGCCCGAAGAGTAAGG-1"	"A"
"AGCCCGAAGCATTCCA-1"	"G"
"AGCCCGACAACGCAAG-1"	"A"
"AGCCCGACAAGCCTTA-1"	"A"
"AGCCCGACAATGATGA-1"	"G"
"AGCCCGACACAGTTAC-1"	"A"
"AGCCCGACATTTAGGC-1"	"A"
"AGCCCGAGTACCAAGG-1"	"A"
"AGCCCGAGTACCCACG-1"	"G"
"AGCCCGAGTCAGGTGA-1"	"A"
"AGCCCGAGTTATCGAC-1"	"A"
"AGCCCGATCAGTCTTT-1"	"G"
"AGCCCGATCCGGACTG-1"	"A"
"AGCCCGATCGAACCGC-1"	"G"
"AGCCCGATCGGCATAT-1"	"A"
"AGCCCGATCTAAACGC-1"	"G"
"AGCCCGATCTCTGCGT-1"	"G"
"AGCCGCAAGACCGCAA-1"	"G"
"AGCCGCAAGTGCAACG-1"	"A"
"AGCCGCACACCCTTAC-1"	"A"
"AGCCGCACAGGGTACA-1"	"G"
"AGCCGCAGTACGTATC-1"	"A"
"AGCCGCAGTAGTCTGT-1"	"G"
"AGCCGCAGTCGCTAGC-1"	"G"
"AGCCGCAGTGGACGAT-1"	"G"
"AGCCGCATCACTACCC-1"	"A"
"AGCCGCATCCGATTGA-1"	"A"
"AGCCGCATCTATCTTG-1"	"G"
"AGCCTCTAGAATCAGT-1"	"A"
"AGCCTCTAGCAGGACT-1"	"G"
"AGCCTCTCAAGCAGGT-1"	"A"
"AGCCTCTCACATTGCA-1"	"A"
"AGCCTCTCACTGGGCT-1"	"G"
"AGCCTCTCAGCCACGT-1"	"G"
"AGCCTCTCAGTGCGAA-1"	"A"
"AGCCTCTGTAACGGCA-1"	"G"
"AGCCTCTGTAGTCCAT-1"	"G"
"AGCCTCTGTGCTGTGC-1"	"G"
"AGCCTCTGTTTGTCTT-1"	"A"
"AGCCTCTTCCATAGGT-1"	"A"
"AGCCTGGAGTCTCCAA-1"	"A"
"AGCCTGGCATAGCCGC-1"	"A"
"AGCCTGGGTAGCATGG-1"	"A"
"AGCCTGGTCGGGACAA-1"	"G"
"AGCCTGGTCTAGCTGA-1"	"A"
"AGCCTTCAGATGGGAA-1"	"A"
"AGCCTTCAGTCAACTC-1"	"G"
"AGCCTTCCACAGTAGG-1"	"A"
"AGCCTTCCAGTTGCAT-1"	"A"
"AGCCTTCCATCACAAC-1"	"A"
"AGCCTTCGTAGGGTCA-1"	"G"
"AGCCTTCGTCGATAGG-1"	"A"
"AGCCTTCTCCAGTACA-1"	"G"
"AGCGATTAGGTCGTTT-1"	"A"
"AGCGATTAGTATAGTG-1"	"G"
"AGCGATTAGTGAGTGC-1"	"A"
"AGCGATTCAAGGGAGG-1"	"A"
"AGCGATTCAGATTAAG-1"	"A"
"AGCGATTGTAGAAGCC-1"	"A"
"AGCGATTGTGATAAGT-1"	"G"
"AGCGATTGTGCACATT-1"	"A"
"AGCGATTTCGACTTAG-1"	"G"
"AGCGATTTCTCTGAGA-1"	"G"
"AGCGTATAGAGAGTTT-1"	"A"
"AGCGTATAGCAACGGT-1"	"G"
"AGCGTATAGCATTCCA-1"	"A"
"AGCGTATAGTGTAATG-1"	"A"
"AGCGTATCACCGAATT-1"	"G"
"AGCGTATCACTGCTTC-1"	"A"
"AGCGTATGTTCCGGCA-1"	"A"
"AGCGTATTCGTGAACT-1"	"A"
"AGCGTGCAGATTGACA-1"	"A"
"AGCGTGCAGTATGGGC-1"	"A"
"AGCGTGCAGTGTAATG-1"	"A"
"AGCGTGCAGTTAGCGG-1"	"G"
"AGCGTGCCACCCTTAC-1"	"A"
"AGCGTGCCAGATTTGC-1"	"A"
"AGCGTGCCATCCCAAA-1"	"A"
"AGCGTGCGTAACGTAA-1"	"A"
"AGCGTGCTCCTCTCTT-1"	"A"
"AGCTATGAGAGGTCCA-1"	"A"
"AGCTATGAGGACTTTC-1"	"A"
"AGCTATGAGTACGACG-1"	"A"
"AGCTATGAGTCGATAA-1"	"A"
"AGCTATGAGTGCTGAG-1"	"G"
"AGCTATGAGTGTCACT-1"	"G"
"AGCTATGCAAGGAACC-1"	"A"
"AGCTATGCAGACCTGC-1"	"A"
"AGCTATGCAGCGTGAA-1"	"G"
"AGCTATGCAGTGCGAA-1"	"G"
"AGCTATGGTACTATGC-1"	"A"
"AGCTATGGTCGTAGTT-1"	"G"
"AGCTATGGTGGACAGT-1"	"G"
"AGCTATGGTTTAAGGA-1"	"G"
"AGCTATGTCATTCGGA-1"	"A"
"AGCTGATAGCGTCAAG-1"	"A"
"AGCTGATAGGCAGTAC-1"	"G"
"AGCTGATAGGCGTCCT-1"	"A"
"AGCTGATCATCCCTTG-1"	"G"
"AGCTGATGTACGGAGT-1"	"A"
"AGCTGATGTAGAATAC-1"	"A"
"AGCTGGCAGATTACGA-1"	"G"
"AGCTGGCAGGCACTAG-1"	"A"
"AGCTGGCAGGGACGTT-1"	"A"
"AGCTGGCAGGTCTTTG-1"	"A"
"AGCTGGCCACAAACAA-1"	"A"
"AGCTGGCCACCACGAC-1"	"G"
"AGCTGGCGTAGCGTTT-1"	"G"
"AGCTGGCTCAAGGCCC-1"	"A"
"AGCTGGCTCAGCCGGT-1"	"A"
"AGCTGGCTCCGATGCG-1"	"G"
"AGCTGGCTCGCCCTTA-1"	"A"
"AGCTGGCTCTGGAAGG-1"	"G"
"AGCTGTAAGGTTGTTC-1"	"G"
"AGCTGTAAGTACCCAT-1"	"G"
"AGCTGTAAGTAGTGTA-1"	"A"
"AGCTGTACAAGCCCTG-1"	"A"
"AGCTGTAGTGACCAGA-1"	"A"
"AGCTGTAGTGGACTGA-1"	"G"
"AGCTGTATCCCAGCAG-1"	"A"
"AGCTGTATCGCGTGAC-1"	"A"
"AGGACGAAGAGCCACA-1"	"G"
"AGGACGAAGGCCTCGT-1"	"A"
"AGGACGAAGTAACACA-1"	"G"
"AGGACGAAGTAACTCC-1"	"A"
"AGGACGACAAGGCGTA-1"	"G"
"AGGACGACAGTAACGG-1"	"G"
"AGGACGACATTAGCAC-1"	"A"
"AGGACGAGTTTGATCG-1"	"A"
"AGGACGATCATTCATC-1"	"A"
"AGGACGATCGTGGGTC-1"	"G"
"AGGACGATCGTGGTAT-1"	"G"
"AGGCCCAAGAGCTGTG-1"	"A"
"AGGCCCAAGGCGTAGT-1"	"G"
"AGGCCCAAGGTCGGTA-1"	"G"
"AGGCCCACATGGTATC-1"	"A"
"AGGCCCACATGTAGAA-1"	"A"
"AGGCCCAGTAAAGGCC-1"	"A"
"AGGCCCAGTAACTCCA-1"	"G"
"AGGCCCAGTACGCAAG-1"	"A"
"AGGCCCATCCTGTAGA-1"	"G"
"AGGCCCATCGTTGTTT-1"	"A"
"AGGCCCATCTCTATCA-1"	"G"
"AGGCCTGAGAGCCTGA-1"	"A"
"AGGCCTGAGCCATTCA-1"	"G"
"AGGCCTGCAAGCAACG-1"	"A"
"AGGCCTGCATTACACG-1"	"A"
"AGGCCTGGTTCTACCC-1"	"G"
"AGGCCTGTCACCACAA-1"	"A"
"AGGCCTGTCCGGCTGA-1"	"A"
"AGGCCTGTCCTCAAGA-1"	"G"
"AGGCCTGTCGATCGCG-1"	"G"
"AGGCCTGTCGCGCCAA-1"	"A"
"AGGCCTGTCGGTCCGA-1"	"A"
"AGGCCTGTCTGCCGAG-1"	"A"
"AGGCCTGTCTTGCGCT-1"	"G"
"AGGCGAAAGACAGTGC-1"	"G"
"AGGCGAAAGTCGGGAT-1"	"G"
"AGGCGAACAAGCGACA-1"	"A"
"AGGCGAACAAGTTGCT-1"	"A"
"AGGCGAACAGTAGTCT-1"	"A"
"AGGCGAAGTCTGGGCT-1"	"A"
"AGGCGAAGTTATGCAC-1"	"A"
"AGGCGAATCTAGCTGA-1"	"G"
"AGGCGAATCTCTCAAT-1"	"A"
"AGGCGTCAGTCCGTGC-1"	"A"
"AGGCGTCAGTCCTTCC-1"	"A"
"AGGCGTCCACATGATC-1"	"G"
"AGGCGTCCAGGGCTTC-1"	"G"
"AGGCGTCCAGTAACCT-1"	"A"
"AGGCGTCCATATTGGC-1"	"G"
"AGGCGTCGTAAACGGC-1"	"G"
"AGGCGTCGTAATGCAA-1"	"G"
"AGGCGTCGTACGTAAA-1"	"G"
"AGGCGTCGTACTTGAC-1"	"A"
"AGGCGTCGTCCGTGCA-1"	"G"
"AGGCGTCGTTGGGAAC-1"	"A"
"AGGCGTCGTTGTGAGG-1"	"G"
"AGGCGTCTCACCGCGA-1"	"A"
"AGGCGTCTCCGTTTCG-1"	"A"
"AGGCGTCTCTATAGGC-1"	"A"
"AGGCGTCTCTCCACTG-1"	"A"
"AGTCAACAGAACAGGA-1"	"G"
"AGTCAACAGCGTAGCA-1"	"A"
"AGTCAACAGGAAGACA-1"	"G"
"AGTCAACAGGATGCCA-1"	"A"
"AGTCAACAGTCTGCTA-1"	"G"
"AGTCAACCAAATTCCG-1"	"A"
"AGTCAACCAATTCGTG-1"	"A"
"AGTCAACCACCACAGC-1"	"G"
"AGTCAACGTAGTACAA-1"	"A"
"AGTCAACGTCCTTATT-1"	"G"
"AGTCAACGTTATAGAG-1"	"A"
"AGTCAACTCATCGCAA-1"	"G"
"AGTCAACTCTCTGCAC-1"	"A"
"AGTCCGGAGGATGTAT-1"	"A"
"AGTCCGGAGTGCCCTG-1"	"G"
"AGTCCGGCAAGCCCTG-1"	"G"
"AGTCCGGGTACGCCCA-1"	"A"
"AGTCCGGGTAGCTGTT-1"	"G"
"AGTCCGGGTCCCGTGA-1"	"G"
"AGTCCGGGTTACCCAA-1"	"G"
"AGTCCGGGTTCAGTAC-1"	"A"
"AGTCCGGGTTGTGACT-1"	"A"
"AGTCCGGTCGCCACTT-1"	"G"
"AGTCCGGTCTTTGCAT-1"	"G"
"AGTGCCGAGAGGTGGG-1"	"G"
"AGTGCCGAGCCTATAC-1"	"A"
"AGTGCCGAGGGTCTGA-1"	"A"
"AGTGCCGCAATACTGC-1"	"G"
"AGTGCCGCAGTAAGAT-1"	"A"
"AGTGCCGCAGTAGGCA-1"	"A"
"AGTGCCGCAGTGCGAA-1"	"A"
"AGTGCCGGTCAAATCC-1"	"G"
"AGTGCCGGTCATAAGA-1"	"G"
"AGTGCCGGTCGTAATC-1"	"A"
"AGTGCCGGTTTGTACG-1"	"A"
"AGTGCCGTCCAGAATC-1"	"A"
"AGTGCCGTCCGAGGAA-1"	"G"
"AGTGCCGTCCGTTAGA-1"	"G"
"AGTGCCGTCCGTTTCG-1"	"G"
"AGTGCCGTCCTGAAAC-1"	"A"
"AGTGCCGTCGTCTTAT-1"	"A"
"AGTGCGCAGCTGGAGT-1"	"G"
"AGTGCGCTCAAGAGAT-1"	"A"
"AGTGCGCTCATCGCAA-1"	"A"
"AGTGCGCTCGCGCCAA-1"	"A"
"AGTGCGCTCGCTTACC-1"	"A"
"AGTGCGCTCTCGACCT-1"	"A"
"AGTGTACAGAACTAAC-1"	"A"
"AGTGTACAGAAGGGCG-1"	"G"
"AGTGTACAGGATTTGA-1"	"G"
"AGTGTACCACTCGCAG-1"	"G"
"AGTGTACCATATAGAG-1"	"A"
"AGTGTACCATGCGACC-1"	"G"
"AGTGTACGTCACTCTC-1"	"A"
"AGTGTACGTGTCGTGC-1"	"A"
"AGTGTACGTTCAGTTG-1"	"A"
"AGTGTACTCCAAACCA-1"	"G"
"AGTTACGCAAATGTCC-1"	"G"
"AGTTACGCATCGCTAA-1"	"G"
"AGTTACGGTAGCATGG-1"	"A"
"AGTTACGGTTCCCGGA-1"	"A"
"AGTTACGTCACCCTTG-1"	"G"
"AGTTACGTCACTACCC-1"	"G"
"AGTTACGTCAGCCGGT-1"	"G"
"AGTTACGTCATTGCCC-1"	"G"
"AGTTACGTCGATCTTT-1"	"A"
"AGTTACGTCGCCTTAC-1"	"G"
"AGTTACGTCTCTCAAT-1"	"A"
"AGTTTGGAGAAATGGG-1"	"G"
"AGTTTGGAGGATGTCG-1"	"G"
"AGTTTGGAGGTTCTCA-1"	"G"
"AGTTTGGCACAAACAA-1"	"A"
"AGTTTGGCACTGAAGG-1"	"G"
"AGTTTGGCATTACACG-1"	"G"
"AGTTTGGGTATCTCAG-1"	"A"
"AGTTTGGGTGGACAGT-1"	"A"
"AGTTTGGGTTTGCCCT-1"	"A"
"AGTTTGGGTTTGTCTT-1"	"G"
"AGTTTGGTCGCGTGAC-1"	"A"
"AGTTTGGTCTAGCAGT-1"	"G"
"ATAGGCTAGGTACTCT-1"	"A"
"ATAGGCTAGGTGAACC-1"	"A"
"ATAGGCTGTAGCGGTA-1"	"A"
"ATAGGCTGTTGTCGGC-1"	"A"
"ATAGGCTTCAAAGTAG-1"	"G"
"ATAGGCTTCGCAAGCC-1"	"A"
"ATAGTCGAGAAAGGGT-1"	"G"
"ATAGTCGAGAGATTAC-1"	"G"
"ATAGTCGAGAGGTCCA-1"	"A"
"ATAGTCGAGGAACCGT-1"	"A"
"ATAGTCGAGTCTTAGC-1"	"A"
"ATAGTCGAGTTGCCGC-1"	"A"
"ATAGTCGGTATCCCTC-1"	"A"
"ATAGTCGGTGTGCTTA-1"	"G"
"ATAGTCGGTTGGCGAA-1"	"A"
"ATAGTCGTCTCAGATG-1"	"G"
"ATAGTCGTCTGGGCGT-1"	"G"
"ATATTCCAGCATGTGG-1"	"A"
"ATATTCCAGGGTAATT-1"	"G"
"ATATTCCCAGTAACCT-1"	"A"
"ATATTCCTCGCTCGGA-1"	"G"
"ATATTCCTCTATCTTG-1"	"A"
"ATCCAGAAGCCATGGA-1"	"A"
"ATCCAGAAGGCAGTAC-1"	"A"
"ATCCAGAAGTAGGAAG-1"	"G"
"ATCCAGACAAGGATGC-1"	"G"
"ATCCAGACATCCTCGT-1"	"A"
"ATCCAGAGTCTGGGAA-1"	"G"
"ATCCAGAGTGATCAGG-1"	"G"
"ATCCAGAGTGGCCTTG-1"	"A"
"ATCCAGATCAAGGCAG-1"	"A"
"ATCCAGATCCATCTAT-1"	"A"
"ATCCAGATCGCACCTT-1"	"G"
"ATCCCTGAGAGACTCG-1"	"G"
"ATCCCTGAGGCTTTAC-1"	"A"
"ATCCCTGAGGGTATCG-1"	"G"
"ATCCCTGAGTATGCTC-1"	"A"
"ATCCCTGAGTCACGCC-1"	"G"
"ATCCCTGCAATGGCTT-1"	"A"
"ATCCCTGCACAGGTAG-1"	"A"
"ATCCCTGCACATCATG-1"	"A"
"ATCCCTGCACCTGAAT-1"	"G"
"ATCCCTGGTAACTCCA-1"	"A"
"ATCCCTGGTACGCCCA-1"	"A"
"ATCCCTGGTACTTCAG-1"	"A"
"ATCCCTGGTATCAGCT-1"	"G"
"ATCCCTGGTGAGAGTC-1"	"A"
"ATCCCTGTCCAGAGAG-1"	"A"
"ATCCCTGTCCCACTTG-1"	"A"
"ATCCCTGTCCTAAGTG-1"	"G"
"ATCCCTGTCTCGTAGA-1"	"G"
"ATCCCTGTCTTACTCA-1"	"A"
"ATCCTCGAGAGAATTC-1"	"G"
"ATCCTCGAGTCATCTG-1"	"A"
"ATCCTCGCAAAGCATA-1"	"G"
"ATCCTCGGTAGCCATT-1"	"A"
"ATCCTCGGTCACATTG-1"	"A"
"ATCCTCGGTTGTCGGC-1"	"A"
"ATCCTCGTCAAACCCA-1"	"A"
"ATCCTCGTCGTCGCAG-1"	"A"
"ATCCTGCAGTGAGTGC-1"	"G"
"ATCCTGCCAAGACTTC-1"	"A"
"ATCCTGCCAAGTCTGT-1"	"G"
"ATCCTGCGTATTCGCA-1"	"G"
"ATCCTGCGTCATTGCA-1"	"A"
"ATCCTGCGTCCTTCAC-1"	"A"
"ATCCTGCTCGAAGCCC-1"	"A"
"ATCCTGCTCTACATCT-1"	"A"
"ATCGAGTAGCATTGGG-1"	"A"
"ATCGAGTAGCCATGGA-1"	"G"
"ATCGAGTAGCTGATTC-1"	"G"
"ATCGAGTAGGCCTCGT-1"	"G"
"ATCGAGTCATCGGCCA-1"	"G"
"ATCGAGTGTAAAGCTA-1"	"A"
"ATCGAGTTCAGATACC-1"	"A"
"ATGCATGAGACAACGC-1"	"A"
"ATGCATGAGACTCTTG-1"	"G"
"ATGCATGAGCTGAATA-1"	"A"
"ATGCATGAGGCAGATC-1"	"G"
"ATGCATGAGGGCGAAG-1"	"G"
"ATGCATGCAGCGTACC-1"	"A"
"ATGCATGGTGTCCCAG-1"	"G"
"ATGCATGGTTAGGCTT-1"	"A"
"ATGCATGTCGTGGTAT-1"	"A"
"ATGCATGTCTGGAAGG-1"	"A"
"ATGGATCAGGAGAACA-1"	"A"
"ATGGATCCACATGATC-1"	"G"
"ATGGATCCAGTCAGAG-1"	"A"
"ATGGATCGTATTCTGG-1"	"A"
"ATGGATCGTCGTAGTT-1"	"G"
"ATGGATCGTTGTATCG-1"	"G"
"ATGGATCTCCTTGACC-1"	"A"
"ATGGATCTCGACTATG-1"	"A"
"ATGTACGAGAGGAACA-1"	"A"
"ATGTACGCACACATTG-1"	"G"
"ATGTACGCATTAACGC-1"	"G"
"ATGTACGGTGCGTCCA-1"	"A"
"ATGTACGTCCCGGGTA-1"	"G"
"ATGTACGTCCGAATTG-1"	"G"
"ATGTACGTCGGTACTA-1"	"G"
"ATGTACGTCGGTCTCT-1"	"A"
"ATGTACGTCTGGAAGG-1"	"A"
"ATGTCGAAGAGGTACC-1"	"G"
"ATGTCGAAGCCTTTGA-1"	"G"
"ATGTCGAAGGATGCCA-1"	"G"
"ATGTCGAAGTTGTCCA-1"	"A"
"ATGTCGAGTGCGCTCA-1"	"G"
"ATGTCGAGTTCCAATG-1"	"A"
"ATGTCGATCAGTACAC-1"	"A"
"ATGTCGATCCCACGGA-1"	"A"
"ATGTCGATCGCGTGAC-1"	"A"
"ATGTCGATCGGGAAAC-1"	"A"
"ATGTCGATCGTGAGTT-1"	"A"
"ATGTCTTAGGAAGACA-1"	"A"
"ATGTCTTAGTCGAAAT-1"	"A"
"ATGTCTTAGTCGAGCA-1"	"A"
"ATGTCTTCAACTAGAA-1"	"A"
"ATGTCTTCACCTACCT-1"	"A"
"ATGTCTTCAGGTGTCC-1"	"A"
"ATGTCTTGTTCTGAAC-1"	"A"
"ATGTCTTTCAGTCAAC-1"	"G"
"ATGTCTTTCCGCTATC-1"	"G"
"ATGTCTTTCGGATCGC-1"	"G"
"ATGTCTTTCTCATATC-1"	"G"
"ATGTTTCAGAGTCCGA-1"	"A"
"ATGTTTCCAAGACTAA-1"	"G"
"ATGTTTCCACAAGGGT-1"	"G"
"ATGTTTCGTAACATAG-1"	"A"
"ATGTTTCGTACGTAGG-1"	"A"
"ATGTTTCTCAAACCAC-1"	"A"
"ATGTTTCTCAACGTGT-1"	"G"
"ATGTTTCTCGATCTTT-1"	"G"
"ATTACCTAGTAACATG-1"	"A"
"ATTACCTCACTCGGAC-1"	"G"
"ATTACCTCACTTTGGA-1"	"G"
"ATTACCTCATCCATAG-1"	"A"
"ATTACCTGTAGAGAGA-1"	"A"
"ATTACCTGTCACCCGA-1"	"A"
"ATTACCTGTCTCTGGG-1"	"G"
"ATTACCTGTGCTGAAG-1"	"G"
"ATTACCTGTGCTTGAT-1"	"G"
"ATTACCTTCAAACCAC-1"	"G"
"ATTACCTTCAGAACGG-1"	"A"
"ATTACCTTCTCGCGGA-1"	"A"
"ATTACTCAGACAGCTG-1"	"A"
"ATTACTCAGGAGGCGA-1"	"G"
"ATTACTCAGGCGATTG-1"	"G"
"ATTACTCAGTTACACC-1"	"A"
"ATTACTCCACCTGGTG-1"	"A"
"ATTACTCCATGTGGGA-1"	"A"
"ATTACTCGTCTGGTTA-1"	"G"
"ATTACTCGTGTACGCC-1"	"A"
"ATTACTCGTTGCCTGG-1"	"A"
"ATTACTCGTTTAGACC-1"	"G"
"ATTACTCTCAGTTGAC-1"	"G"
"ATTACTCTCGTGTGCG-1"	"A"
"ATTCGTTAGATTCCGT-1"	"A"
"ATTCGTTAGGGTATCG-1"	"A"
"ATTCGTTCAATGAAAC-1"	"G"
"ATTCGTTCAGACCTGC-1"	"A"
"ATTCGTTCAGAGAGAA-1"	"G"
"ATTCGTTCATGCACTA-1"	"G"
"ATTCGTTGTGGCATAG-1"	"G"
"ATTCGTTTCCACGGCA-1"	"G"
"ATTCGTTTCGCGCCAA-1"	"A"
"ATTCGTTTCGCGGCAT-1"	"A"
"ATTCGTTTCGGGTCCA-1"	"A"
"ATTGTCTAGGCGACTA-1"	"G"
"ATTGTCTCACACATGT-1"	"A"
"ATTGTCTCATCCGTGG-1"	"A"
"ATTGTCTGTAAAGCTA-1"	"A"
"ATTGTCTGTCCTTATT-1"	"A"
"ATTGTCTTCGCGTTCT-1"	"G"
"ATTGTCTTCGGTCAGC-1"	"A"
"ATTGTGGAGATGTTGA-1"	"G"
"ATTGTGGCAAAGGTCG-1"	"A"
"ATTGTGGCACCTGTGG-1"	"A"
"ATTGTGGCAGTTACAC-1"	"A"
"ATTGTGGCAGTTCGGC-1"	"G"
"ATTGTGGCATACCCGG-1"	"A"
"ATTGTGGCATCCTCGT-1"	"G"
"ATTGTGGGTCGACTGC-1"	"A"
"ATTGTGGGTGTCCAGC-1"	"A"
"ATTGTGGGTTAGGAAT-1"	"A"
"ATTGTGGGTTGCCTGG-1"	"A"
"ATTGTGGGTTGGACGA-1"	"G"
"ATTGTGGGTTGGCTAT-1"	"G"
"ATTGTGGTCATTCATC-1"	"A"
"ATTGTGGTCCGTCAAA-1"	"A"
"ATTTGTCAGAGGTCCA-1"	"A"
"ATTTGTCCATCGACCG-1"	"A"
"ATTTGTCCATTGAACC-1"	"A"
"ATTTGTCGTGGATTTC-1"	"A"
"ATTTGTCTCACATCCC-1"	"A"
"ATTTGTCTCAGCCGAC-1"	"A"
"ATTTGTCTCAGGCGCT-1"	"A"
"ATTTGTCTCCCTACGT-1"	"A"
"ATTTGTCTCGTGATAC-1"	"A"
"CAAAGCTCAAACGTTC-1"	"A"
"CAAAGCTCACCGTTGG-1"	"G"
"CAAAGCTGTACGGATG-1"	"A"
"CAAAGCTGTAGCGAGT-1"	"A"
"CAAAGCTGTATTCACG-1"	"A"
"CAAAGCTGTCAGGCTC-1"	"A"
"CAAAGCTGTGCATCAT-1"	"A"
"CAAAGCTGTGCCCGAT-1"	"A"
"CAAAGCTGTGCCCTAG-1"	"G"
"CAAAGCTGTTACCCAA-1"	"G"
"CAAAGCTTCGCACAAT-1"	"G"
"CAAAGCTTCTCTTAAC-1"	"G"
"CAAAGCTTCTGTTGCC-1"	"G"
"CAAAGCTTCTTATCAC-1"	"A"
"CAACCAAAGATTCCGT-1"	"G"
"CAACCAAAGGGTATCG-1"	"G"
"CAACCAACAACTTGGT-1"	"A"
"CAACCAACAGTAAGAT-1"	"G"
"CAACCAACAGTTAAAG-1"	"G"
"CAACCAAGTAACCCAT-1"	"A"
"CAACCAAGTGCCGGTT-1"	"G"
"CAACCAAGTTCTGAAC-1"	"A"
"CAACCAAGTTCTTTGT-1"	"A"
"CAACCAATCTCGCGTT-1"	"A"
"CAACCAATCTTGTCAT-1"	"G"
"CAACGGCAGAGCGGTT-1"	"A"
"CAACGGCAGTTCAACC-1"	"A"
"CAACGGCCACGTTACA-1"	"G"
"CAACGGCCAGAGATGC-1"	"G"
"CAACGGCCAGATAAGT-1"	"G"
"CAACGGCTCACCGCGA-1"	"G"
"CAACGGCTCAGCCGAC-1"	"A"
"CAACGGCTCAGGATCT-1"	"A"
"CAACGGCTCGAGTTAC-1"	"A"
"CAACGGCTCGGATGTT-1"	"A"
"CAACGGCTCGGGTCCA-1"	"A"
"CAACGTAAGACCGCAA-1"	"A"
"CAACGTAAGAGGAAGT-1"	"G"
"CAACGTAAGCGCACAA-1"	"G"
"CAACGTAAGGTCGGTA-1"	"A"
"CAACGTAAGTTCAAGA-1"	"G"
"CAACGTACAATGTAAG-1"	"A"
"CAACGTACAGGTGTGA-1"	"G"
"CAACGTAGTGCGCATC-1"	"G"
"CAACGTAGTTACGAAA-1"	"A"
"CAACGTAGTTCCTATT-1"	"A"
"CAACGTAGTTTAGGAA-1"	"A"
"CAACGTATCAAGGCCC-1"	"G"
"CAACGTATCCATTGAG-1"	"A"
"CAACGTATCTCGTGAA-1"	"G"
"CAAGAAAAGAATAGTC-1"	"A"
"CAAGAAAAGACTAGCG-1"	"G"
"CAAGAAAGTAGTTTGC-1"	"A"
"CAAGAAAGTCTGTTGA-1"	"G"
"CAAGCTAAGAACCATA-1"	"A"
"CAAGCTAAGCCATCAT-1"	"A"
"CAAGCTAAGGCATGCA-1"	"A"
"CAAGCTAAGGGTTCTT-1"	"G"
"CAAGCTAAGTAACTCC-1"	"A"
"CAAGCTAAGTTGTCCA-1"	"A"
"CAAGCTACACAAACGG-1"	"A"
"CAAGCTACATTGTGAC-1"	"G"
"CAAGCTAGTATCTGCA-1"	"A"
"CAAGCTAGTGAGCTAG-1"	"A"
"CAAGCTATCAAGAGGC-1"	"A"
"CAAGCTATCAGGCGCT-1"	"A"
"CAAGCTATCGACTTAG-1"	"G"
"CAAGCTATCGTTCAGA-1"	"A"
"CAAGGCCAGGATTAAC-1"	"A"
"CAAGGCCAGGTTGACG-1"	"A"
"CAAGGCCCAAACGACG-1"	"G"
"CAAGGCCCAATGACTC-1"	"A"
"CAAGGCCGTTCTCGAA-1"	"G"
"CAAGGCCGTTGGCTAT-1"	"G"
"CAAGGCCTCACTACCC-1"	"A"
"CAAGGCCTCCATAGGT-1"	"A"
"CAAGGCCTCGCATAAC-1"	"G"
"CAATCCCAGCGTTAGG-1"	"A"
"CAATCCCAGCTAGCAG-1"	"A"
"CAATCCCAGGTTCTCA-1"	"G"
"CAATCCCCAACGTAGG-1"	"A"
"CAATCCCGTCATAGAA-1"	"A"
"CAATCCCGTGGCCTCA-1"	"A"
"CAATCCCGTGTTGGTT-1"	"G"
"CAATCCCTCTTCAGAG-1"	"G"
"CAATCCCTCTTGTACT-1"	"A"
"CACAACAAGCATTCCA-1"	"G"
"CACAACAAGGCTGGAT-1"	"A"
"CACAACACAACTCGTA-1"	"A"
"CACAACACACGTTACA-1"	"G"
"CACAACACATATTGGC-1"	"G"
"CACAACAGTCGACTGC-1"	"A"
"CACAACAGTTCCCGGA-1"	"G"
"CACAACATCAATCGTG-1"	"A"
"CACAACATCCAAGTCA-1"	"A"
"CACAACATCGGGCTCA-1"	"A"
"CACAGATAGAAGCCTG-1"	"G"
"CACAGATAGAGGAACA-1"	"G"
"CACAGATAGCCTATAC-1"	"G"
"CACAGATAGGCTTAAA-1"	"G"
"CACAGATAGGGAAGCG-1"	"G"
"CACAGATGTAAGTCTC-1"	"A"
"CACAGATGTCCCGTGA-1"	"A"
"CACAGATGTTACCACA-1"	"G"
"CACAGATGTTAGCTCA-1"	"G"
"CACAGATGTTCCATCC-1"	"G"
"CACAGATGTTTGCGAT-1"	"A"
"CACAGATTCCTCTCTT-1"	"G"
"CACAGATTCGCGTGAC-1"	"A"
"CACAGATTCTCGTAGA-1"	"G"
"CACAGATTCTTAATCC-1"	"A"
"CACATGAAGCATTGGG-1"	"G"
"CACATGAAGCGAGAAA-1"	"A"
"CACATGACATTTCTTG-1"	"A"
"CACATGAGTCATCAAC-1"	"A"
"CACATGAGTGATAAGT-1"	"G"
"CACATGATCCTAAGTG-1"	"G"
"CACATGATCCTATCCG-1"	"G"
"CACATGATCGGTTGTA-1"	"G"
"CACCACTAGAGGAATG-1"	"A"
"CACCACTAGCCCATTA-1"	"A"
"CACCACTAGGATCCTT-1"	"G"
"CACCACTAGTCGACCC-1"	"G"
"CACCACTAGTCTCCAA-1"	"A"
"CACCACTCAACCTCCT-1"	"G"
"CACCACTCACATGATC-1"	"A"
"CACCACTCACGCGACT-1"	"G"
"CACCACTCATGTGGGA-1"	"G"
"CACCACTGTCATCAAC-1"	"A"
"CACCACTGTCCTATTT-1"	"G"
"CACCACTGTCGTAGTT-1"	"G"
"CACCACTGTTTCCTAT-1"	"G"
"CACCACTTCGATTACG-1"	"A"
"CACCACTTCGTCCCTA-1"	"A"
"CACCTGTAGAGCACTG-1"	"A"
"CACCTGTAGGTAGGCT-1"	"A"
"CACCTGTAGGTTAGTA-1"	"A"
"CACCTGTCAATTCAGC-1"	"A"
"CACCTGTCATAGATAG-1"	"G"
"CACCTGTCATGCTATG-1"	"A"
"CACCTGTGTGATAAGT-1"	"A"
"CACCTGTGTTTGCATG-1"	"A"
"CACCTGTTCGCAAGCC-1"	"G"
"CACCTGTTCGCTTCAC-1"	"G"
"CACCTGTTCGGCATAT-1"	"A"
"CACCTGTTCTGAAAGA-1"	"A"
"CACCTGTTCTTGTGCC-1"	"A"
"CACCTTGAGTGTTCCA-1"	"A"
"CACCTTGCACTAGCCG-1"	"A"
"CACCTTGCACTGTCAA-1"	"A"
"CACCTTGTCGCGTTCT-1"	"A"
"CACCTTGTCTGCGTCT-1"	"A"
"CACGTTCAGCGCCTAC-1"	"A"
"CACGTTCAGGCATGCA-1"	"G"
"CACGTTCAGTGAAACT-1"	"G"
"CACGTTCAGTTAGCAA-1"	"A"
"CACGTTCCAAGATTAG-1"	"A"
"CACGTTCCAAGCACTT-1"	"A"
"CACGTTCCACTCAAGT-1"	"A"
"CACGTTCGTCATCGTA-1"	"A"
"CACGTTCTCACACGTA-1"	"G"
"CACGTTCTCCAGGCCA-1"	"G"
"CACTAAGAGCAACTGG-1"	"A"
"CACTAAGAGTACAGAT-1"	"A"
"CACTAAGAGTCAGGAC-1"	"G"
"CACTAAGCAAACGTTC-1"	"A"
"CACTAAGCATTACTTC-1"	"A"
"CACTAAGGTAGCGTTT-1"	"A"
"CACTGAACAAGCGACA-1"	"G"
"CACTGAACACACTAGT-1"	"A"
"CACTGAACAGGTGTCC-1"	"G"
"CACTGAAGTCGCGCTA-1"	"G"
"CACTGAAGTTTGTCTT-1"	"G"
"CACTGAATCAAACCCA-1"	"A"
"CACTGAATCCCAATGA-1"	"A"
"CACTGAATCTCGACCT-1"	"G"
"CACTGAATCTGATCTT-1"	"A"
"CAGCCTTAGCAGGACT-1"	"A"
"CAGCCTTAGCGCATTT-1"	"A"
"CAGCCTTAGGAGGCGA-1"	"G"
"CAGCCTTAGTCATCTG-1"	"A"
"CAGCCTTAGTGCTGAG-1"	"A"
"CAGCCTTCAGAACTTC-1"	"G"
"CAGCCTTCAGTAACTC-1"	"G"
"CAGCCTTGTCATGAGG-1"	"G"
"CAGCCTTGTCCAACCG-1"	"G"
"CAGCCTTGTTCTACGA-1"	"A"
"CAGCCTTGTTGGCGAA-1"	"G"
"CAGCCTTTCTATAGGC-1"	"A"
"CAGCCTTTCTGATCTT-1"	"A"
"CAGCCTTTCTGGCGCA-1"	"G"
"CAGCTAAAGAAACGCC-1"	"A"
"CAGCTAACAACGAGGT-1"	"A"
"CAGCTAACAATGTGCT-1"	"A"
"CAGCTAACACTGATAC-1"	"A"
"CAGCTAAGTTCCAATG-1"	"G"
"CAGCTAATCGCACCTT-1"	"G"
"CAGCTAATCGCATACA-1"	"A"
"CAGCTGGAGGGTTCCC-1"	"G"
"CAGCTGGCAAAGGCCA-1"	"A"
"CAGCTGGCACGCGTTG-1"	"A"
"CAGCTGGCACTCAGCG-1"	"A"
"CAGCTGGCATAGCCGC-1"	"A"
"CAGCTGGCATCGTACA-1"	"A"
"CAGCTGGGTCGACTGC-1"	"G"
"CAGCTGGTCATCGCAA-1"	"A"
"CAGCTGGTCTAGCAGT-1"	"G"
"CAGCTGGTCTCATCCG-1"	"G"
"CAGGATTCAAGGCGTA-1"	"A"
"CAGGATTCACAGATGG-1"	"A"
"CAGGATTCACCTGTGG-1"	"G"
"CAGGATTGTATCTCAG-1"	"A"
"CAGGATTGTCTGGGCT-1"	"A"
"CAGGATTTCGATCTTT-1"	"G"
"CAGGGCTAGAATATCG-1"	"G"
"CAGGGCTAGAGAGGTA-1"	"G"
"CAGGGCTAGGCTTAAA-1"	"A"
"CAGGGCTAGGTAAGTT-1"	"A"
"CAGGGCTCAACGACAG-1"	"A"
"CAGGGCTCATCCTGGG-1"	"G"
"CAGGGCTGTACGCCCA-1"	"G"
"CAGGGCTGTAGCAGCA-1"	"G"
"CAGGGCTGTTCAGAAA-1"	"A"
"CAGGGCTTCAGAACGG-1"	"G"
"CAGGGCTTCCATACCC-1"	"G"
"CAGTATGAGCAGGAGG-1"	"G"
"CAGTATGAGCTGAGGT-1"	"G"
"CAGTATGAGGGAGATA-1"	"A"
"CAGTATGAGTTGCGCC-1"	"A"
"CAGTATGCACGATTAC-1"	"G"
"CAGTATGCAGCAAACG-1"	"A"
"CAGTATGCAGTAGGCA-1"	"G"
"CAGTATGCAGTGCGAA-1"	"G"
"CAGTATGCATTAACGC-1"	"G"
"CAGTATGGTCCCGAGT-1"	"A"
"CAGTATGGTCGAGGAT-1"	"A"
"CAGTATGGTGCGACCT-1"	"G"
"CAGTATGGTGCTTACA-1"	"A"
"CAGTATGGTTCTTAGG-1"	"A"
"CAGTATGGTTTCCACC-1"	"A"
"CAGTGCGAGAAATACC-1"	"G"
"CAGTGCGAGCTAGTTC-1"	"A"
"CAGTGCGAGTATGCTC-1"	"A"
"CAGTGCGAGTCGTATC-1"	"G"
"CAGTGCGCAGACTAAA-1"	"A"
"CAGTGCGCAGGGTACA-1"	"G"
"CAGTGCGCATGGCCTG-1"	"G"
"CAGTGCGGTGATAACA-1"	"A"
"CAGTGCGGTGTTAGAA-1"	"G"
"CAGTGCGGTTCCCAAA-1"	"A"
"CAGTGCGGTTTAGAAG-1"	"G"
"CAGTGCGGTTTGCCAA-1"	"G"
"CAGTGCGTCACCACAA-1"	"A"
"CAGTGCGTCATTGCCC-1"	"A"
"CAGTGCGTCCAACAAC-1"	"G"
"CAGTGTAAGCGTTAGG-1"	"G"
"CAGTGTAAGGCCTCGT-1"	"G"
"CAGTGTAAGTACAGTA-1"	"G"
"CAGTGTAAGTAGCAAT-1"	"A"
"CAGTGTAGTGTGAGGT-1"	"G"
"CAGTGTAGTTGTGACT-1"	"G"
"CAGTGTATCCGTCAAA-1"	"A"
"CAGTGTATCGTTCAGA-1"	"G"
"CATAACGAGCAGAATT-1"	"G"
"CATAACGAGTATGCTC-1"	"A"
"CATAACGAGTCAGCCC-1"	"G"
"CATAACGAGTTCAAGA-1"	"G"
"CATAACGCACCGATCG-1"	"A"
"CATAACGCACGCTAAT-1"	"A"
"CATAACGCATCACAGT-1"	"G"
"CATAACGCATGGTAAA-1"	"A"
"CATAACGGTATTGTGC-1"	"A"
"CATAACGGTCAATACC-1"	"A"
"CATAACGGTCCCGAGT-1"	"G"
"CATAACGGTCGCTAGC-1"	"G"
"CATAACGGTTAAGTCC-1"	"A"
"CATAACGGTTTGTGAC-1"	"A"
"CATAACGTCCAGGTCG-1"	"A"
"CATAACGTCGTCCCTA-1"	"G"
"CATGCCTAGAGGCGGA-1"	"G"
"CATGCCTAGGATTGCG-1"	"G"
"CATGCCTAGGTCCTCG-1"	"G"
"CATGCCTAGTAGTGTA-1"	"G"
"CATGCCTGTACGTAAA-1"	"G"
"CATGCCTGTATTGTCG-1"	"A"
"CATGCCTGTTAAGGGC-1"	"A"
"CATGCCTGTTGCTTGA-1"	"A"
"CATGCCTTCAGCCGGT-1"	"G"
"CATGCCTTCCGCGATG-1"	"A"
"CATGCCTTCCTCATTA-1"	"G"
"CATGCCTTCGCGCTGA-1"	"A"
"CATGCCTTCGCGTTCT-1"	"G"
"CATGCCTTCGTGAACT-1"	"A"
"CATGTTTAGAGGAACA-1"	"G"
"CATGTTTAGGAGTACC-1"	"G"
"CATGTTTAGTCCGGAA-1"	"G"
"CATGTTTGTAAAGGCC-1"	"G"
"CATGTTTGTACGGATG-1"	"A"
"CATGTTTGTTCCCAAA-1"	"A"
"CATGTTTTCACTTACT-1"	"G"
"CATGTTTTCGGTTAGT-1"	"A"
"CATGTTTTCGTCTAGA-1"	"A"
"CATGTTTTCTCTGCGT-1"	"G"
"CATGTTTTCTCTGTTA-1"	"G"
"CATGTTTTCTGGAAGG-1"	"A"
"CATTCATAGAACGCCA-1"	"A"
"CATTCATAGACACGGT-1"	"G"
"CATTCATAGGATATCA-1"	"A"
"CATTCATGTAGTACAA-1"	"G"
"CATTCATGTGATGCGA-1"	"A"
"CATTCATGTGCTGTCG-1"	"G"
"CATTCATGTGTCGTGC-1"	"G"
"CATTCATGTTGGCGAA-1"	"G"
"CATTCATTCTCTATCA-1"	"G"
"CATTCCGAGAGCTGTG-1"	"A"
"CATTCCGAGAGGTCCA-1"	"A"
"CATTCCGAGCGAGCTA-1"	"A"
"CATTCCGAGGCCAGTA-1"	"G"
"CATTCCGAGTAGGAAG-1"	"G"
"CATTCCGCAAGCAGGT-1"	"A"
"CATTCCGCACAAGTGG-1"	"G"
"CATTCCGCACCACCAG-1"	"A"
"CATTCCGGTAAACGTA-1"	"G"
"CATTCCGGTCCCTAAA-1"	"G"
"CATTCCGGTTTCCACC-1"	"G"
"CATTGGAAGAACAGGA-1"	"A"
"CATTGGAAGACAGCTG-1"	"A"
"CATTGGAAGCTACGTT-1"	"A"
"CATTGGAAGCTCGTTA-1"	"G"
"CATTGGAAGGCTGGAT-1"	"A"
"CATTGGAAGTCGATAA-1"	"G"
"CATTGGACAGCTTACA-1"	"G"
"CATTGGACATACAACC-1"	"G"
"CATTGGACATGGTATC-1"	"A"
"CATTGGAGTGCATTCA-1"	"G"
"CATTGGATCCGGAAAG-1"	"A"
"CATTGGATCTCAGATG-1"	"G"
"CATTGGATCTCGACCT-1"	"A"
"CATTGGATCTGACTTT-1"	"G"
"CCAATGAAGACAGCTG-1"	"G"
"CCAATGAAGAGCTCCC-1"	"A"
"CCAATGAAGATTACGA-1"	"A"
"CCAATGAAGCGGACAT-1"	"A"
"CCAATGAAGCTGAATA-1"	"A"
"CCAATGAAGGATTTGA-1"	"G"
"CCAATGACATTTCACT-1"	"A"
"CCAATGAGTATGAAGT-1"	"A"
"CCAATGAGTTCCAGTA-1"	"G"
"CCAATGATCCACTAGA-1"	"G"
"CCAATGATCTTCATAC-1"	"A"
"CCACAGGAGAGAATTC-1"	"A"
"CCACAGGAGGCGTAGT-1"	"A"
"CCACAGGCAACTCCCT-1"	"A"
"CCACAGGCAAGTGGCA-1"	"A"
"CCACAGGGTAACCGAG-1"	"A"
"CCACAGGGTAGGGTTG-1"	"G"
"CCACAGGTCCACGCTT-1"	"A"
"CCACAGGTCCCTATTA-1"	"A"
"CCACAGGTCGCCCTTA-1"	"A"
"CCACAGGTCTCTTCTC-1"	"A"
"CCACAGGTCTTGTCAT-1"	"A"
"CCACGTTAGAAGCCGT-1"	"A"
"CCACGTTAGGTTGTTC-1"	"G"
"CCACGTTCAACTCCCT-1"	"G"
"CCACGTTCATGGATGG-1"	"G"
"CCACGTTGTATCTGCA-1"	"A"
"CCACGTTGTCTGTGTA-1"	"G"
"CCACGTTGTTCTACCC-1"	"A"
"CCACGTTTCAATCGTG-1"	"G"
"CCACGTTTCAGTACAC-1"	"G"
"CCACGTTTCCGGACTG-1"	"G"
"CCACGTTTCGTGAGTT-1"	"A"
"CCACGTTTCGTTTGAG-1"	"G"
"CCAGAATCACCACAGC-1"	"A"
"CCAGAATCAGGTAGGT-1"	"A"
"CCAGAATCATCAACTG-1"	"A"
"CCAGAATGTCCGTGCA-1"	"A"
"CCAGAATTCCGGAAAG-1"	"A"
"CCAGAATTCGGTACTA-1"	"A"
"CCAGAATTCGTCCCTA-1"	"G"
"CCAGAATTCTCATCCG-1"	"A"
"CCAGAATTCTTTGCAT-1"	"A"
"CCAGATAAGCCTATAC-1"	"A"
"CCAGATAAGCGCGTTC-1"	"A"
"CCAGATAAGGTTCGAG-1"	"A"
"CCAGATACAACGCAAG-1"	"A"
"CCAGATACACTCCTCA-1"	"G"
"CCAGATAGTAGCTGTT-1"	"G"
"CCAGATAGTATGGGTG-1"	"A"
"CCAGATAGTATTGTGC-1"	"A"
"CCAGATAGTGCAACAG-1"	"G"
"CCAGATAGTGTAGGAC-1"	"G"
"CCAGATATCCCGATTC-1"	"G"
"CCAGATATCCGATTGA-1"	"A"
"CCATACCAGGCCAGTA-1"	"G"
"CCATACCAGTTCGCGC-1"	"A"
"CCATACCAGTTGCTTG-1"	"A"
"CCATACCCAAACGACG-1"	"A"
"CCATACCCAAGAGATT-1"	"A"
"CCATACCCAAGCTTTG-1"	"A"
"CCATACCCATTCACCC-1"	"A"
"CCATACCGTCAAACAA-1"	"A"
"CCATACCTCACTGATG-1"	"A"
"CCATACCTCGATATGC-1"	"G"
"CCATACCTCTCGCGGA-1"	"G"
"CCCACATAGCGATACG-1"	"A"
"CCCACATAGCGTATCT-1"	"A"
"CCCACATCACCACGAC-1"	"A"
"CCCACATCATAGACGG-1"	"G"
"CCCACATGTCCAGACC-1"	"A"
"CCCACATGTCTCTGCT-1"	"A"
"CCCACATTCAGCCGGT-1"	"A"
"CCCAGAGAGAACGCCA-1"	"A"
"CCCAGAGAGGTTAGTA-1"	"A"
"CCCAGAGCAGGCTACC-1"	"A"
"CCCAGAGCATCGTGAT-1"	"A"
"CCCAGAGGTAGTACAA-1"	"G"
"CCCAGAGGTCCTATTT-1"	"G"
"CCCAGAGGTGTACGCC-1"	"G"
"CCCAGAGGTTTCAGCA-1"	"A"
"CCCAGAGTCCCGATTC-1"	"A"
"CCCAGAGTCCTGAAAC-1"	"G"
"CCCGTTAAGAGGAAGT-1"	"A"
"CCCGTTACAAAGAAGG-1"	"A"
"CCCGTTACAAAGGCCA-1"	"A"
"CCCGTTACACCACCAG-1"	"A"
"CCCGTTACATTCACCC-1"	"A"
"CCCGTTAGTAGTATCC-1"	"G"
"CCCGTTAGTTGCAGAG-1"	"A"
"CCCGTTATCACCCTTG-1"	"A"
"CCCTAACAGATCTCAC-1"	"G"
"CCCTAACAGCCGCTGT-1"	"A"
"CCCTAACAGGTGTCGA-1"	"G"
"CCCTAACAGGTTAGTA-1"	"A"
"CCCTAACCACGCGACT-1"	"G"
"CCCTAACCATCAGAAA-1"	"A"
"CCCTAACGTTCCCAAA-1"	"A"
"CCCTAACGTTGGTAAA-1"	"A"
"CCCTAACTCACGATTG-1"	"A"
"CCCTAACTCTACCCGT-1"	"G"
"CCCTAACTCTTGTACT-1"	"G"
"CCCTAGTAGCCAGAAC-1"	"A"
"CCCTAGTAGGTAGGAA-1"	"G"
"CCCTAGTAGTTACCAC-1"	"A"
"CCCTAGTCAACGTAGG-1"	"A"
"CCCTAGTCAAGGGAGG-1"	"G"
"CCCTAGTCACGCTGTG-1"	"G"
"CCCTAGTCAGTGCGAA-1"	"G"
"CCCTAGTCATTGCGAT-1"	"G"
"CCCTAGTGTACAAGCG-1"	"G"
"CCCTAGTGTGTTTCTT-1"	"G"
"CCCTAGTTCCAGAATC-1"	"A"
"CCCTCTCAGAGTGGTC-1"	"G"
"CCCTCTCAGGCGATTG-1"	"A"
"CCCTCTCCAATGTGCT-1"	"A"
"CCCTCTCCAGAAGTGC-1"	"A"
"CCCTCTCCAGGTAGGT-1"	"A"
"CCCTCTCCAGTATCTG-1"	"A"
"CCCTCTCGTAGCAGGT-1"	"G"
"CCCTCTCGTAGCGAGT-1"	"A"
"CCCTCTCGTCAGGCTC-1"	"A"
"CCCTCTCGTGCTAGTT-1"	"G"
"CCCTCTCGTTATAGAG-1"	"G"
"CCCTCTCGTTCGGGAA-1"	"A"
"CCCTCTCTCAGCACGC-1"	"A"
"CCCTCTCTCCCACGGA-1"	"G"
"CCCTCTCTCGGCATAT-1"	"A"
"CCCTGATAGAACTCCT-1"	"G"
"CCCTGATAGGCAAGGG-1"	"A"
"CCCTGATAGGGCTTCC-1"	"G"
"CCCTGATCAAAGCATA-1"	"A"
"CCCTGATGTCATAGCT-1"	"A"
"CCCTGATTCCATACGA-1"	"A"
"CCCTGATTCTAGTCGA-1"	"A"
"CCCTGATTCTTAAGCG-1"	"A"
"CCGAAGCAGCATGTGG-1"	"A"
"CCGAAGCAGGAAACTT-1"	"A"
"CCGAAGCAGGAACCGT-1"	"A"
"CCGAAGCAGTCTGGGA-1"	"A"
"CCGAAGCCAAAGAGAG-1"	"A"
"CCGAAGCCAGGCATTT-1"	"A"
"CCGAAGCGTGGTCGAA-1"	"A"
"CCGAAGCTCACCCGGA-1"	"G"
"CCGAAGCTCGCATACA-1"	"G"
"CCGCATTCAAGATGCG-1"	"A"
"CCGCATTCAAGGTCGA-1"	"A"
"CCGCATTCAGAAAGAG-1"	"G"
"CCGCATTCAGGTAGCA-1"	"G"
"CCGCATTCATCATAGC-1"	"A"
"CCGCATTCATCGCTAA-1"	"G"
"CCGCATTGTGCTAGTT-1"	"G"
"CCGCATTGTGGACGAT-1"	"A"
"CCGCATTGTTACTTTC-1"	"G"
"CCGCATTTCGGTACTA-1"	"G"
"CCGCATTTCTCTGTTA-1"	"A"
"CCGCATTTCTTCCGTG-1"	"A"
"CCGTACTAGCTGAAAT-1"	"G"
"CCGTACTAGGAATGGA-1"	"G"
"CCGTACTAGGACTTTC-1"	"A"
"CCGTACTAGGCACCTC-1"	"A"
"CCGTACTAGGGAAGCG-1"	"G"
"CCGTACTAGTGTGTAA-1"	"G"
"CCGTACTCAACCTCTC-1"	"A"
"CCGTACTCACCACCAG-1"	"G"
"CCGTACTCAGGTAACG-1"	"G"
"CCGTACTGTACGCAAG-1"	"G"
"CCGTACTTCCCAATGA-1"	"G"
"CCGTACTTCTTCGTTA-1"	"A"
"CCGTAGGCATAGCAGG-1"	"A"
"CCGTAGGGTCAGGTGA-1"	"G"
"CCGTAGGGTCGCTAGC-1"	"A"
"CCGTAGGGTGAATGGC-1"	"A"
"CCGTAGGGTTAAGGGC-1"	"G"
"CCGTAGGGTTTAAGCC-1"	"A"
"CCGTAGGTCCACGGCA-1"	"A"
"CCGTAGGTCCTCCAGT-1"	"A"
"CCGTAGGTCGTGAACT-1"	"A"
"CCGTGAGAGAGGAACA-1"	"A"
"CCGTGAGCAAGTGGCA-1"	"G"
"CCGTGAGCACGTACAT-1"	"G"
"CCGTGAGCAGTCAGCC-1"	"A"
"CCGTGAGGTAACACTC-1"	"A"
"CCGTGAGGTGGCCTCA-1"	"A"
"CCGTGAGTCCAAGAGG-1"	"A"
"CCGTGAGTCGGAAAGC-1"	"A"
"CCGTGAGTCGGTCTCT-1"	"G"
"CCGTGAGTCTGAGTAC-1"	"A"
"CCTAAAGAGAACGCCA-1"	"A"
"CCTAAAGAGAACGTTA-1"	"G"
"CCTAAAGAGCTACGTT-1"	"G"
"CCTAAAGAGTATACCC-1"	"A"
"CCTAAAGAGTCCCTCT-1"	"G"
"CCTAAAGCAACTCGAT-1"	"A"
"CCTAAAGCACACATTG-1"	"G"
"CCTAAAGGTGGGTAGT-1"	"G"
"CCTAAAGTCAGTGTGT-1"	"G"
"CCTAAAGTCGCCCTTA-1"	"G"
"CCTAAAGTCTCTGAGA-1"	"A"
"CCTATTAAGACGCCAA-1"	"A"
"CCTATTAAGACTAGGC-1"	"G"
"CCTATTACAATGTGCT-1"	"A"
"CCTATTACAGAGAGAA-1"	"A"
"CCTATTACATGTGGGA-1"	"A"
"CCTATTAGTACGGAGT-1"	"A"
"CCTATTAGTCACTCTC-1"	"G"
"CCTATTAGTCTGGGAA-1"	"A"
"CCTATTAGTTGGTAAA-1"	"A"
"CCTATTATCACTAGCA-1"	"G"
"CCTATTATCCTCCCAA-1"	"G"
"CCTATTATCGAGAAGC-1"	"G"
"CCTATTATCGATAGGG-1"	"G"
"CCTCCCTAGAGTTCGG-1"	"A"
"CCTCCCTAGGGAGATA-1"	"G"
"CCTCCCTCAAGGGTAC-1"	"A"
"CCTCCCTCACAGCCAC-1"	"G"
"CCTCCCTCACGTACAT-1"	"A"
"CCTCCCTCATAAAGTG-1"	"G"
"CCTCCCTGTATTCTCT-1"	"G"
"CCTCCCTGTGGTACTT-1"	"A"
"CCTCCCTGTGTCGTCG-1"	"A"
"CCTCCCTGTTACGCTA-1"	"A"
"CCTCCCTGTTTGCCCT-1"	"A"
"CCTCCCTTCCATAACG-1"	"G"
"CCTCCCTTCGGTGATT-1"	"A"
"CCTCCCTTCTAGCTGA-1"	"G"
"CCTGCTAAGACCCATT-1"	"G"
"CCTGCTAAGCGAGAAA-1"	"A"
"CCTGCTAAGTGAGTTA-1"	"G"
"CCTGCTAAGTGTCGGA-1"	"A"
"CCTGCTAAGTTACACC-1"	"A"
"CCTGCTACAGGCTACC-1"	"G"
"CCTGCTACATGGCCGT-1"	"A"
"CCTGCTAGTCATAGAA-1"	"A"
"CCTGCTAGTTTGAAGA-1"	"G"
"CCTGCTATCACCCTTG-1"	"A"
"CCTGCTATCCCAGCAG-1"	"G"
"CCTGCTATCTTTGCAT-1"	"G"
"CCTGGGAAGACACGGT-1"	"A"
"CCTGGGAAGCCTCGCA-1"	"A"
"CCTGGGAAGGAGAACA-1"	"A"
"CCTGGGACAAACCTAC-1"	"A"
"CCTGGGACAACCTCTC-1"	"G"
"CCTGGGACACACTAGT-1"	"A"
"CCTGGGACACGTACAT-1"	"A"
"CCTGGGACAGCAATGG-1"	"G"
"CCTGGGACAGGCAGAT-1"	"G"
"CCTGGGAGTGAATGGC-1"	"G"
"CCTGGGAGTGCTTCCT-1"	"A"
"CCTGGGAGTTCTCGAA-1"	"A"
"CCTGGGAGTTCTGATG-1"	"G"
"CCTGGGATCAGTGGTT-1"	"G"
"CCTGGGATCTCGGCGA-1"	"A"
"CCTTAATAGGGTAATT-1"	"G"
"CCTTAATAGTGTCACT-1"	"A"
"CCTTAATCAAGGAAGA-1"	"G"
"CCTTAATCAAGTCTGT-1"	"G"
"CCTTAATCACCCTTTG-1"	"G"
"CCTTAATCATTAGCAC-1"	"A"
"CCTTAATGTATTCACG-1"	"A"
"CCTTAATGTGAATGTA-1"	"G"
"CCTTAATTCAAATGGA-1"	"A"
"CCTTAATTCAGGTTTG-1"	"G"
"CCTTAATTCCTCAAGA-1"	"A"
"CCTTAATTCGTCCCAT-1"	"A"
"CCTTGCAAGTACCACT-1"	"A"
"CCTTGCAAGTTATGAG-1"	"A"
"CCTTGCAAGTTGCTTG-1"	"A"
"CCTTGCACACCACGAC-1"	"G"
"CCTTGCACACGACGAA-1"	"A"
"CCTTGCACATTCACCC-1"	"A"
"CCTTGCAGTCATTGCA-1"	"A"
"CCTTGCAGTGCATCAT-1"	"G"
"CCTTGCATCACACGTA-1"	"G"
"CCTTGCATCGCTCGGA-1"	"A"
"CCTTGCATCTATCTCA-1"	"G"
"CCTTGCATCTCGCGTT-1"	"A"
"CCTTGGTAGAGTGGAA-1"	"A"
"CCTTGGTAGGTAGGAA-1"	"A"
"CCTTGGTAGTGATATG-1"	"G"
"CCTTGGTAGTTCCCGG-1"	"A"
"CCTTGGTCAAACCGAG-1"	"A"
"CCTTGGTCAAATGCTC-1"	"G"
"CCTTGGTCAGCTATAC-1"	"A"
"CCTTGGTCAGTAACGG-1"	"A"
"CCTTGGTCATCACAGT-1"	"A"
"CCTTGGTCATTTAGGC-1"	"G"
"CCTTGGTGTTAACCAC-1"	"G"
"CCTTGGTTCCGGGCAT-1"	"A"
"CCTTGGTTCGACTTAG-1"	"A"
"CCTTGGTTCTTCCACG-1"	"A"
"CGAGTTAAGGCACTAG-1"	"G"
"CGAGTTAAGGGACGTT-1"	"G"
"CGAGTTAAGGTGTCGA-1"	"G"
"CGAGTTACAGTCAGCC-1"	"G"
"CGAGTTACATCAGAAA-1"	"A"
"CGAGTTAGTAGGTGAC-1"	"A"
"CGAGTTAGTGAATCAA-1"	"A"
"CGAGTTATCCCAGCGA-1"	"G"
"CGAGTTATCTCCCTTT-1"	"G"
"CGATGATAGCCAGAAC-1"	"G"
"CGATGATAGCTCGGCT-1"	"G"
"CGATGATAGTGCAACG-1"	"A"
"CGATGATCACCATTCC-1"	"A"
"CGATGATCACCTGAAT-1"	"G"
"CGATGATGTATTCACG-1"	"A"
"CGATGATGTCCAAGTT-1"	"G"
"CGATGATTCCACACCT-1"	"A"
"CGATGATTCCAGGTAT-1"	"A"
"CGATGATTCGTCTAGA-1"	"G"
"CGATGATTCTTCCACG-1"	"A"
"CGCAATAAGATGAGGA-1"	"A"
"CGCAATAAGCAGAAAG-1"	"A"
"CGCAATAAGTGCCCTG-1"	"G"
"CGCAATAAGTGTCGGA-1"	"A"
"CGCAATAAGTTACCAC-1"	"G"
"CGCAATAAGTTCTCCC-1"	"A"
"CGCAATACAAGCAACG-1"	"G"
"CGCAATACACTGTTAG-1"	"A"
"CGCAATACATCGACGC-1"	"G"
"CGCAATAGTTAGGAGC-1"	"A"
"CGCAATAGTTGCAGAG-1"	"A"
"CGCAATATCTGATCCC-1"	"A"
"CGCACAGAGAGCTCCC-1"	"G"
"CGCACAGAGATATGAC-1"	"G"
"CGCACAGAGCGGACAT-1"	"A"
"CGCACAGAGTTTGGAA-1"	"G"
"CGCACAGCATTGAACC-1"	"G"
"CGCACAGGTAGAACGC-1"	"A"
"CGCACAGGTATCTAGC-1"	"G"
"CGCACAGGTTATGCAC-1"	"G"
"CGCACAGGTTTGTACG-1"	"A"
"CGCACAGTCACAAGCT-1"	"G"
"CGCACAGTCATAGGTC-1"	"A"
"CGCACAGTCATGCTTT-1"	"A"
"CGCACAGTCCCATAGA-1"	"G"
"CGCACAGTCCCTACGT-1"	"A"
"CGCACAGTCGCTTGAA-1"	"A"
"CGCACAGTCTGTTGCC-1"	"A"
"CGCAGGTAGAATCAGT-1"	"A"
"CGCAGGTAGAGCGGTT-1"	"A"
"CGCAGGTAGTACAGAT-1"	"A"
"CGCAGGTCAAGCCAGA-1"	"A"
"CGCAGGTCAATGGCAG-1"	"A"
"CGCAGGTCACTGTAAC-1"	"G"
"CGCAGGTCAGATTTGC-1"	"A"
"CGCAGGTCATCCATAG-1"	"G"
"CGCAGGTCATCGAGTT-1"	"G"
"CGCAGGTCATGGAGGT-1"	"A"
"CGCAGGTCATTGTTCT-1"	"A"
"CGCAGGTGTAGCGTTT-1"	"G"
"CGCAGGTGTTTAGACC-1"	"A"
"CGCAGGTTCCCGGGTA-1"	"G"
"CGCGCAAAGACGCCAA-1"	"A"
"CGCGCAAGTGCTTACA-1"	"A"
"CGCGCAAGTGTGAGGT-1"	"G"
"CGCGCAAGTTGTGACT-1"	"A"
"CGCGCAATCACAAGCT-1"	"G"
"CGCGCAATCCCAGTAA-1"	"G"
"CGCGCAATCCGCGATG-1"	"A"
"CGCGCAATCTCGGCGA-1"	"G"
"CGCGCAATCTTAGTGG-1"	"G"
"CGCGCAATCTTGTACT-1"	"G"
"CGCTAGGAGAAGAGTG-1"	"A"
"CGCTAGGAGTCGCCTG-1"	"A"
"CGCTAGGCATGGATGG-1"	"G"
"CGCTAGGGTCGCGCTA-1"	"A"
"CGCTAGGGTCTGTTGA-1"	"A"
"CGCTAGGGTTCTACGA-1"	"A"
"CGCTAGGTCGATGAAA-1"	"G"
"CGCTATCAGCAGAAAG-1"	"A"
"CGCTATCAGGTTGACG-1"	"G"
"CGCTATCCAAAGCATA-1"	"G"
"CGCTATCCACACATGT-1"	"G"
"CGCTATCCACTCGCAG-1"	"G"
"CGCTATCGTAAAGGCC-1"	"G"
"CGCTATCGTAACGGTG-1"	"A"
"CGCTATCGTAACTGAA-1"	"A"
"CGCTATCGTACGACCC-1"	"G"
"CGCTATCGTTCTTATC-1"	"A"
"CGCTATCGTTGTCGGC-1"	"A"
"CGCTATCTCACAGGGA-1"	"G"
"CGCTATCTCCGGGCAT-1"	"A"
"CGCTATCTCGAACCGC-1"	"A"
"CGCTATCTCGTTACAG-1"	"G"
"CGCTATCTCTTAAGCG-1"	"A"
"CGCTGGAAGAGAACCC-1"	"A"
"CGCTGGAAGTGCTGAG-1"	"A"
"CGCTGGACAAAGCATA-1"	"A"
"CGCTGGACAAATGTCC-1"	"A"
"CGCTGGACATGGCCCA-1"	"A"
"CGCTGGACATTTGGTG-1"	"G"
"CGCTGGAGTAAACGGC-1"	"A"
"CGCTGGAGTACTTGAC-1"	"G"
"CGCTGGAGTAGAGAGA-1"	"A"
"CGCTGGAGTAGATGAT-1"	"A"
"CGCTGGAGTCTGAGCC-1"	"A"
"CGCTGGAGTCTGGGCT-1"	"A"
"CGGACCAAGGCTGGAT-1"	"A"
"CGGACCAAGGTTAGTA-1"	"G"
"CGGACCACAGAAGTGC-1"	"A"
"CGGACCAGTAGAAAGG-1"	"G"
"CGGACCAGTCAGGTGA-1"	"G"
"CGGACCAGTGGGTAGT-1"	"A"
"CGGACCATCTCTTCTC-1"	"A"
"CGGACCATCTTCGTTA-1"	"A"
"CGGACTGAGACTAGGC-1"	"G"
"CGGACTGAGCAGAATT-1"	"G"
"CGGACTGAGTGTCGGA-1"	"A"
"CGGACTGCAATGACTC-1"	"A"
"CGGACTGCACACACAT-1"	"A"
"CGGACTGCAGGTGTGA-1"	"G"
"CGGACTGCAGTCAGCC-1"	"A"
"CGGACTGCATTGCACA-1"	"G"
"CGGACTGGTAAACCCT-1"	"A"
"CGGACTGGTAGCGAGT-1"	"A"
"CGGACTGTCCGTACGG-1"	"A"
"CGGACTGTCGAGTTAC-1"	"G"
"CGGACTGTCTCGCGTT-1"	"A"
"CGGTGCAAGCCTTTGA-1"	"G"
"CGGTGCAAGGCCAATG-1"	"G"
"CGGTGCAAGTAGTGTA-1"	"A"
"CGGTGCAAGTCCCTCT-1"	"G"
"CGGTGCAAGTCTAGAA-1"	"G"
"CGGTGCAAGTGCTGAG-1"	"A"
"CGGTGCACAACTACTG-1"	"A"
"CGGTGCACACCCATCT-1"	"A"
"CGGTGCACAGTTGCAT-1"	"A"
"CGGTGCACATCCCGGA-1"	"A"
"CGGTGCACATGCTATG-1"	"G"
"CGGTGCAGTACGGATG-1"	"A"
"CGGTGCAGTGGTTCTA-1"	"A"
"CGGTGCAGTTGTATCG-1"	"G"
"CGGTGCATCGTCAACA-1"	"A"
"CGTAAACAGACCCTAT-1"	"A"
"CGTAAACAGAGCTGTG-1"	"G"
"CGTAAACAGATGAGGA-1"	"G"
"CGTAAACAGATTGACA-1"	"A"
"CGTAAACAGGTCTTGT-1"	"G"
"CGTAAACAGTAACACA-1"	"A"
"CGTAAACAGTGATATG-1"	"A"
"CGTAAACAGTTCAAGA-1"	"A"
"CGTAAACCAAACCCTA-1"	"A"
"CGTAAACCACGCTCAG-1"	"G"
"CGTAAACCAGAACGAC-1"	"A"
"CGTAAACCAGCCACGT-1"	"G"
"CGTAAACCAGTAGTTC-1"	"G"
"CGTAAACCATATTGGC-1"	"A"
"CGTAAACGTCCAAGAG-1"	"G"
"CGTAAACGTCCTCAGG-1"	"A"
"CGTAAACGTGTTGTTG-1"	"A"
"CGTAAACGTTAACTCG-1"	"A"
"CGTAAACGTTAGTAGA-1"	"A"
"CGTAAACTCTGGCACG-1"	"G"
"CGTACAACACGATTAC-1"	"A"
"CGTACAACACGCGACT-1"	"G"
"CGTACAACATTCCCGT-1"	"G"
"CGTACAAGTACAACGG-1"	"A"
"CGTACAAGTTTCACCC-1"	"G"
"CGTACAATCCATCTAT-1"	"G"
"CGTACAATCCGCTATC-1"	"A"
"CGTACAATCCGTGCAG-1"	"A"
"CGTACAATCTCGCGTT-1"	"A"
"CGTGGCAAGAACGTTA-1"	"A"
"CGTGGCAAGATCGAGC-1"	"A"
"CGTGGCAAGCACACCC-1"	"A"
"CGTGGCAAGCAGGACT-1"	"G"
"CGTGGCACAAGTTCGT-1"	"G"
"CGTGGCACAGTCAGAG-1"	"G"
"CGTGGCACATGGTAAA-1"	"G"
"CGTGGCACATGTAGAA-1"	"G"
"CGTGGCACATTTAGGC-1"	"G"
"CGTGGCAGTACGGTTT-1"	"G"
"CGTGGCAGTACGTAAA-1"	"A"
"CGTGGCAGTGTGACCC-1"	"A"
"CGTGGCAGTTAGAGAT-1"	"A"
"CGTGGCATCCCGATTC-1"	"A"
"CGTTCCAAGAGATTAC-1"	"A"
"CGTTCCAAGCGCCTAC-1"	"A"
"CGTTCCAAGCTGGAGT-1"	"A"
"CGTTCCAAGGTTTCTG-1"	"A"
"CGTTCCAAGTTGAATG-1"	"A"
"CGTTCCACATAGACGG-1"	"A"
"CGTTCCAGTACGTAAA-1"	"G"
"CGTTCCAGTGGTAGAC-1"	"A"
"CGTTCCAGTTGCAGCC-1"	"G"
"CGTTCCATCGCTCGGA-1"	"G"
"CGTTCCATCGTTCAGA-1"	"G"
"CGTTCCATCTATATCC-1"	"A"
"CTAACTTAGGCTCCTG-1"	"A"
"CTAACTTGTACTTGAC-1"	"G"
"CTAACTTGTCAACTGT-1"	"G"
"CTAACTTGTGCCGGTT-1"	"G"
"CTAACTTTCATTCTCA-1"	"A"
"CTAACTTTCCCAGCGA-1"	"G"
"CTACAGAAGGCAGATC-1"	"A"
"CTACAGACAAAGGCCA-1"	"G"
"CTACAGACACGGTTAT-1"	"G"
"CTACAGACATACAACC-1"	"A"
"CTACAGAGTAGCATGG-1"	"G"
"CTACAGAGTATTCTTC-1"	"G"
"CTACAGAGTTTGCCAA-1"	"A"
"CTACAGATCCTCCCAA-1"	"A"
"CTACAGATCCTTCGAC-1"	"A"
"CTACAGATCTGTCGGG-1"	"G"
"CTACTTAAGATTAGAC-1"	"G"
"CTACTTAAGCAACGGT-1"	"G"
"CTACTTAAGTGAGTTA-1"	"G"
"CTACTTACAAGGAACC-1"	"G"
"CTACTTACAATGGTAA-1"	"G"
"CTACTTACATCAACTG-1"	"A"
"CTACTTAGTTCCAGTA-1"	"A"
"CTACTTATCCAACAAC-1"	"A"
"CTACTTATCCTATCAT-1"	"G"
"CTAGCGGAGAAATGGG-1"	"G"
"CTAGCGGAGGAGGCGA-1"	"G"
"CTAGCGGAGGCTTCGC-1"	"A"
"CTAGCGGAGGTTACAA-1"	"G"
"CTAGCGGAGTAACACA-1"	"G"
"CTAGCGGAGTACAGAT-1"	"A"
"CTAGCGGAGTGTGTAA-1"	"A"
"CTAGCGGCACCACGAC-1"	"A"
"CTAGCGGCACCTATTT-1"	"G"
"CTAGCGGGTCGTAGTT-1"	"A"
"CTAGCGGGTCTAACCA-1"	"A"
"CTAGCGGTCACATTCT-1"	"A"
"CTAGCGGTCCAAGAGG-1"	"A"
"CTAGGATAGCAGAGCT-1"	"A"
"CTAGGATAGCATGTGG-1"	"G"
"CTAGGATAGCTCGGCT-1"	"A"
"CTAGGATAGTCGACCC-1"	"G"
"CTAGGATCAATGATGA-1"	"A"
"CTAGGATCACAGCTTA-1"	"G"
"CTAGGATCATGGCCCA-1"	"A"
"CTAGGATGTGTCTACA-1"	"G"
"CTAGGATTCAGGTCTA-1"	"A"
"CTAGGATTCCCGAAGC-1"	"G"
"CTAGGATTCGGTACTA-1"	"A"
"CTAGGGCAGAAGAGTG-1"	"G"
"CTAGGGCAGTGCTAGG-1"	"G"
"CTAGGGCCAAAGGCCA-1"	"A"
"CTAGGGCCAACACGGA-1"	"A"
"CTAGGGCCAGGCACAA-1"	"G"
"CTAGGGCCATACCCGG-1"	"G"
"CTAGGGCCATCCATAG-1"	"G"
"CTAGGGCGTGCAACAG-1"	"A"
"CTAGGGCTCGGATGTT-1"	"G"
"CTCAACCAGAGCTCCC-1"	"A"
"CTCAACCAGGCCTAAG-1"	"A"
"CTCAACCAGGGTTCCC-1"	"A"
"CTCAACCAGGTTCGAG-1"	"G"
"CTCAACCCAATGCACT-1"	"A"
"CTCAACCCACATTCTT-1"	"G"
"CTCAACCCATTCCCGT-1"	"A"
"CTCAACCGTCATAGCT-1"	"A"
"CTCAACCGTGTCTCGG-1"	"A"
"CTCAACCGTTAGTAGA-1"	"G"
"CTCAACCTCTTTATCG-1"	"G"
"CTCACCAAGCGTGTTT-1"	"G"
"CTCACCAAGCTACGCC-1"	"A"
"CTCACCACATGGAGGT-1"	"A"
"CTCACCAGTCATTGCA-1"	"G"
"CTCACCAGTTAGAGAT-1"	"A"
"CTCACCAGTTCTTTCA-1"	"A"
"CTCACCAGTTGGCTAT-1"	"G"
"CTCACCATCCTTACGC-1"	"A"
"CTCACCATCGGTAGGA-1"	"G"
"CTCAGAAAGGCTTCGC-1"	"A"
"CTCAGAACAAAGAAGG-1"	"A"
"CTCAGAACAAAGACGC-1"	"A"
"CTCAGAACACTACACA-1"	"G"
"CTCAGAAGTATGGGTG-1"	"G"
"CTCAGAAGTATGGTTC-1"	"A"
"CTCAGAAGTCTCTGGG-1"	"G"
"CTCAGAAGTGCTGTGC-1"	"G"
"CTCAGAATCGTCTAGA-1"	"G"
"CTCAGAATCTCCCTTT-1"	"A"
"CTCAGAATCTCCTTAA-1"	"G"
"CTCAGCTAGAGTGGTC-1"	"G"
"CTCAGCTAGATATGTG-1"	"G"
"CTCAGCTAGCTATCCA-1"	"A"
"CTCAGCTAGTACAACA-1"	"A"
"CTCAGCTCAAGCACTT-1"	"G"
"CTCAGCTCAATCCATG-1"	"G"
"CTCAGCTCAATGGTCT-1"	"G"
"CTCAGCTCATAGGCGA-1"	"G"
"CTCAGCTGTGTTAGAA-1"	"A"
"CTCAGCTTCGACGGAA-1"	"A"
"CTCAGCTTCGGGCTCA-1"	"A"
"CTCATGCAGTGCTCGC-1"	"G"
"CTCATGCCAAATGCTC-1"	"A"
"CTCATGCCAATGGTCT-1"	"A"
"CTCATGCCATTGTTCT-1"	"A"
"CTCATGCGTCTGTGTA-1"	"A"
"CTCATGCGTGAAACAT-1"	"G"
"CTCATGCGTTCACGTA-1"	"G"
"CTCATGCGTTCTTATC-1"	"G"
"CTCATGCTCGTTGTAG-1"	"A"
"CTCATGCTCTGAGTCA-1"	"G"
"CTCCCAAAGACCATAA-1"	"A"
"CTCCCAAAGAGAGTTT-1"	"A"
"CTCCCAACAGCAAACG-1"	"A"
"CTCCCAAGTACCTATG-1"	"G"
"CTCCCAATCAAGGCCC-1"	"A"
"CTCGCTAAGGATTTGA-1"	"A"
"CTCGCTAAGTCTTAGC-1"	"G"
"CTCGCTAGTATTCGCA-1"	"G"
"CTCGCTAGTTAGTAGA-1"	"A"
"CTCGCTATCATGCTTT-1"	"A"
"CTCGCTATCCATACGA-1"	"A"
"CTCTACGAGTGTCGCC-1"	"G"
"CTCTACGCAAGACTAA-1"	"A"
"CTCTACGCATCAGCTA-1"	"G"
"CTCTACGCATCCCAAA-1"	"G"
"CTCTACGGTATATGGA-1"	"G"
"CTCTACGGTCTTAGCA-1"	"A"
"CTCTACGGTGCGCATC-1"	"A"
"CTCTACGTCAGGATCT-1"	"A"
"CTCTACGTCGACGGAA-1"	"G"
"CTCTACGTCTAGCAAC-1"	"A"
"CTCTAGCAGATCGCCC-1"	"G"
"CTCTAGCAGATCTCAC-1"	"G"
"CTCTAGCCAACTCGAT-1"	"A"
"CTCTAGCCAAGGTTCT-1"	"A"
"CTCTAGCCACTACACA-1"	"A"
"CTCTAGCCACTCAAGT-1"	"G"
"CTCTAGCGTAAAGGCC-1"	"A"
"CTCTAGCGTTTGCATG-1"	"A"
"CTCTAGCTCACTAGCA-1"	"A"
"CTCTAGCTCTGTTGCC-1"	"A"
"CTCTCAGAGCAATGTA-1"	"A"
"CTCTCAGAGCTACGTT-1"	"G"
"CTCTCAGAGTCTCTAG-1"	"A"
"CTCTCAGCACTGTCGG-1"	"G"
"CTCTCAGGTAAAGCTA-1"	"G"
"CTCTCAGGTGGCCTTG-1"	"A"
"CTCTCAGGTTAGGAAT-1"	"G"
"CTCTCAGTCTTCCGTG-1"	"G"
"CTCTCGAAGGTTCGAG-1"	"G"
"CTCTCGAAGTCGTGAG-1"	"G"
"CTCTCGACAAGCGGTA-1"	"G"
"CTCTCGACACGATTAC-1"	"A"
"CTCTCGACACGGTTAT-1"	"G"
"CTCTCGAGTATTGTCG-1"	"A"
"CTCTCGAGTGCGTAGA-1"	"A"
"CTCTCGATCACTGGTA-1"	"A"
"CTCTCGATCCATTGAG-1"	"A"
"CTCTCGATCCTATCCG-1"	"A"
"CTCTCGATCGCTAGTA-1"	"A"
"CTCTCGATCTTTGCAT-1"	"A"
"CTGAATGAGACGAAAG-1"	"G"
"CTGAATGAGAGGCAGG-1"	"A"
"CTGAATGAGCGCAATG-1"	"A"
"CTGAATGAGCTAACAA-1"	"G"
"CTGAATGCACAAGTGG-1"	"G"
"CTGAATGCACATTGCA-1"	"A"
"CTGAATGCAGACTAAA-1"	"A"
"CTGAATGGTATCCTTT-1"	"G"
"CTGAATGGTGCGTAGA-1"	"G"
"CTGAATGTCAGTGTAC-1"	"A"
"CTGCGTTAGACACAAT-1"	"A"
"CTGCGTTAGAGAGTTT-1"	"G"
"CTGCGTTAGAGTTCGG-1"	"G"
"CTGCGTTAGGCTGGAT-1"	"A"
"CTGCGTTGTCGAGAAC-1"	"G"
"CTGCGTTGTGCATTCA-1"	"G"
"CTGCGTTGTTTCACCC-1"	"G"
"CTGCGTTTCACCCGGA-1"	"A"
"CTGCGTTTCGCTACCT-1"	"G"
"CTGCGTTTCGTTCCGT-1"	"G"
"CTGCTCAAGACTCGGA-1"	"G"
"CTGCTCAAGGGCGAAG-1"	"A"
"CTGCTCACAAGCAATA-1"	"A"
"CTGCTCACAAGCCTTA-1"	"A"
"CTGCTCAGTCATGAGG-1"	"G"
"CTGCTCAGTCTAAAGA-1"	"A"
"CTGCTCAGTGCTTACA-1"	"G"
"CTGGCAGAGAACGCCA-1"	"A"
"CTGGCAGCAACACGGA-1"	"A"
"CTGGCAGCACAGTTCA-1"	"G"
"CTGGCAGCAGGACTGA-1"	"A"
"CTGGCAGGTAACGGAC-1"	"G"
"CTGGCAGGTGGTTCTA-1"	"G"
"CTGGCAGTCATGAACC-1"	"G"
"CTGGCAGTCGTAGCGC-1"	"A"
"CTGGGACAGAAGCCTG-1"	"G"
"CTGGGACAGGATGTCG-1"	"A"
"CTGGGACCAATAGCGG-1"	"A"
"CTGGGACCACTGATTG-1"	"A"
"CTGGGACTCTCTTCTC-1"	"G"
"CTGTATTAGAGCGGTT-1"	"A"
"CTGTATTAGGCAGTGT-1"	"A"
"CTGTATTAGGCTTCGC-1"	"G"
"CTGTATTAGTGTTCCA-1"	"G"
"CTGTATTCACGGTTAT-1"	"A"
"CTGTATTGTATTCTGG-1"	"G"
"CTGTATTGTTCCCAAA-1"	"A"
"CTGTATTTCCAGGGAA-1"	"A"
"CTGTATTTCCTGAAAC-1"	"G"
"CTGTATTTCTTGTACT-1"	"A"
"CTGTTCGAGATCACCT-1"	"G"
"CTGTTCGAGTACCACT-1"	"A"
"CTGTTCGCAAGCGGTA-1"	"A"
"CTGTTCGCATGGATGG-1"	"A"
"CTGTTCGGTTACGCTA-1"	"G"
"CTGTTCGGTTAGGAGC-1"	"A"
"CTGTTCGTCGCGTTCT-1"	"A"
"CTGTTCGTCGGCTATA-1"	"A"
"CTGTTCGTCTAGCAGT-1"	"A"
"CTGTTCGTCTCTTAAC-1"	"A"
"CTTAATCAGAAACGCC-1"	"G"
"CTTAATCCAACGCACC-1"	"A"
"CTTAATCCACGTTAGT-1"	"A"
"CTTAATCCATGATCGT-1"	"A"
"CTTAATCTCAGCCGAC-1"	"A"
"CTTAATCTCGTGCTGG-1"	"G"
"CTTCCAGAGAGACTCG-1"	"A"
"CTTCCAGAGATCCGAG-1"	"A"
"CTTCCAGAGTCCGGAA-1"	"A"
"CTTCCAGCATTGCGAT-1"	"A"
"CTTCCAGGTGCCAAGA-1"	"A"
"CTTCCAGTCCAGAATC-1"	"A"
"CTTCCAGTCCCTAAAG-1"	"A"
"CTTCCAGTCGCTTACC-1"	"A"
"CTTCCAGTCTGACATG-1"	"A"
"CTTCTAAAGCACACCC-1"	"G"
"CTTCTAAAGCTCCATA-1"	"A"
"CTTCTAAAGGACCGAT-1"	"A"
"CTTCTAAAGGGTTCTT-1"	"G"
"CTTCTAACATATTGGC-1"	"A"
"CTTCTAACATCGTACA-1"	"A"
"CTTCTAACATCTCACC-1"	"A"
"CTTCTAAGTAACGGTG-1"	"G"
"CTTCTAAGTGTTGGTT-1"	"G"
"CTTCTAATCCGTCAAA-1"	"G"
"CTTCTAATCGCGTGAC-1"	"G"
"CTTGAAGAGGTTCTCA-1"	"G"
"CTTGAAGAGTATAGTG-1"	"G"
"CTTGAAGAGTCATACC-1"	"G"
"CTTGAAGCAAACAGTA-1"	"G"
"CTTGAAGGTCCGAGCT-1"	"A"
"CTTGAAGGTCTCAAAC-1"	"A"
"CTTGAAGGTGAATGGC-1"	"G"
"CTTGAAGTCGTCCCAT-1"	"A"
"CTTGAAGTCGTGCTTC-1"	"G"
"CTTGAAGTCTCGCGTT-1"	"G"
"CTTGAAGTCTCTGAGA-1"	"A"
"CTTGAAGTCTTCTCTC-1"	"A"
"CTTGAAGTCTTTATCG-1"	"A"
"CTTGCCAAGGCCTCTG-1"	"A"
"CTTGCCAAGTCCTTCC-1"	"G"
"CTTGCCACAAGTTGCT-1"	"G"
"CTTGCCACAGTTAAAG-1"	"G"
"CTTGCCAGTTGGGAAC-1"	"G"
"CTTGCCAGTTTAGAAG-1"	"A"
"CTTGCCATCTGTTTAC-1"	"A"
"CTTGCCATCTTACCTA-1"	"A"
"CTTGCTGAGAAGAGTG-1"	"A"
"CTTGCTGAGAGCACTG-1"	"A"
"CTTGCTGAGCGTCAAG-1"	"G"
"CTTGCTGAGCTGAAAT-1"	"A"
"CTTGCTGAGGAGGCGA-1"	"G"
"CTTGCTGAGTTACCAC-1"	"A"
"CTTGCTGCAACCTCTC-1"	"G"
"CTTGCTGCACCTATTT-1"	"A"
"CTTGCTGCATGCCCTT-1"	"A"
"CTTGCTGGTCAACTAC-1"	"A"
"CTTGCTGTCCATATCT-1"	"A"
"CTTGTCGCACACATTG-1"	"G"
"CTTGTCGCACGCCGAT-1"	"A"
"CTTGTCGCAGGCACAA-1"	"A"
"CTTGTCGCATGTGAGG-1"	"G"
"CTTGTCGTCGGTAGGA-1"	"A"
"CTTGTCGTCGGTCAGC-1"	"A"
"CTTGTCGTCTCGTAGA-1"	"A"
"CTTGTCGTCTGTTGCC-1"	"A"
"CTTTGCGAGCAGGAGG-1"	"A"
"CTTTGCGAGCTAGTTC-1"	"G"
"CTTTGCGAGTACCACT-1"	"A"
"CTTTGCGCAGATTTGC-1"	"G"
"CTTTGCGCATGGCCTG-1"	"A"
"CTTTGCGGTCCTCAGG-1"	"A"
"CTTTGCGGTCTGCGCA-1"	"G"
"CTTTGCGGTGCATCAT-1"	"A"
"CTTTGCGGTGTCCTTC-1"	"A"
"CTTTGCGTCCACTAGA-1"	"G"
"CTTTGCGTCTTTCGAT-1"	"G"
"GAAACAAGTTTAGGAA-1"	"A"
"GAAACAAGTTTCACCC-1"	"G"
"GAAAGTAAGAAAGGGT-1"	"G"
"GAAAGTAAGAAGGGCG-1"	"A"
"GAAAGTAAGACCAATA-1"	"A"
"GAAAGTAAGCGCGTTC-1"	"G"
"GAAAGTAAGTAGTGTA-1"	"G"
"GAAAGTACAAGGTTCT-1"	"A"
"GAAAGTACAAGTTCGT-1"	"A"
"GAAAGTAGTAATGCAA-1"	"A"
"GAAAGTAGTACGGTTT-1"	"G"
"GAAAGTAGTCATAGCT-1"	"A"
"GAAAGTAGTGATAGAT-1"	"G"
"GAAAGTAGTTGTATCG-1"	"A"
"GAAAGTATCACTTACT-1"	"A"
"GAAAGTATCTGTAGAC-1"	"A"
"GAAATGAAGCTAGCAG-1"	"A"
"GAAATGACACGGTTAT-1"	"G"
"GAAATGACATAGTCCA-1"	"G"
"GAAATGAGTATCATGC-1"	"A"
"GAAATGATCAGAGTGG-1"	"A"
"GAAATGATCGTGGCGT-1"	"A"
"GAAATGATCGTGGTAT-1"	"A"
"GAAATGATCTCGCGGA-1"	"A"
"GAAATGATCTTGTGCC-1"	"A"
"GAACCGCAGAAATCTG-1"	"A"
"GAACCGCAGAAGGGCG-1"	"G"
"GAACCGCAGCAACGGT-1"	"G"
"GAACCGCAGCCTTTGA-1"	"A"
"GAACCGCAGCTCCGGT-1"	"A"
"GAACCGCAGGATATCA-1"	"A"
"GAACCGCAGTGAATAC-1"	"A"
"GAACCGCAGTGTCGCC-1"	"G"
"GAACCGCCAAGCAACG-1"	"A"
"GAACCGCGTACCTATG-1"	"A"
"GAACCGCGTCAGAAGC-1"	"G"
"GAACCGCTCACGATTG-1"	"A"
"GAACCGCTCGTCAACA-1"	"A"
"GAACCGCTCTGGCTAA-1"	"A"
"GAACCTAAGAGTTTGA-1"	"A"
"GAACCTAAGGATTGAT-1"	"A"
"GAACCTAAGGCCAATG-1"	"A"
"GAACCTAAGGCGTAGT-1"	"G"
"GAACCTACAATAGCGG-1"	"A"
"GAACCTACACAGCTTA-1"	"A"
"GAACCTACACGAACGA-1"	"G"
"GAACCTACAGCTATAC-1"	"A"
"GAACCTAGTAGAACGC-1"	"A"
"GAACCTAGTGGTGGTA-1"	"A"
"GAACCTAGTGTCGTGC-1"	"G"
"GAACCTAGTGTTGGTT-1"	"A"
"GAACGTTAGAAGCCTG-1"	"A"
"GAACGTTAGAGGTGGG-1"	"G"
"GAACGTTAGGCTTCGC-1"	"A"
"GAACGTTAGTGTCCCG-1"	"A"
"GAACGTTCACGATATC-1"	"A"
"GAACGTTGTATTGTGC-1"	"G"
"GAACGTTGTGGCCTTG-1"	"G"
"GAACGTTGTTATCGAC-1"	"A"
"GAACGTTGTTTGACCA-1"	"A"
"GAACGTTTCCCAATAG-1"	"A"
"GAACGTTTCGGAAAGC-1"	"A"
"GAACGTTTCGGATCGC-1"	"A"
"GAACGTTTCTATCCTA-1"	"G"
"GAACGTTTCTGGGCGT-1"	"A"
"GAACTTGAGAGAACCC-1"	"A"
"GAACTTGAGCTTTCCC-1"	"A"
"GAACTTGAGGCGCTTC-1"	"A"
"GAACTTGAGTCCGGAA-1"	"G"
"GAACTTGAGTGTCGCC-1"	"A"
"GAACTTGCAAGTGGCA-1"	"G"
"GAACTTGCATGGCCGT-1"	"A"
"GAACTTGGTAACGGCA-1"	"A"
"GAACTTGGTACCCATA-1"	"G"
"GAACTTGGTAGCATGG-1"	"A"
"GAACTTGGTTTGGATC-1"	"G"
"GAACTTGTCTCCACTG-1"	"G"
"GAAGAGCAGACAGCTG-1"	"G"
"GAAGAGCAGGCTTTAC-1"	"A"
"GAAGAGCAGTCGTACT-1"	"A"
"GAAGAGCCAATACTGC-1"	"G"
"GAAGAGCCACGATATC-1"	"A"
"GAAGAGCCACTGCTCT-1"	"G"
"GAAGAGCGTAACAATG-1"	"G"
"GAAGAGCGTAGCAGGT-1"	"A"
"GAAGAGCGTCACTCTC-1"	"A"
"GAAGAGCGTCTTAGCA-1"	"A"
"GAAGAGCGTGGAAAGA-1"	"A"
"GAAGAGCGTGTGCTTA-1"	"G"
"GAAGAGCGTTTGGATC-1"	"A"
"GAAGAGCTCAATTCCT-1"	"G"
"GAAGAGCTCACTCCCA-1"	"G"
"GAAGTCTAGACCAATA-1"	"G"
"GAAGTCTAGAGAACCC-1"	"A"
"GAAGTCTAGGCCTCGT-1"	"A"
"GAAGTCTCAAAGCTTC-1"	"G"
"GAAGTCTCAACACGGA-1"	"G"
"GAAGTCTCAGGTGTCC-1"	"A"
"GAAGTCTCATGGGTGA-1"	"A"
"GAAGTCTGTCCCGAGT-1"	"A"
"GAAGTCTGTCGACTGC-1"	"A"
"GAAGTCTGTGTCGTCG-1"	"G"
"GAAGTCTTCTTCGTTA-1"	"G"
"GAAGTGGAGAAATTCG-1"	"G"
"GAAGTGGAGAATACTG-1"	"G"
"GAAGTGGAGATCTCAC-1"	"A"
"GAAGTGGAGGCACCTC-1"	"G"
"GAAGTGGCAGGTAGGT-1"	"G"
"GAAGTGGGTAGGTGAC-1"	"A"
"GAAGTGGGTCGTAGTT-1"	"A"
"GAAGTGGGTGGTGGTA-1"	"A"
"GAAGTGGTCTCATATC-1"	"A"
"GAAGTGGTCTTAACGG-1"	"A"
"GAATCTGAGACCGCAA-1"	"G"
"GAATCTGAGCTTCAAC-1"	"A"
"GAATCTGAGGATGCCA-1"	"G"
"GAATCTGAGGTTGTGG-1"	"G"
"GAATCTGCACCTCGTT-1"	"G"
"GAATCTGCAGCGTCGT-1"	"A"
"GAATCTGCATAGCAGG-1"	"G"
"GAATCTGGTCAGAGTG-1"	"G"
"GAATCTGGTCCTTATT-1"	"A"
"GAATCTGGTTGGCTAT-1"	"G"
"GAATCTGTCAACACGT-1"	"A"
"GAATCTGTCATGAACC-1"	"G"
"GAATCTGTCCCAGCGA-1"	"A"
"GAATCTGTCTGTGTGA-1"	"A"
"GACCAATAGTACGCGA-1"	"A"
"GACCAATAGTGCACAG-1"	"G"
"GACCAATAGTGGTGTG-1"	"G"
"GACCAATCATCATCGA-1"	"G"
"GACCAATGTTTGTAGC-1"	"A"
"GACCAATTCGCTTCAC-1"	"A"
"GACCAATTCTCGACAA-1"	"A"
"GACCAATTCTGTGTGA-1"	"A"
"GACCCAGAGTGAGTTA-1"	"G"
"GACCCAGCACCATTCC-1"	"A"
"GACCCAGCACCCTTAC-1"	"A"
"GACCCAGGTACCAAGG-1"	"A"
"GACCCAGGTATCAGCT-1"	"G"
"GACCCAGGTTAACCAC-1"	"A"
"GACCCAGTCCTCCAGT-1"	"A"
"GACCCAGTCGGATCGC-1"	"G"
"GACCGACAGAATCAGT-1"	"A"
"GACCGACAGAGTTCGG-1"	"G"
"GACCGACAGCGAATAT-1"	"A"
"GACCGACAGGCACCTC-1"	"A"
"GACCGACAGTCAACTC-1"	"G"
"GACCGACCAAGTTGCT-1"	"G"
"GACCGACCACTAGCCG-1"	"G"
"GACCGACCAGGGTACA-1"	"G"
"GACCGACCAGTAACCT-1"	"G"
"GACCGACGTAACTCCA-1"	"A"
"GACCGACGTATCGCGC-1"	"G"
"GACCGACGTTCACGTA-1"	"A"
"GACCGACGTTCTTTCA-1"	"G"
"GACCGACTCATTCATC-1"	"G"
"GACCGACTCGGCATAT-1"	"A"
"GACCGACTCGGTTAGT-1"	"G"
"GACCGACTCTATCTAC-1"	"A"
"GACCTTCAGACAACGC-1"	"A"
"GACCTTCAGATATGAC-1"	"A"
"GACCTTCAGGAGTACC-1"	"G"
"GACCTTCAGGGAGATA-1"	"A"
"GACCTTCCAATGCATC-1"	"G"
"GACCTTCCACATCATG-1"	"A"
"GACCTTCCACATTGCA-1"	"A"
"GACCTTCCAGAACTTC-1"	"G"
"GACCTTCCATCGACCG-1"	"G"
"GACCTTCCATGGCCGT-1"	"G"
"GACCTTCGTGCTGGCT-1"	"A"
"GACCTTCGTTAACCGT-1"	"G"
"GACCTTCTCCACACCT-1"	"A"
"GACCTTCTCTGAGTAC-1"	"A"
"GACTAACAGAACGTTA-1"	"G"
"GACTAACAGGCTGGAT-1"	"A"
"GACTAACCAAGGTTCT-1"	"G"
"GACTAACCATCCTCGT-1"	"A"
"GACTAACGTTCCAATG-1"	"G"
"GACTAACTCAGCACTA-1"	"A"
"GACTAACTCGTGAGTT-1"	"G"
"GACTAGTAGGATGTCG-1"	"A"
"GACTAGTAGGCTTAAA-1"	"A"
"GACTAGTAGTCGCCTG-1"	"G"
"GACTAGTCATGTGAGG-1"	"G"
"GACTAGTCATTAACGC-1"	"A"
"GACTAGTGTATTCTGG-1"	"A"
"GACTAGTGTCATCAAC-1"	"A"
"GACTAGTGTTATGCAC-1"	"A"
"GACTAGTGTTTCGATG-1"	"G"
"GAGAACGAGACAGCTG-1"	"G"
"GAGAACGAGACGAAAG-1"	"A"
"GAGAACGAGCCTGTAT-1"	"A"
"GAGAACGAGGCCTCTG-1"	"A"
"GAGAACGCAAGGGAGG-1"	"G"
"GAGAACGCAGCCACGT-1"	"G"
"GAGAACGCATTGCGAT-1"	"A"
"GAGAACGGTATTCTCT-1"	"A"
"GAGAACGTCAGATACC-1"	"A"
"GAGAACGTCAGGTTTG-1"	"A"
"GAGAACGTCCATGACA-1"	"A"
"GAGAACGTCGGATAGG-1"	"A"
"GAGAACGTCGTGATAC-1"	"A"
"GAGAACGTCTGTGTGA-1"	"G"
"GAGACTTAGACTTGAA-1"	"G"
"GAGACTTCAGACCTGC-1"	"A"
"GAGACTTCAGGTAACG-1"	"G"
"GAGACTTGTAACTGAA-1"	"G"
"GAGACTTGTCTCTGCT-1"	"G"
"GAGACTTTCGCAACTA-1"	"A"
"GAGACTTTCTCTTCCT-1"	"A"
"GAGATTCAGAGCTACG-1"	"G"
"GAGATTCAGGATTTGA-1"	"A"
"GAGATTCAGGCAAGGG-1"	"G"
"GAGATTCAGGTTGTGG-1"	"G"
"GAGATTCAGTACCCAT-1"	"A"
"GAGATTCAGTTGACAA-1"	"G"
"GAGATTCCAACGTCCG-1"	"A"
"GAGATTCCAAGCGAAC-1"	"G"
"GAGATTCGTCGATTAC-1"	"G"
"GAGATTCGTGTCGTCG-1"	"A"
"GAGATTCTCCATCTAT-1"	"A"
"GAGATTCTCCCACTAC-1"	"A"
"GAGATTCTCCGGGCAT-1"	"A"
"GAGATTCTCGAACACT-1"	"A"
"GAGATTCTCGCTATAG-1"	"G"
"GAGATTCTCTGATCCC-1"	"G"
"GAGCATTAGAGAATTC-1"	"A"
"GAGCATTAGATGGCAC-1"	"G"
"GAGCATTGTAACATAG-1"	"A"
"GAGCATTGTTGGCGAA-1"	"A"
"GAGCATTGTTTAAGCC-1"	"A"
"GAGCATTTCTGGACAT-1"	"A"
"GAGCGCTAGATACCAA-1"	"A"
"GAGCGCTAGCTAGTTC-1"	"G"
"GAGCGCTAGTTCTCCC-1"	"G"
"GAGCGCTCAAACCTAC-1"	"G"
"GAGCGCTCACACATTG-1"	"G"
"GAGCGCTCAGGACCTC-1"	"A"
"GAGCGCTCATCATAGC-1"	"A"
"GAGCGCTCATCCCGGA-1"	"G"
"GAGCGCTGTAGGTAAT-1"	"A"
"GAGCGCTGTCTCTGCT-1"	"G"
"GAGCGCTGTGTGCTTA-1"	"A"
"GAGCGCTTCTACTGCC-1"	"G"
"GAGGATGAGAATATCG-1"	"G"
"GAGGATGAGAGCCTGA-1"	"A"
"GAGGATGAGCGATACG-1"	"G"
"GAGGATGAGGAGTACC-1"	"A"
"GAGGATGAGTTGACAA-1"	"A"
"GAGGATGGTAAGTGCG-1"	"A"
"GAGGATGGTCTGTGTA-1"	"A"
"GAGGATGGTTATAGAG-1"	"G"
"GAGGCTCCAAGTCTCA-1"	"A"
"GAGGCTCCAGGTGGTA-1"	"G"
"GAGGCTCCATATTGGC-1"	"A"
"GAGGCTCGTAGGTGAC-1"	"G"
"GAGGCTCGTATATGGA-1"	"G"
"GAGGCTCGTGCAAGAC-1"	"A"
"GAGGCTCGTTTGACCA-1"	"G"
"GAGGCTCGTTTGATCG-1"	"A"
"GAGGCTCGTTTGGATC-1"	"G"
"GAGGTCCAGACCTATC-1"	"A"
"GAGGTCCAGCAATAAC-1"	"G"
"GAGGTCCAGCCATCAT-1"	"G"
"GAGGTCCAGGGACGTT-1"	"G"
"GAGGTCCAGTCATCTG-1"	"A"
"GAGGTCCCAACACGGA-1"	"G"
"GAGGTCCCAACTAGAA-1"	"A"
"GAGGTCCCACGATATC-1"	"A"
"GAGGTCCCAGAAAGAG-1"	"A"
"GAGGTCCGTAGCTGTT-1"	"G"
"GAGGTCCGTCCCTAAA-1"	"G"
"GAGGTCCGTGGACGAT-1"	"G"
"GAGGTCCTCAATCGTG-1"	"A"
"GAGTGAGAGGGCGAAG-1"	"A"
"GAGTGAGAGGTTCTCA-1"	"A"
"GAGTGAGCAAGGGTAC-1"	"A"
"GAGTGAGCATTAGCCA-1"	"A"
"GAGTGAGGTCACAGGA-1"	"A"
"GAGTGAGGTCTGCACG-1"	"G"
"GAGTGAGGTTCCAGTA-1"	"A"
"GAGTGAGTCCAGCACG-1"	"A"
"GAGTGAGTCCATACCC-1"	"A"
"GAGTGAGTCCCACGGA-1"	"G"
"GATCATGCACCCATCT-1"	"A"
"GATCATGCACGCGTTG-1"	"G"
"GATCATGCATTGCACA-1"	"G"
"GATCATGGTGCATCAT-1"	"A"
"GATCATGTCGCGCTGA-1"	"A"
"GATCGTAAGATGCGCA-1"	"G"
"GATCGTAAGCAGGAGG-1"	"A"
"GATCGTAAGTAACACA-1"	"A"
"GATCGTAAGTTACCAC-1"	"A"
"GATCGTAGTAGAACGC-1"	"G"
"GATCGTAGTAGCTGTT-1"	"A"
"GATCGTAGTCTGGATT-1"	"G"
"GATCGTAGTTTAGGAA-1"	"G"
"GATCGTATCCATCATT-1"	"A"
"GATCGTATCTGGACAT-1"	"A"
"GATGATCAGCCCATGC-1"	"G"
"GATGATCAGGGCTTCC-1"	"G"
"GATGATCCAACACGGA-1"	"A"
"GATGATCCAAGCAACG-1"	"A"
"GATGATCCAATGGCTT-1"	"A"
"GATGATCCATCGCTAA-1"	"A"
"GATGATCGTAACTCCA-1"	"G"
"GATGATCGTACCCATA-1"	"A"
"GATGATCGTACTATGC-1"	"A"
"GATGATCGTACTTCGA-1"	"G"
"GATGATCGTAGGTCTT-1"	"G"
"GATGATCGTGGCCTTG-1"	"G"
"GATGATCGTTGGCTTA-1"	"G"
"GATGATCTCAGTGGTT-1"	"A"
"GATGATCTCTGGCACG-1"	"A"
"GATGGCCAGAGGCCTA-1"	"G"
"GATGGCCCAGCGTCGT-1"	"G"
"GATGGCCCAGCGTGAA-1"	"A"
"GATGGCCCATGGTAAA-1"	"A"
"GATGGCCGTATCCTTT-1"	"G"
"GATGGCCGTCTCTAAG-1"	"G"
"GATGGCCGTGAGTTGG-1"	"A"
"GATGGCCGTTTGAAGA-1"	"A"
"GATGGCCTCAGTCACA-1"	"G"
"GATGGCCTCCATAACG-1"	"G"
"GATGGCCTCGATGTAC-1"	"A"
"GATGGCCTCTGTTTAC-1"	"A"
"GATTAGCAGAGGCAGG-1"	"A"
"GATTAGCAGTCCGTGC-1"	"A"
"GATTAGCAGTCTTAGC-1"	"A"
"GATTAGCCAGCAACCC-1"	"G"
"GATTAGCCAGGTCCTG-1"	"A"
"GATTAGCGTAACATAG-1"	"G"
"GATTAGCTCCAGGGAA-1"	"A"
"GATTAGCTCCCGTAGG-1"	"G"
"GATTAGCTCGATGTAC-1"	"A"
"GATTAGCTCTTATCAC-1"	"A"
"GATTGACAGACGACTG-1"	"A"
"GATTGACAGCTTACCA-1"	"A"
"GATTGACCATCACAGT-1"	"G"
"GATTGACGTACAAATG-1"	"G"
"GATTGACGTCCGTCGA-1"	"G"
"GATTGACTCAACTTGG-1"	"G"
"GATTGACTCAGAACGG-1"	"G"
"GATTGACTCCATACCC-1"	"A"
"GATTGACTCCATATCT-1"	"G"
"GATTGACTCCGAGGAA-1"	"G"
"GATTGACTCGCGATGC-1"	"A"
"GATTGACTCTGAGTCA-1"	"G"
"GCAAAGGAGCGTGTTT-1"	"G"
"GCAAAGGAGCTGATTC-1"	"A"
"GCAAAGGAGGAGTAGA-1"	"G"
"GCAAAGGAGTCAGCCC-1"	"A"
"GCAAAGGCAAGGATGC-1"	"A"
"GCAAAGGCACCGATCG-1"	"A"
"GCAAAGGCATTTCTTG-1"	"G"
"GCAAAGGCATTTGGCA-1"	"G"
"GCAAAGGGTAGCGGTA-1"	"A"
"GCAAAGGGTGACCAGA-1"	"G"
"GCAAAGGGTGAGTTGG-1"	"G"
"GCAAAGGGTTAGGAAT-1"	"G"
"GCAAAGGGTTCCTATT-1"	"G"
"GCAAAGGTCCACTAGA-1"	"A"
"GCAAAGGTCGCACCTT-1"	"A"
"GCAAAGGTCTTTGCAT-1"	"G"
"GCAACCGAGAACCCGA-1"	"G"
"GCAACCGAGCGAGCTA-1"	"A"
"GCAACCGAGTACTCTG-1"	"A"
"GCAACCGAGTGAAACT-1"	"G"
"GCAACCGAGTGATAAC-1"	"A"
"GCAACCGCAACGTAGG-1"	"A"
"GCAACCGCAAGTCCTA-1"	"A"
"GCAACCGCACGCGATC-1"	"G"
"GCAACCGCAGTAACGG-1"	"A"
"GCAACCGGTGCCCTAG-1"	"A"
"GCAACCGGTGGTCGAA-1"	"A"
"GCAACCGTCCCGATTC-1"	"G"
"GCAACCGTCGACTCGG-1"	"G"
"GCAACCGTCTCCCTTT-1"	"G"
"GCACCTTAGCCATGGA-1"	"G"
"GCACCTTCAATGTAAG-1"	"G"
"GCACCTTCACGTTGTA-1"	"A"
"GCACCTTCATGTCCCT-1"	"A"
"GCACCTTGTATTCTTC-1"	"A"
"GCACCTTGTCTAAGAA-1"	"A"
"GCACCTTGTGTGAGGT-1"	"A"
"GCACCTTGTTACTTTC-1"	"A"
"GCACCTTTCAAGTTGC-1"	"G"
"GCACCTTTCCGATTGA-1"	"A"
"GCACCTTTCCTGAAAC-1"	"A"
"GCACGCAAGCCGCTGT-1"	"A"
"GCACGCAAGTAACTCC-1"	"G"
"GCACGCACAAGCGAAC-1"	"A"
"GCACGCACAAGCTTTG-1"	"G"
"GCACGCACAAGTCCTA-1"	"A"
"GCACGCACACTAGCCG-1"	"G"
"GCACGCACATTACACG-1"	"A"
"GCACGCAGTCGATTAC-1"	"G"
"GCACGCAGTGAGTTGG-1"	"G"
"GCACGCAGTTACCACA-1"	"G"
"GCACGCATCAGAACGG-1"	"A"
"GCACGCATCATACTTC-1"	"A"
"GCACGCATCATGTTCT-1"	"G"
"GCACGCATCCGCTATC-1"	"A"
"GCACGCATCCTTCGAC-1"	"A"
"GCACGCATCTCGCGGA-1"	"G"
"GCACGCATCTTCTCTC-1"	"G"
"GCACGGTAGACACAAT-1"	"G"
"GCACGGTAGACAGTGC-1"	"A"
"GCACGGTAGATGGGAA-1"	"A"
"GCACGGTAGCCGCTGT-1"	"G"
"GCACGGTAGGAAACTT-1"	"G"
"GCACGGTAGGTTTCTG-1"	"G"
"GCACGGTCACCCATCT-1"	"A"
"GCACGGTCAGAACAGC-1"	"A"
"GCACGGTCAGAACTTC-1"	"G"
"GCACGGTCAGCTATAC-1"	"G"
"GCACGGTCAGGCACAA-1"	"A"
"GCACGGTCAGTAACGG-1"	"A"
"GCACGGTCATGCGCTG-1"	"A"
"GCACGGTGTACAAATG-1"	"A"
"GCACGGTGTAGGTCTT-1"	"G"
"GCACGGTGTATCCTTT-1"	"A"
"GCACGGTGTTGGCTAT-1"	"G"
"GCACGGTTCTCGTGAA-1"	"G"
"GCACGGTTCTTATCAC-1"	"G"
"GCAGATTAGAACAGGA-1"	"G"
"GCAGATTAGAAGCCGT-1"	"G"
"GCAGATTCAAACCTAC-1"	"G"
"GCAGATTCAAATGTCC-1"	"G"
"GCAGATTCAATTCGTG-1"	"A"
"GCAGATTCACGCGCAT-1"	"A"
"GCAGATTCAGCAACAG-1"	"G"
"GCAGATTCATCACAGT-1"	"G"
"GCAGATTGTTCTTAGG-1"	"G"
"GCAGATTTCCTCCCAA-1"	"A"
"GCAGATTTCCTGAAAC-1"	"G"
"GCAGCCAAGACCCTAT-1"	"A"
"GCAGCCAAGATCTCAC-1"	"G"
"GCAGCCAAGCTTACCA-1"	"G"
"GCAGCCAAGTACTCTG-1"	"G"
"GCAGCCAAGTCTAGAA-1"	"A"
"GCAGCCAAGTTCAACC-1"	"G"
"GCAGCCACAAGGGAGG-1"	"G"
"GCAGCCACACCTACCT-1"	"A"
"GCAGCCACAGGTGTGA-1"	"A"
"GCAGCCACAGTAACTC-1"	"G"
"GCAGCCACAGTGGTCC-1"	"A"
"GCAGCCACATAGACGG-1"	"G"
"GCAGCCAGTAAACCCT-1"	"G"
"GCAGCCAGTAAGTGCG-1"	"A"
"GCAGCCATCACGTCAA-1"	"A"
"GCAGCCATCCAGTACA-1"	"A"
"GCAGCCATCTAGCAGT-1"	"A"
"GCAGCTGAGAAGAGTG-1"	"A"
"GCAGCTGAGAAGGGCG-1"	"A"
"GCAGCTGAGAGAATTC-1"	"A"
"GCAGCTGAGGAGTCTG-1"	"A"
"GCAGCTGCAATGGTCT-1"	"A"
"GCAGCTGCACACACAT-1"	"G"
"GCAGCTGCATCGCCTT-1"	"G"
"GCAGCTGGTAACCCAT-1"	"A"
"GCAGCTGGTAACCGAG-1"	"A"
"GCAGCTGGTCAGGTGA-1"	"A"
"GCAGCTGGTGGTACTT-1"	"A"
"GCAGCTGGTTACTACG-1"	"G"
"GCAGCTGTCGTGGCGT-1"	"G"
"GCAGCTGTCGTTCCGT-1"	"A"
"GCATGATCACCACAGC-1"	"G"
"GCATGATCAGGTGGTA-1"	"G"
"GCATGATCATAGAATG-1"	"A"
"GCATGATGTAACTCCA-1"	"A"
"GCATGATGTACTTCGA-1"	"A"
"GCATGATGTCAGTGCC-1"	"G"
"GCATGATGTCTGATTG-1"	"A"
"GCATGATGTGACCAGA-1"	"G"
"GCATGATGTGCAACAG-1"	"G"
"GCATGATGTGGAAGCT-1"	"A"
"GCATGATGTTTGATCG-1"	"G"
"GCATGATTCACTCGGG-1"	"A"
"GCATGATTCCAGGGAA-1"	"A"
"GCATGATTCCTCTCTT-1"	"G"
"GCATTCCAGCGTCTGC-1"	"A"
"GCATTCCAGGCCAATG-1"	"G"
"GCATTCCAGTCAACTC-1"	"G"
"GCATTCCAGTTGAATG-1"	"G"
"GCATTCCGTCCGTAGC-1"	"G"
"GCATTCCGTGCCGGTT-1"	"G"
"GCATTCCGTGTCGTGC-1"	"G"
"GCATTCCTCCCTACCA-1"	"A"
"GCATTGAAGAAATGGG-1"	"A"
"GCATTGAAGATGTTCC-1"	"G"
"GCATTGAAGTGCTCGC-1"	"A"
"GCATTGAAGTTACACC-1"	"A"
"GCATTGACAAACCCTA-1"	"A"
"GCATTGACAAGGATGC-1"	"G"
"GCATTGACAATGTAAG-1"	"A"
"GCATTGACACTCAGCG-1"	"A"
"GCATTGACAGTAGTTC-1"	"A"
"GCATTGACATATACGC-1"	"A"
"GCATTGAGTCAGAGTG-1"	"A"
"GCATTGAGTGTCCTTC-1"	"G"
"GCATTGAGTTTCTACT-1"	"G"
"GCATTGATCGATGCAT-1"	"A"
"GCATTGATCTAGCTGA-1"	"G"
"GCATTGATCTGACTTT-1"	"A"
"GCCAGACCACATAAAG-1"	"G"
"GCCAGACCACATTGCA-1"	"G"
"GCCAGACCAGTGCGAA-1"	"A"
"GCCAGACCAGTGGTCC-1"	"A"
"GCCAGACCATCCCTCA-1"	"G"
"GCCAGACCATGTGGGA-1"	"G"
"GCCAGACGTAACACTC-1"	"A"
"GCCAGACTCAGTCACA-1"	"G"
"GCCAGACTCTCCTTAA-1"	"A"
"GCCAGCAAGAAGCCTG-1"	"G"
"GCCAGCAAGACAGCTG-1"	"A"
"GCCAGCAAGGCGCTTC-1"	"G"
"GCCAGCAAGGTCTTGT-1"	"A"
"GCCAGCAAGGTGTCGA-1"	"G"
"GCCAGCAAGTGATAAC-1"	"A"
"GCCAGCACACAATAAG-1"	"G"
"GCCAGCACACTGCTTC-1"	"A"
"GCCAGCACAGCAACCC-1"	"G"
"GCCAGCACAGTAAGAT-1"	"A"
"GCCAGCAGTAATGTAG-1"	"A"
"GCCAGCAGTCCGAGCT-1"	"G"
"GCCAGCATCCTTGACC-1"	"G"
"GCCAGCATCGGTCTCT-1"	"A"
"GCCAGCATCGGTTAGT-1"	"A"
"GCCAGCATCGTTCTAT-1"	"A"
"GCCAGCATCTGGAAGG-1"	"G"
"GCCAGCATCTTCAGAG-1"	"A"
"GCCATAAAGAGGCCTA-1"	"G"
"GCCATAAAGAGTTTGA-1"	"A"
"GCCATAAAGGAAGGTA-1"	"A"
"GCCATAAAGGCTTCGC-1"	"A"
"GCCATAACAACATAAG-1"	"G"
"GCCATAACAAGTCTGT-1"	"G"
"GCCATAAGTAGCCATT-1"	"A"
"GCCATAAGTCCCGTGA-1"	"A"
"GCCATAAGTGAAACAT-1"	"G"
"GCCATAAGTGGACAGT-1"	"G"
"GCCATAAGTGTTAGAA-1"	"A"
"GCCATAAGTTTCAGCA-1"	"A"
"GCCATAATCGGGCTCA-1"	"A"
"GCCATAATCTTCCAGC-1"	"A"
"GCCCAGAAGAAAGGGT-1"	"G"
"GCCCAGAAGATACCAA-1"	"A"
"GCCCAGAAGTTGCTTG-1"	"A"
"GCCCAGACACACACAT-1"	"A"
"GCCCAGACAGTAACCT-1"	"A"
"GCCCAGACAGTAGTCT-1"	"A"
"GCCCAGACATGCACTA-1"	"G"
"GCCCAGACATGGCCTG-1"	"G"
"GCCCAGACATGTCCCT-1"	"G"
"GCCCAGACATTGTGAC-1"	"A"
"GCCCAGAGTAGAATAC-1"	"A"
"GCCCAGAGTATTGTGC-1"	"A"
"GCCCAGATCAGAATGA-1"	"G"
"GCCCAGATCGTCCCTA-1"	"A"
"GCCCAGATCGTGCTTC-1"	"A"
"GCCCAGATCTATCTAC-1"	"A"
"GCCCGAAAGACGCCCT-1"	"G"
"GCCCGAACAAGGCGTA-1"	"A"
"GCCCGAACACCTGTGG-1"	"A"
"GCCCGAACATGCACTA-1"	"A"
"GCCCGAAGTTTCTCTA-1"	"A"
"GCCCGAATCAAATGGA-1"	"A"
"GCCCGAATCAAGGCAG-1"	"A"
"GCCCGAATCCATAACG-1"	"G"
"GCCTACTAGAACCCGA-1"	"G"
"GCCTACTAGCTTACCA-1"	"A"
"GCCTACTAGTCGAGCA-1"	"A"
"GCCTACTAGTGCTAGG-1"	"A"
"GCCTACTAGTGGGACT-1"	"A"
"GCCTACTCACTCAGCG-1"	"G"
"GCCTACTCATTAGCCA-1"	"G"
"GCCTACTTCAGATACC-1"	"G"
"GCCTACTTCCTCTCTT-1"	"G"
"GCCTACTTCTCTGTTA-1"	"A"
"GCCTAGGAGAATACTG-1"	"A"
"GCCTAGGAGATCTAAG-1"	"A"
"GCCTAGGAGTGCACAG-1"	"A"
"GCCTAGGCAGGCAGAT-1"	"G"
"GCCTAGGGTACATGGG-1"	"G"
"GCCTAGGGTAGAACGC-1"	"A"
"GCCTAGGGTAGTCTGT-1"	"G"
"GCCTAGGGTCGCGCTA-1"	"A"
"GCCTAGGGTGAGCTAG-1"	"A"
"GCCTAGGTCAACTTGG-1"	"G"
"GCCTAGGTCTTACTCA-1"	"A"
"GCGAGAAAGAATATCG-1"	"G"
"GCGAGAAGTACTAGAA-1"	"G"
"GCGAGAAGTGAATGGC-1"	"A"
"GCGAGAAGTGCCCAGT-1"	"G"
"GCGAGAATCTGGAAGG-1"	"A"
"GCGAGTCAGATTGACA-1"	"A"
"GCGAGTCAGGCCAATG-1"	"A"
"GCGAGTCAGTGATATG-1"	"G"
"GCGAGTCGTTCCGGCA-1"	"A"
"GCGAGTCTCACTAGCA-1"	"A"
"GCGAGTCTCGGGACAA-1"	"A"
"GCGATCGAGTCGATAA-1"	"A"
"GCGATCGAGTGAAACT-1"	"A"
"GCGATCGCAAACCGAG-1"	"A"
"GCGATCGCAGTAAGAT-1"	"G"
"GCGATCGGTGGACCAA-1"	"A"
"GCGATCGGTTCTGAGT-1"	"A"
"GCGATCGGTTGGTAAA-1"	"G"
"GCGATCGTCCGGAAAG-1"	"A"
"GCGATCGTCCTAAGTG-1"	"A"
"GCGATCGTCCTTCGAC-1"	"A"
"GCGATTAAGCCAGAAC-1"	"G"
"GCGATTAAGCTACGCC-1"	"G"
"GCGATTACAGAACAGC-1"	"A"
"GCGATTAGTCCCGTGA-1"	"G"
"GCGATTAGTGGCCTTG-1"	"G"
"GCGATTAGTTTCCACC-1"	"G"
"GCGATTATCAGTCTTT-1"	"A"
"GCGATTATCCGCTATC-1"	"A"
"GCGATTATCGACTTAG-1"	"A"
"GCGATTATCTTGGCCT-1"	"G"
"GCGCATGAGATACCAA-1"	"G"
"GCGCATGAGTACAACA-1"	"A"
"GCGCATGAGTACCCAT-1"	"A"
"GCGCATGCAGAACTTC-1"	"A"
"GCGCATGGTAACATAG-1"	"A"
"GCGCATGGTAGATTAG-1"	"A"
"GCGCATGGTCGGCTGT-1"	"A"
"GCGCATGGTGCTTACA-1"	"A"
"GCGCATGTCACAACAC-1"	"A"
"GCGCCAAAGACTAGGC-1"	"G"
"GCGCCAAAGATGAGGA-1"	"A"
"GCGCCAAAGTTGTCCA-1"	"G"
"GCGCCAACAAGTAATG-1"	"G"
"GCGCCAACACAGCCAC-1"	"A"
"GCGCCAACACGTTGTA-1"	"A"
"GCGCCAAGTAATGTGA-1"	"G"
"GCGCCAAGTAGATGAT-1"	"A"
"GCGCCAAGTGAATACA-1"	"A"
"GCGCCAAGTTCATTTC-1"	"G"
"GCGCCAATCACTCGGG-1"	"A"
"GCGCCAATCGAACCGC-1"	"G"
"GCGCCAATCGACTTAG-1"	"A"
"GCGCCAATCGGCTATA-1"	"A"
"GCGCCAATCGTTCAGA-1"	"A"
"GCGCCAATCTTAACGG-1"	"A"
"GCGGAAAAGAGGTCCA-1"	"G"
"GCGGAAAAGCTAGCAG-1"	"A"
"GCGGAAAAGGAAGAAC-1"	"A"
"GCGGAAAAGTTGCCGC-1"	"A"
"GCGGAAACATCAGAAA-1"	"A"
"GCGGAAACATTATGGC-1"	"A"
"GCGGAAAGTATGAAGT-1"	"A"
"GCGGAAAGTCAGTGCC-1"	"G"
"GCGGAAAGTTTGAAGA-1"	"A"
"GCGGAAATCAGCACTA-1"	"A"
"GCGGAAATCGGTTAGT-1"	"A"
"GCGGAAATCGTGGTAT-1"	"A"
"GCGGAAATCTTATCAC-1"	"A"
"GCGGGTTAGGCACTAG-1"	"G"
"GCGGGTTAGGTGTCGA-1"	"A"
"GCGGGTTAGTCGAAAT-1"	"A"
"GCGGGTTAGTGAAACT-1"	"A"
"GCGGGTTAGTTAGCAA-1"	"A"
"GCGGGTTCAACATAAG-1"	"G"
"GCGGGTTCAACTACTG-1"	"G"
"GCGGGTTCATAGGCGA-1"	"A"
"GCGGGTTCATCGTGAT-1"	"G"
"GCGGGTTGTTACTACG-1"	"A"
"GCGGGTTTCAACTTGG-1"	"A"
"GCGGGTTTCACACGTA-1"	"G"
"GCGGGTTTCCATCGAA-1"	"A"
"GCGGGTTTCCGCCTAT-1"	"A"
"GCGGGTTTCGTCTAGA-1"	"G"
"GCGGTGTAGCAATGTA-1"	"G"
"GCGGTGTAGGTCTTGT-1"	"A"
"GCGGTGTCAACTTGGT-1"	"A"
"GCGGTGTCAAGCGTCC-1"	"A"
"GCGGTGTCAGCTTACA-1"	"A"
"GCGGTGTCATACAACC-1"	"G"
"GCGGTGTCATGCACTA-1"	"A"
"GCGGTGTGTATTCTTC-1"	"G"
"GCGGTGTGTCGATTAC-1"	"G"
"GCGGTGTGTGCGTCCA-1"	"A"
"GCGGTGTTCTCCAACC-1"	"A"
"GCGGTGTTCTGGCACG-1"	"A"
"GCGGTGTTCTGTTGCC-1"	"G"
"GCGTAGCAGGAGTCTG-1"	"A"
"GCGTAGCAGGCCTCTG-1"	"G"
"GCGTAGCCAAAGCTTC-1"	"G"
"GCGTAGCCACAAGTGG-1"	"G"
"GCGTAGCCACTGATTG-1"	"G"
"GCGTAGCCATGGTATC-1"	"G"
"GCGTAGCGTAACGGTG-1"	"G"
"GCGTAGCGTTGGCTTA-1"	"A"
"GCGTAGCGTTTGTACG-1"	"A"
"GCGTAGCTCGACGGAA-1"	"A"
"GCGTAGCTCGCGCCAA-1"	"A"
"GCGTAGCTCTACATCT-1"	"G"
"GCGTTGGAGATGCGCA-1"	"A"
"GCGTTGGAGCAACGGT-1"	"G"
"GCGTTGGGTAAACGAT-1"	"A"
"GCGTTGGGTAGACGCA-1"	"G"
"GCGTTGGGTAGGTCTT-1"	"A"
"GCGTTGGGTCCAAGTT-1"	"A"
"GCGTTGGGTCCGTGCA-1"	"A"
"GCGTTGGGTTCACGTA-1"	"G"
"GCGTTGGGTTGTGACT-1"	"A"
"GCGTTGGTCGGGACAA-1"	"A"
"GCGTTGGTCGTTTGAG-1"	"A"
"GCGTTGGTCTCCCTTT-1"	"A"
"GCTCACTAGGCATGCA-1"	"A"
"GCTCACTAGGGCATTG-1"	"A"
"GCTCACTAGGTTTCTG-1"	"A"
"GCTCACTCAAGCAACG-1"	"G"
"GCTCACTGTTAGGAAT-1"	"A"
"GCTCAGGAGGTGAACC-1"	"G"
"GCTCAGGAGTTACCAC-1"	"G"
"GCTCAGGCACAGTTCA-1"	"G"
"GCTCAGGCACGCGATC-1"	"A"
"GCTCAGGCATCTGCAA-1"	"G"
"GCTCAGGGTACTTGAC-1"	"A"
"GCTCAGGGTAGTCTGT-1"	"A"
"GCTCAGGGTTTAGACC-1"	"A"
"GCTCAGGTCCGCTCTA-1"	"A"
"GCTCAGGTCGGTCTCT-1"	"A"
"GCTCCTACAAGAGATT-1"	"A"
"GCTCCTACAAGCTTTG-1"	"A"
"GCTCCTACACCTCGTT-1"	"G"
"GCTCCTACATAAAGTG-1"	"A"
"GCTCCTAGTACAAGCG-1"	"G"
"GCTCCTAGTATGTCCA-1"	"G"
"GCTCCTAGTTACGCTA-1"	"A"
"GCTCCTAGTTAGGCTT-1"	"A"
"GCTCCTATCACTCCCA-1"	"G"
"GCTCCTATCAGGATCT-1"	"A"
"GCTCCTATCCCAGCGA-1"	"A"
"GCTCCTATCGGGACAA-1"	"G"
"GCTCCTATCTTAAGCG-1"	"A"
"GCTCGAGAGTAGTGTA-1"	"A"
"GCTCGAGCAGGACTGA-1"	"A"
"GCTCGAGGTAATGTGA-1"	"A"
"GCTCGAGGTCATAAGA-1"	"A"
"GCTCGAGGTCCGTCGA-1"	"A"
"GCTCGAGTCACGTCAA-1"	"G"
"GCTCGAGTCGATAGTC-1"	"A"
"GCTCGAGTCGTGCTTC-1"	"G"
"GCTGAGCAGCTGAATA-1"	"A"
"GCTGAGCAGGCAATTA-1"	"G"
"GCTGAGCAGGGTAATT-1"	"A"
"GCTGAGCCAGCTTACA-1"	"G"
"GCTGAGCGTATGGATA-1"	"A"
"GCTGAGCGTATTCTCT-1"	"G"
"GCTGAGCGTTAGAGAT-1"	"A"
"GCTGAGCTCCAATCCC-1"	"A"
"GCTGCGAAGAGAGTTT-1"	"G"
"GCTGCGAAGGTTCGAG-1"	"G"
"GCTGCGAAGTAATCAG-1"	"G"
"GCTGCGAAGTGCTGAG-1"	"A"
"GCTGCGACATTTGGTG-1"	"G"
"GCTGCGAGTAATGCAA-1"	"G"
"GCTGCGAGTCGAGAAC-1"	"G"
"GCTGCGAGTTCCTATT-1"	"A"
"GCTGCGATCATCGCTC-1"	"A"
"GCTGCGATCCGGCGAT-1"	"A"
"GCTGCGATCGAGCGCT-1"	"A"
"GCTGCGATCTGAACGT-1"	"G"
"GCTGTTCAGAGGTACC-1"	"A"
"GCTGTTCAGGTTAACA-1"	"A"
"GCTGTTCAGTGCTGAG-1"	"A"
"GCTGTTCCAAGCCAGA-1"	"G"
"GCTGTTCCACTAGCCG-1"	"G"
"GCTGTTCGTCTAAAGA-1"	"G"
"GCTGTTCGTCTCTAAG-1"	"A"
"GCTGTTCGTGCATTGT-1"	"A"
"GCTGTTCGTGGTGGTA-1"	"G"
"GCTGTTCGTTTCAGCA-1"	"A"
"GCTGTTCTCAGTGGTT-1"	"A"
"GCTGTTCTCCGGCGAT-1"	"A"
"GCTGTTCTCCTGACCT-1"	"G"
"GCTTAAGAGAAAGGGT-1"	"G"
"GCTTAAGAGATACCAA-1"	"A"
"GCTTAAGAGGGCGAAG-1"	"G"
"GCTTAAGGTAGACACG-1"	"A"
"GCTTAAGGTCCCGTGA-1"	"A"
"GCTTAAGGTCCCTTTG-1"	"A"
"GCTTAAGGTTTAAGCC-1"	"A"
"GCTTAAGGTTTCAGCA-1"	"G"
"GCTTAAGTCGAGGTCC-1"	"A"
"GCTTAAGTCGCGCCAA-1"	"A"
"GCTTAAGTCGCTGATA-1"	"G"
"GCTTAAGTCTCCTTGG-1"	"G"
"GCTTGCTAGAGAAGCA-1"	"G"
"GCTTGCTAGAGGTCCA-1"	"G"
"GCTTGCTAGCTGAATA-1"	"A"
"GCTTGCTAGGCAAGGG-1"	"A"
"GCTTGCTCAATCCATG-1"	"G"
"GCTTGCTGTATACGCT-1"	"A"
"GCTTGCTGTATTGTGC-1"	"A"
"GCTTGCTGTCCTATTT-1"	"G"
"GCTTGCTTCCAGAGAG-1"	"A"
"GCTTGCTTCGTTCCGT-1"	"G"
"GCTTGCTTCTCCAACC-1"	"A"
"GCTTTCGAGAGCAGCT-1"	"A"
"GCTTTCGAGGTGATGC-1"	"A"
"GCTTTCGAGTGGTGTG-1"	"G"
"GCTTTCGCACCTGAAT-1"	"G"
"GCTTTCGGTACCAAGG-1"	"A"
"GCTTTCGGTACGTAAA-1"	"G"
"GCTTTCGGTCAACTAC-1"	"A"
"GCTTTCGGTCATCGTA-1"	"G"
"GCTTTCGGTGTCCTTC-1"	"G"
"GCTTTCGTCATTGCCC-1"	"A"
"GGAACCCAGACAGCTG-1"	"G"
"GGAACCCAGACAGTGC-1"	"G"
"GGAACCCAGTGATCTC-1"	"A"
"GGAACCCCAGTATACC-1"	"A"
"GGAACCCCATCACAGT-1"	"G"
"GGAACCCCATTACCTT-1"	"G"
"GGAACCCGTATGTCCA-1"	"A"
"GGAACCCGTCACCCGA-1"	"A"
"GGAACCCGTCAGGCTC-1"	"G"
"GGAACCCGTTCAGAAA-1"	"A"
"GGAACCCTCCACGCTT-1"	"A"
"GGAACCCTCTTACGGA-1"	"G"
"GGAACTTAGGATATCA-1"	"G"
"GGAACTTAGGTTGTTC-1"	"G"
"GGAACTTAGTAGACCG-1"	"G"
"GGAACTTAGTGTCGGA-1"	"A"
"GGAACTTCAATAGTGA-1"	"A"
"GGAACTTCAGTAGGCA-1"	"A"
"GGAACTTTCCGATTGA-1"	"G"
"GGAACTTTCGCGTGAC-1"	"G"
"GGAACTTTCGTTTGAG-1"	"G"
"GGAACTTTCTCTATCA-1"	"A"
"GGAATCTAGTTAGCGG-1"	"A"
"GGAATCTCAAGTAATG-1"	"A"
"GGAATCTCAAGTCTCA-1"	"A"
"GGAATCTCATGATTGC-1"	"A"
"GGAATCTGTCCACCAG-1"	"A"
"GGAATCTGTGAGTAAT-1"	"A"
"GGAATCTGTGGCGCTT-1"	"A"
"GGAATCTTCCACGCTT-1"	"G"
"GGAATCTTCTCCCTTT-1"	"G"
"GGAATCTTCTGGTACA-1"	"A"
"GGACACCAGCTCGTTA-1"	"A"
"GGACACCAGTACCTCA-1"	"G"
"GGACACCAGTCTCGAT-1"	"G"
"GGACACCCACTTATGG-1"	"G"
"GGACACCCATGGCCTG-1"	"G"
"GGACACCGTAACTCCA-1"	"G"
"GGACACCGTGTCCTTC-1"	"A"
"GGACACCGTTAAGTCC-1"	"G"
"GGACACCTCGCTGATA-1"	"A"
"GGACACCTCTGTTTAC-1"	"G"
"GGAGAACAGGCTAAAT-1"	"G"
"GGAGAACAGTTACCAC-1"	"A"
"GGAGAACCACATCATG-1"	"G"
"GGAGAACCAGCCGAAA-1"	"A"
"GGAGAACCATGCGACC-1"	"A"
"GGAGAACCATGGCCCA-1"	"G"
"GGAGAACGTAGGTCTT-1"	"A"
"GGAGAACGTATACGCT-1"	"A"
"GGAGAACTCCATTGTT-1"	"A"
"GGAGAACTCCGATGCG-1"	"A"
"GGAGGATAGAGAATTC-1"	"G"
"GGAGGATAGAGTGGAA-1"	"A"
"GGAGGATAGATATGTG-1"	"A"
"GGAGGATAGCGCATTT-1"	"G"
"GGAGGATAGGCCAATG-1"	"A"
"GGAGGATAGTCGATAA-1"	"A"
"GGAGGATCAACACGGA-1"	"G"
"GGAGGATCAATGTAAG-1"	"A"
"GGAGGATCACGCTCAG-1"	"A"
"GGAGGATCAGCTGATT-1"	"A"
"GGAGGATCATTACTTC-1"	"A"
"GGAGGATGTGGTTCTA-1"	"G"
"GGAGGATGTTACCCAA-1"	"A"
"GGAGGATGTTCTGATG-1"	"A"
"GGAGGATTCCCGTATC-1"	"A"
"GGAGGATTCCTAAGTG-1"	"A"
"GGAGTAGAGATCTAAG-1"	"A"
"GGAGTAGAGCATTCCA-1"	"G"
"GGAGTAGAGGCATGCA-1"	"G"
"GGAGTAGAGGGCTTCC-1"	"A"
"GGAGTAGCAACTCAAC-1"	"A"
"GGAGTAGCAATTAGGA-1"	"G"
"GGAGTAGCACACTAGT-1"	"G"
"GGAGTAGGTAAAGCTA-1"	"A"
"GGAGTAGGTACGGAGT-1"	"G"
"GGAGTAGGTGGACTGA-1"	"A"
"GGAGTAGGTTATGCAC-1"	"G"
"GGAGTAGTCTCTTAAC-1"	"G"
"GGAGTAGTCTGAAAGA-1"	"G"
"GGATAGGAGAACGTTA-1"	"G"
"GGATAGGAGGTTCTCA-1"	"A"
"GGATAGGAGTAACACA-1"	"G"
"GGATAGGCAAACTACC-1"	"G"
"GGATAGGCAAGACTAA-1"	"G"
"GGATAGGCATGGGAAC-1"	"A"
"GGATAGGGTACGTATC-1"	"G"
"GGATAGGGTATCATGC-1"	"G"
"GGATAGGGTCATAGCT-1"	"A"
"GGATAGGGTCCCGTGA-1"	"G"
"GGATAGGGTCTGGGAA-1"	"A"
"GGATAGGTCCCGAAGC-1"	"G"
"GGATAGGTCGCCGAAC-1"	"G"
"GGATAGGTCTGGCCAG-1"	"G"
"GGATAGGTCTTACTCA-1"	"A"
"GGATAGGTCTTCCGTG-1"	"G"
"GGATGAGAGGTTAGTA-1"	"G"
"GGATGAGAGTGTCGGA-1"	"G"
"GGATGAGCACAAGTGG-1"	"G"
"GGATGAGCAGCACATT-1"	"G"
"GGATGAGCATAGAATG-1"	"A"
"GGATGAGGTGGACTGA-1"	"A"
"GGATGAGTCAAACCCA-1"	"A"
"GGATGAGTCCATCGAA-1"	"A"
"GGATGAGTCTATTTCG-1"	"A"
"GGATGAGTCTTGTACT-1"	"A"
"GGCACGTAGAACCCGA-1"	"G"
"GGCACGTAGATGCGCA-1"	"G"
"GGCACGTAGTATACCC-1"	"G"
"GGCACGTAGTCATACC-1"	"G"
"GGCACGTCAGAACGAC-1"	"G"
"GGCACGTCAGGCACAA-1"	"G"
"GGCACGTCATCCCGGA-1"	"G"
"GGCACGTCATCGTACA-1"	"G"
"GGCACGTCATTGCACA-1"	"A"
"GGCACGTGTGATAGAT-1"	"A"
"GGCACGTTCCAGAATC-1"	"G"
"GGCACGTTCGAGGTCC-1"	"A"
"GGCACGTTCTCGACCT-1"	"G"
"GGCATTAAGGATGTAT-1"	"A"
"GGCATTAAGGGATCCA-1"	"G"
"GGCATTAAGTCCAGAG-1"	"A"
"GGCATTACAGAACGAC-1"	"G"
"GGCATTACAGGATGTG-1"	"G"
"GGCATTAGTGAATACA-1"	"G"
"GGCATTAGTGCTGTGC-1"	"G"
"GGCATTAGTGTCTCGG-1"	"G"
"GGCATTAGTTCCAGTA-1"	"A"
"GGCATTAGTTTCCGGG-1"	"A"
"GGCATTATCCGAGGAA-1"	"G"
"GGCGAAAAGAAGGGCG-1"	"A"
"GGCGAAAAGAATAGTC-1"	"G"
"GGCGAAAAGACCGCAA-1"	"A"
"GGCGAAAAGAGAAGCA-1"	"G"
"GGCGAAAAGCATACCT-1"	"A"
"GGCGAAAAGGACTTTC-1"	"G"
"GGCGAAAAGTGTCGCC-1"	"G"
"GGCGAAACACCACGAC-1"	"A"
"GGCGAAACAGGTGTGA-1"	"G"
"GGCGAAACAGTTGGAG-1"	"A"
"GGCGAAACATCCGTAA-1"	"G"
"GGCGAAACATTCCCGT-1"	"A"
"GGCGAAAGTACGTAAA-1"	"G"
"GGCGAAAGTCAGCTTA-1"	"G"
"GGCGAAAGTTCTACGA-1"	"A"
"GGCGAAATCAAACCCA-1"	"A"
"GGCGAAATCGCCACTT-1"	"G"
"GGCGAAATCGCTACCT-1"	"A"
"GGCGAAATCGTTTGAG-1"	"A"
"GGCGTTGAGAGAACCC-1"	"A"
"GGCGTTGAGATATGTG-1"	"G"
"GGCGTTGAGCTGCCAC-1"	"G"
"GGCGTTGAGCTTTCCC-1"	"G"
"GGCGTTGAGTGATCTC-1"	"A"
"GGCGTTGAGTGCAACG-1"	"A"
"GGCGTTGCACTACACA-1"	"A"
"GGCGTTGCATCCATAG-1"	"G"
"GGCGTTGGTAAACGAT-1"	"A"
"GGCGTTGGTTTCCTAT-1"	"G"
"GGCGTTGTCCAGGGAA-1"	"A"
"GGCGTTGTCGGATAAA-1"	"A"
"GGGAACAAGTAGGAAG-1"	"A"
"GGGAACACAAGCCAGA-1"	"A"
"GGGAACACAAGTGGCA-1"	"G"
"GGGAACACAGAAGTGC-1"	"G"
"GGGAACAGTTCACGTA-1"	"A"
"GGGAACAGTTTCGATG-1"	"A"
"GGGAACATCAAACCAC-1"	"A"
"GGGAACATCAGTCAAC-1"	"G"
"GGGAACATCATGAACC-1"	"A"
"GGGAACATCGATGAAA-1"	"A"
"GGGAACATCGCTTACC-1"	"G"
"GGGACCTAGAAAGGGT-1"	"A"
"GGGACCTAGATCGATA-1"	"A"
"GGGACCTAGTCTCCAA-1"	"A"
"GGGACCTAGTGAAGGA-1"	"A"
"GGGACCTCAGCAACCC-1"	"G"
"GGGACCTCATGGCCGT-1"	"A"
"GGGACCTGTGGTTCTA-1"	"A"
"GGGACCTGTTGGTAAA-1"	"A"
"GGGACCTTCACTACCC-1"	"G"
"GGGACCTTCGAGGTAG-1"	"G"
"GGGCCATAGACCCTAT-1"	"G"
"GGGCCATAGCTTACCA-1"	"A"
"GGGCCATAGGTCACTT-1"	"A"
"GGGCCATCAAGATTAG-1"	"A"
"GGGCCATCAAGCGGTA-1"	"G"
"GGGCCATCACCTGTGG-1"	"G"
"GGGCCATCATAGATAG-1"	"G"
"GGGCCATCATTCACCC-1"	"G"
"GGGCCATGTAGCAGGT-1"	"A"
"GGGCCATGTCGCGCTA-1"	"A"
"GGGCCATGTGCACTTA-1"	"A"
"GGGCCATGTGCGACCT-1"	"G"
"GGGCCATTCCAAACCA-1"	"G"
"GGGCCATTCTGTTTAC-1"	"G"
"GGGTCTGAGACACGGT-1"	"G"
"GGGTCTGAGCGTATCT-1"	"G"
"GGGTCTGAGCTGAATA-1"	"A"
"GGGTCTGAGGCAGTGT-1"	"G"
"GGGTCTGCAACGCACC-1"	"A"
"GGGTCTGCACTCAAGT-1"	"A"
"GGGTCTGCACTTATGG-1"	"A"
"GGGTCTGCAGGAGCAT-1"	"G"
"GGGTCTGCAGGGTACA-1"	"G"
"GGGTCTGCATTGCACA-1"	"A"
"GGGTCTGGTAGGTCTT-1"	"A"
"GGGTCTGGTCGAGGAT-1"	"A"
"GGGTCTGGTGGAAAGA-1"	"A"
"GGGTCTGGTTCTGATG-1"	"A"
"GGGTCTGTCCCACTTG-1"	"A"
"GGGTCTGTCGGTAGGA-1"	"A"
"GGGTCTGTCTAGCTGA-1"	"A"
"GGGTCTGTCTGTTGCC-1"	"A"
"GGGTGTCCAAGCAGGT-1"	"A"
"GGGTGTCCAGGACTGA-1"	"A"
"GGGTGTCCATTGAACC-1"	"G"
"GGGTGTCGTCTGTTGA-1"	"G"
"GGGTGTCGTTTGTAGC-1"	"G"
"GGGTGTCTCAGGCCGT-1"	"A"
"GGGTGTCTCTATCTCA-1"	"G"
"GGGTTATAGAACCCGA-1"	"G"
"GGGTTATAGACAACGC-1"	"G"
"GGGTTATAGCCTATAC-1"	"A"
"GGGTTATAGTCGATAA-1"	"G"
"GGGTTATCAACGGACA-1"	"A"
"GGGTTATCACGATATC-1"	"A"
"GGGTTATCAGCAACAG-1"	"G"
"GGGTTATGTTGAAGCG-1"	"A"
"GGGTTATTCCATCATT-1"	"A"
"GGGTTATTCCCACTTG-1"	"G"
"GGGTTATTCGTTGTAG-1"	"G"
"GGGTTATTCTATGAGC-1"	"A"
"GGTACCGCACTGATAC-1"	"G"
"GGTACCGGTACGGTTT-1"	"G"
"GGTACCGGTTAGTAGA-1"	"A"
"GGTACCGTCAACACGT-1"	"G"
"GGTACCGTCAACTTGG-1"	"G"
"GGTACCGTCCTTACGC-1"	"A"
"GGTAGGAAGCTTTCCC-1"	"G"
"GGTAGGAAGGTTAGTA-1"	"G"
"GGTAGGACAAATGCTC-1"	"G"
"GGTAGGACACGTTGTA-1"	"A"
"GGTAGGACACTGTCGG-1"	"A"
"GGTAGGACAGAACAGC-1"	"A"
"GGTAGGAGTAGGTGAC-1"	"G"
"GGTAGGAGTCCAGACC-1"	"A"
"GGTCATAAGAAACGCC-1"	"A"
"GGTCATAAGCCAGAAC-1"	"G"
"GGTCATAAGTCCGATT-1"	"A"
"GGTCATACAAGGTCGA-1"	"A"
"GGTCATACAAGTAATG-1"	"G"
"GGTCATACAATGGCTT-1"	"A"
"GGTCATACACACATGT-1"	"G"
"GGTCATACAGAGAGAA-1"	"G"
"GGTCATACATTGCCTC-1"	"A"
"GGTCATAGTAAACGTA-1"	"A"
"GGTCATAGTAACGTAA-1"	"A"
"GGTCATAGTAGAAAGG-1"	"G"
"GGTCATAGTATCGCGC-1"	"G"
"GGTCATAGTTAGAGAT-1"	"A"
"GGTCATATCACTGATG-1"	"A"
"GGTCATATCGAAGCCC-1"	"A"
"GGTCATATCGAGGTAG-1"	"A"
"GGTCATATCGTCTAGA-1"	"A"
"GGTCATATCGTTGTTT-1"	"A"
"GGTGAAGAGACAACGC-1"	"A"
"GGTGAAGAGACGAAAG-1"	"A"
"GGTGAAGAGATGCGCA-1"	"G"
"GGTGAAGAGGGTTCTT-1"	"G"
"GGTGAAGAGTATAGTG-1"	"A"
"GGTGAAGCAAGTAACA-1"	"G"
"GGTGAAGGTAACCGAG-1"	"A"
"GGTGAAGGTACGGATG-1"	"A"
"GGTGAAGTCCCAATGA-1"	"G"
"GGTGAAGTCGCAAACT-1"	"G"
"GGTGAAGTCGGTAGGA-1"	"A"
"GGTGAAGTCTATCTCA-1"	"A"
"GGTGCTGAGCGCACAA-1"	"A"
"GGTGCTGAGGGAAATG-1"	"A"
"GGTGCTGAGTACAACA-1"	"G"
"GGTGCTGCAAGGGAGG-1"	"A"
"GGTGCTGCAATTCGTG-1"	"A"
"GGTGCTGCATTAAGGA-1"	"A"
"GGTGCTGCATTAGCAC-1"	"A"
"GGTGCTGGTACGAGAC-1"	"A"
"GGTGCTGGTAGAGAGA-1"	"G"
"GGTGCTGGTCAGTGTT-1"	"A"
"GGTGCTGGTTCCCGGA-1"	"A"
"GGTGCTGTCAAGAGGC-1"	"G"
"GGTGCTGTCTAGCTGA-1"	"G"
"GGTGTCGAGGCTAAAT-1"	"A"
"GGTGTCGAGTCACGCC-1"	"A"
"GGTGTCGAGTTGCGCC-1"	"A"
"GGTGTCGCAAGTCTCA-1"	"A"
"GGTGTCGCAAGTGGCA-1"	"G"
"GGTGTCGCACGATATC-1"	"G"
"GGTGTCGCACGCCGAT-1"	"A"
"GGTGTCGCAGCGCGTT-1"	"G"
"GGTGTCGGTGATGCTT-1"	"G"
"GGTGTCGTCATACTTC-1"	"A"
"GGTGTCGTCGACTTAG-1"	"A"
"GGTGTCGTCGTGGAAG-1"	"A"
"GGTTGCGAGGCAGTGT-1"	"A"
"GGTTGCGAGTGGGACT-1"	"G"
"GGTTGCGAGTTCGACT-1"	"A"
"GGTTGCGCAACGCAAG-1"	"G"
"GGTTGCGCACTGAAGG-1"	"A"
"GGTTGCGGTCCGAGCT-1"	"G"
"GGTTGCGGTCTCAAAC-1"	"A"
"GGTTGCGGTCTGTTGA-1"	"G"
"GGTTGCGGTGACGCAA-1"	"A"
"GGTTGCGGTGCCCGAT-1"	"G"
"GGTTGCGGTGGACCAA-1"	"G"
"GGTTGCGTCCCACGGA-1"	"G"
"GGTTGCGTCGATATGC-1"	"A"
"GGTTGCGTCGATCGCG-1"	"G"
"GTAATCGAGACGCCCT-1"	"A"
"GTAATCGAGAGGTACC-1"	"A"
"GTAATCGAGTAACACA-1"	"G"
"GTAATCGAGTCAACTC-1"	"A"
"GTAATCGGTCACCCGA-1"	"A"
"GTAATCGGTGCAAAGC-1"	"G"
"GTAATCGGTTCTTAGG-1"	"A"
"GTAATCGGTTGGAGGT-1"	"A"
"GTAATCGTCCGAGAGA-1"	"A"
"GTAATCGTCCTCAAGA-1"	"A"
"GTAATCGTCGATAGCT-1"	"A"
"GTACTTTAGAGTTCGG-1"	"A"
"GTACTTTAGCAGAGCT-1"	"G"
"GTACTTTAGGATCCTT-1"	"A"
"GTACTTTAGGCGTCCT-1"	"A"
"GTACTTTAGGCTCAGA-1"	"A"
"GTACTTTAGGGCTTCC-1"	"G"
"GTACTTTAGTTGGAAT-1"	"A"
"GTACTTTCACCCATCT-1"	"G"
"GTACTTTCAGCAACAG-1"	"G"
"GTACTTTGTAGAACGC-1"	"A"
"GTACTTTGTGAGGTCA-1"	"A"
"GTACTTTGTGGTTCTA-1"	"G"
"GTACTTTTCAGTGTAC-1"	"A"
"GTACTTTTCAGTGTGT-1"	"A"
"GTACTTTTCATCGCCT-1"	"A"
"GTACTTTTCGATCGCG-1"	"G"
"GTACTTTTCGCTATTT-1"	"A"
"GTACTTTTCTTGTCGC-1"	"A"
"GTAGACTAGACCCATT-1"	"A"
"GTAGACTAGATCGAGC-1"	"G"
"GTAGACTCAATTGGCT-1"	"A"
"GTAGACTCACGTTGTA-1"	"A"
"GTAGACTCATACTGCA-1"	"G"
"GTAGACTCATGCGTTA-1"	"G"
"GTAGACTGTATGAAGT-1"	"A"
"GTAGACTGTTAGAGAT-1"	"G"
"GTAGACTTCCTGGAAT-1"	"G"
"GTAGACTTCGGTCAGC-1"	"G"
"GTAGGAGAGCATGTGG-1"	"A"
"GTAGGAGCAATGGTAA-1"	"G"
"GTAGGAGCAGTAAGCG-1"	"A"
"GTAGGAGGTAAACGGC-1"	"A"
"GTAGGAGGTTACCCAA-1"	"A"
"GTAGGAGGTTACGAAA-1"	"A"
"GTAGGAGGTTACTACG-1"	"A"
"GTAGTACAGCAGAGCT-1"	"A"
"GTAGTACCAACCTCCT-1"	"A"
"GTAGTACCACCTGTGG-1"	"A"
"GTAGTACCACTAGGAG-1"	"A"
"GTAGTACGTAACCCAT-1"	"A"
"GTAGTACGTAACGTAA-1"	"G"
"GTAGTACGTTCTTTGT-1"	"G"
"GTAGTACGTTTCCGGG-1"	"G"
"GTAGTACGTTTGTAGC-1"	"G"
"GTCACAAAGTAATCAG-1"	"A"
"GTCACAACACAGTTCA-1"	"A"
"GTCACAACAGGTAACG-1"	"G"
"GTCACAACAGTTGGAG-1"	"A"
"GTCACAACATGGGTGA-1"	"A"
"GTCACAAGTAACCATC-1"	"G"
"GTCACAAGTAATGCAA-1"	"G"
"GTCACAAGTACTAGAA-1"	"G"
"GTCACAAGTCTAACCA-1"	"G"
"GTCACAAGTGCCGGTT-1"	"A"
"GTCACAAGTGTGCTTA-1"	"A"
"GTCACAAGTTCCAATG-1"	"A"
"GTCACAATCGAGGTCC-1"	"A"
"GTCACAATCGCAGATT-1"	"G"
"GTCACAATCGGGAAAC-1"	"A"
"GTCACAATCGTAGCGC-1"	"A"
"GTCACCTCAATCAGGG-1"	"G"
"GTCACCTCAATGTGCT-1"	"G"
"GTCACCTGTCGTAATC-1"	"A"
"GTCACCTGTGAATGTA-1"	"A"
"GTCACCTGTGATGTGG-1"	"G"
"GTCACCTTCATCGCAA-1"	"G"
"GTCACCTTCCGGACTG-1"	"G"
"GTCACCTTCGTGTGCG-1"	"G"
"GTCACCTTCTGAGTCA-1"	"G"
"GTCACGGAGGAGACTC-1"	"G"
"GTCACGGAGGCAATTA-1"	"G"
"GTCACGGAGTGCACAG-1"	"G"
"GTCACGGCAAGTAATG-1"	"A"
"GTCACGGCAGTTGGAG-1"	"A"
"GTCACGGTCATGAACC-1"	"G"
"GTCACGGTCGCTATAG-1"	"A"
"GTCACTCAGAGGTCCA-1"	"A"
"GTCACTCAGCTGCTCG-1"	"A"
"GTCACTCCAGGTCCTG-1"	"A"
"GTCACTCCAGGTGTCC-1"	"A"
"GTCACTCCATTATGGC-1"	"G"
"GTCACTCGTGCTAGTT-1"	"A"
"GTCACTCGTGGAAGCT-1"	"A"
"GTCACTCGTTCACGTA-1"	"A"
"GTCACTCGTTCCTATT-1"	"A"
"GTCACTCGTTTCAGCA-1"	"A"
"GTCACTCTCAATTGGC-1"	"A"
"GTCACTCTCAGCCGAC-1"	"A"
"GTCACTCTCTATCCTA-1"	"A"
"GTCCATCAGAGGTGGG-1"	"A"
"GTCCATCAGATGTTGA-1"	"G"
"GTCCATCAGCTAGTTC-1"	"A"
"GTCCATCAGTCCAGAG-1"	"G"
"GTCCATCAGTCTGGGA-1"	"A"
"GTCCATCCAACCTCTC-1"	"G"
"GTCCATCCAGGTGTCC-1"	"G"
"GTCCATCGTATTGTGC-1"	"A"
"GTCCATCGTCAGTGTT-1"	"G"
"GTCCATCTCCAGTACA-1"	"G"
"GTCCATCTCGACTCGG-1"	"A"
"GTCCATCTCGCAAACT-1"	"A"
"GTCCATCTCGGCATAT-1"	"A"
"GTCCATCTCTGATCCC-1"	"A"
"GTCGTAAAGAAAGCAG-1"	"A"
"GTCGTAAAGCCTATAC-1"	"G"
"GTCGTAAAGTGAACCG-1"	"G"
"GTCGTAACAACGCACC-1"	"A"
"GTCGTAACAATTCGTG-1"	"A"
"GTCGTAACACGCGATC-1"	"G"
"GTCGTAACAGCTGATT-1"	"G"
"GTCGTAACAGTCAGAG-1"	"G"
"GTCGTAAGTAAACGAT-1"	"A"
"GTCGTAAGTATGCTAC-1"	"G"
"GTCGTAAGTCCGGTAC-1"	"A"
"GTCGTAAGTGGTGGTA-1"	"A"
"GTCGTAAGTTGGTAAA-1"	"G"
"GTCGTAAGTTTAGAAG-1"	"G"
"GTCGTAATCTGGCTAA-1"	"A"
"GTCTACCAGCATTGGG-1"	"A"
"GTCTACCAGTATGCTC-1"	"A"
"GTCTACCCACAGTTAC-1"	"G"
"GTCTACCCACCATTCC-1"	"A"
"GTCTACCCACCTGGTG-1"	"G"
"GTCTACCGTAAAGGCC-1"	"G"
"GTCTACCGTACCAAGG-1"	"A"
"GTCTACCGTGAAACAT-1"	"G"
"GTCTACCGTGACGCAA-1"	"A"
"GTCTACCGTTCAGTTG-1"	"A"
"GTGACATAGGACCGAT-1"	"A"
"GTGACATAGTCCAGAG-1"	"G"
"GTGACATAGTCTGGGA-1"	"G"
"GTGACATCACTTATGG-1"	"A"
"GTGACATCACTTGCGG-1"	"A"
"GTGACATCAGACTAAA-1"	"A"
"GTGACATGTATCGCGC-1"	"G"
"GTGACATGTCTGCGCA-1"	"G"
"GTGACATGTTTCGACA-1"	"A"
"GTGACATTCGCTATAG-1"	"A"
"GTGACATTCGTTACAG-1"	"A"
"GTGACATTCTATCTTG-1"	"G"
"GTGATCAAGCCGCTGT-1"	"A"
"GTGATCAAGTGTCACT-1"	"A"
"GTGATCACACTGAAGG-1"	"A"
"GTGATCACAGACCTGC-1"	"G"
"GTGATCACATCTCACC-1"	"G"
"GTGATCAGTACGAGAC-1"	"A"
"GTGATCAGTAGCAGCA-1"	"G"
"GTGATCAGTCAGTGCC-1"	"G"
"GTGATCAGTGGATTTC-1"	"G"
"GTGATCAGTGGCCTTG-1"	"G"
"GTGATCAGTGGTGGTA-1"	"A"
"GTGATCAGTTCTTTGT-1"	"A"
"GTGATCATCATTGCCC-1"	"A"
"GTGATCATCGCTTACC-1"	"G"
"GTGATCATCGGGAAAC-1"	"G"
"GTGATCATCGTGCTTC-1"	"A"
"GTGATCATCTTATCAC-1"	"G"
"GTGCACGAGCAATGTA-1"	"G"
"GTGCACGAGCGCAATG-1"	"A"
"GTGCACGAGCTGGAGT-1"	"G"
"GTGCACGAGTAATGTG-1"	"G"
"GTGCACGCAAACCCTA-1"	"A"
"GTGCACGCACGGCCAT-1"	"G"
"GTGCACGCAGATGGCA-1"	"A"
"GTGCACGGTCAGGCTC-1"	"A"
"GTGCACGGTGACAAGC-1"	"G"
"GTGCACGGTGATGCTT-1"	"A"
"GTGCACGGTGTGACCC-1"	"A"
"GTGCACGTCCAGGTAT-1"	"G"
"GTGCACGTCCTATCCG-1"	"A"
"GTGCACGTCGTTCCGT-1"	"A"
"GTGCACGTCTTCATAC-1"	"G"
"GTGCCAGAGAGCCACA-1"	"A"
"GTGCCAGCATAAAGTG-1"	"A"
"GTGCCAGGTCCCTAAA-1"	"G"
"GTGCCAGTCACCGCGA-1"	"A"
"GTGCCAGTCGAAGCCC-1"	"A"
"GTGCCAGTCGTCTAGA-1"	"G"
"GTGCCAGTCTCCTTAA-1"	"A"
"GTGCCAGTCTTCACTA-1"	"A"
"GTGCTGGAGCCATTCA-1"	"A"
"GTGCTGGAGGGTTCTT-1"	"A"
"GTGCTGGAGTCCGATT-1"	"A"
"GTGCTGGAGTCCGGAA-1"	"A"
"GTGCTGGCACTAAACC-1"	"A"
"GTGCTGGCATCGACCG-1"	"A"
"GTGCTGGTCAACTTGG-1"	"A"
"GTGCTGGTCCCAATGA-1"	"G"
"GTGCTGGTCCGTGCGA-1"	"G"
"GTGCTGGTCTGGTACA-1"	"G"
"GTGCTGGTCTTTATCG-1"	"A"
"GTGGATTGTATCGCGC-1"	"G"
"GTGGATTTCGCTATTT-1"	"G"
"GTGGCGTAGCAACGGT-1"	"G"
"GTGGCGTCACGACGAA-1"	"A"
"GTGGCGTCATACAACC-1"	"G"
"GTGGCGTCATATTGGC-1"	"A"
"GTGGCGTCATCACAAC-1"	"G"
"GTGGCGTCATTTGTTC-1"	"A"
"GTGGCGTGTATTTGCG-1"	"G"
"GTGGCGTGTCGATTAC-1"	"G"
"GTGGCGTGTCGGCTGT-1"	"G"
"GTGGCGTTCACTCGGG-1"	"G"
"GTGGCGTTCGGTTAGT-1"	"G"
"GTGGCGTTCGTTCTAT-1"	"A"
"GTGTCAACAGCAATGG-1"	"A"
"GTGTCAACAGGACCTC-1"	"A"
"GTGTCAACAGTCCTGG-1"	"G"
"GTGTCAAGTAACATAG-1"	"A"
"GTGTCAAGTAACGGCA-1"	"A"
"GTGTCAAGTCAGAGTG-1"	"A"
"GTGTCAAGTGTGACCC-1"	"A"
"GTGTCAATCACAAGCT-1"	"G"
"GTGTCAATCGGTCTAA-1"	"G"
"GTGTCCTAGAAGCCTG-1"	"A"
"GTGTCCTAGGATTGCG-1"	"A"
"GTGTCCTCAACATAAG-1"	"G"
"GTGTCCTCAAGGTCGA-1"	"G"
"GTGTCCTCAGTAACGG-1"	"G"
"GTGTCCTGTATTTGCG-1"	"G"
"GTGTGATAGAACGCCA-1"	"G"
"GTGTGATAGAGAAGCA-1"	"G"
"GTGTGATAGCAATAAC-1"	"A"
"GTGTGATAGTCACGCC-1"	"A"
"GTGTGATAGTGGACGT-1"	"A"
"GTGTGATCACTGTTAG-1"	"A"
"GTGTGATGTGGTAAGC-1"	"G"
"GTGTGATTCGACTTAG-1"	"A"
"GTTACGAAGAAGGGCG-1"	"G"
"GTTACGAAGGATGCCA-1"	"G"
"GTTACGAAGTAACTCC-1"	"G"
"GTTACGACAAGACACG-1"	"G"
"GTTACGACACGTGAAG-1"	"A"
"GTTACGACAGCGTACC-1"	"A"
"GTTACGACAGTAAGAT-1"	"A"
"GTTACGAGTACGCAAG-1"	"A"
"GTTACGAGTATCCTTT-1"	"G"
"GTTACGAGTCATAGCT-1"	"A"
"GTTACGAGTCATCAAC-1"	"G"
"GTTACGAGTGTCGTCG-1"	"G"
"GTTACGATCACATTCT-1"	"A"
"GTTACGATCATTCTCA-1"	"G"
"GTTACGATCGGATCGC-1"	"A"
"GTTACTTAGGCAGATC-1"	"A"
"GTTACTTCAAAGGAAG-1"	"A"
"GTTACTTCAAATGCTC-1"	"G"
"GTTACTTCATCCTGGG-1"	"A"
"GTTACTTCATTGCCTC-1"	"G"
"GTTACTTGTCGATAGG-1"	"G"
"GTTACTTTCACACGTA-1"	"G"
"GTTACTTTCCAGGTCG-1"	"G"
"GTTACTTTCCATACGA-1"	"A"
"GTTACTTTCCGGGCAT-1"	"A"
"GTTATGGAGAATCAGT-1"	"A"
"GTTATGGAGACCGCAA-1"	"A"
"GTTATGGAGCAATGTA-1"	"G"
"GTTATGGAGCACCATT-1"	"A"
"GTTATGGGTACAAATG-1"	"G"
"GTTATGGGTATTCTTC-1"	"A"
"GTTATGGTCCACCTAC-1"	"A"
"GTTATGGTCCCACGGA-1"	"A"
"GTTATGGTCGGCAATT-1"	"A"
"GTTATGGTCGTAGCGC-1"	"A"
"GTTATGGTCTACTGCC-1"	"A"
"GTTATGGTCTATCTCA-1"	"A"
"GTTATTCAGCTTTCCC-1"	"G"
"GTTATTCAGGATATCA-1"	"G"
"GTTATTCAGTAGTGTA-1"	"A"
"GTTATTCAGTGATCTC-1"	"A"
"GTTATTCCAAGGATGC-1"	"A"
"GTTATTCCACTCGGAC-1"	"G"
"GTTATTCGTACGTAAA-1"	"A"
"GTTATTCGTGATAAGT-1"	"A"
"GTTATTCGTTGCAGAG-1"	"G"
"GTTATTCTCATGTTCT-1"	"G"
"GTTATTCTCCGATGCG-1"	"A"
"GTTATTCTCCGTCAAA-1"	"A"
"GTTATTCTCGCACAAT-1"	"G"
"GTTATTCTCGGGATCC-1"	"A"
"GTTCAAGAGCACGTAG-1"	"A"
"GTTCAAGAGCGTTAGG-1"	"A"
"GTTCAAGCACGCTAAT-1"	"A"
"GTTCAAGCAGTAACGG-1"	"G"
"GTTCAAGCATGATCGT-1"	"G"
"GTTCAAGGTTGGCTAT-1"	"G"
"GTTCAAGTCATGCTTT-1"	"A"
"GTTCAAGTCTTCCACG-1"	"G"
"GTTGGGCAGATTGACA-1"	"A"
"GTTGGGCAGCTATCGT-1"	"G"
"GTTGGGCAGGGCGAAG-1"	"A"
"GTTGGGCAGGTAGGAA-1"	"A"
"GTTGGGCCACAGCCAC-1"	"A"
"GTTGGGCCACGTGAAG-1"	"A"
"GTTGGGCCACGTTAGT-1"	"A"
"GTTGGGCCAGGCAGAT-1"	"G"
"GTTGGGCCATGTATCG-1"	"G"
"GTTGGGCGTGGTGGTA-1"	"A"
"GTTGGGCGTTCCAATG-1"	"G"
"GTTGGGCTCACCACAA-1"	"G"
"GTTGGGCTCCCACTAC-1"	"A"
"GTTGGGCTCTCGACCT-1"	"G"
"GTTGGTAAGCAATGTA-1"	"G"
"GTTGGTAAGTTACACC-1"	"G"
"GTTGGTAAGTTGGAAT-1"	"G"
"GTTGGTACAATGGTAA-1"	"A"
"GTTGGTAGTACGTAGG-1"	"A"
"GTTGGTAGTAGCGTTT-1"	"G"
"GTTGGTAGTCAGTGCC-1"	"G"
"GTTGGTAGTTGCTTGA-1"	"A"
"GTTGGTATCAAAGTAG-1"	"A"
"GTTGGTATCCATCATT-1"	"G"
"TAAACCGAGAACGTCG-1"	"A"
"TAAACCGAGTGGGACT-1"	"A"
"TAAACCGCAAGGAACC-1"	"G"
"TAAACCGCACCGAATT-1"	"G"
"TAAACCGCACGCCGAT-1"	"A"
"TAAACCGCATCTCTCG-1"	"G"
"TAAACCGGTCTAAAGA-1"	"G"
"TAAACCGGTCTGGATT-1"	"A"
"TAAACCGGTGGACCAA-1"	"A"
"TAAACCGTCGGGCTCA-1"	"A"
"TAACAGCAGATACCAA-1"	"G"
"TAACAGCAGCGATACG-1"	"A"
"TAACAGCAGCGTAGCA-1"	"G"
"TAACAGCAGGCCTCTG-1"	"A"
"TAACAGCAGTTCAACC-1"	"A"
"TAACAGCCAATCACTG-1"	"A"
"TAACAGCCACGCGTTG-1"	"A"
"TAACAGCCACGGTTAT-1"	"A"
"TAACAGCCAGTAACGG-1"	"A"
"TAACAGCGTACCAAGG-1"	"G"
"TAACAGCGTCAAATCC-1"	"G"
"TAACAGCGTGAGCTAG-1"	"A"
"TAACAGCGTGGACTGA-1"	"A"
"TAACAGCGTGGGTAGT-1"	"A"
"TAACAGCGTTCCCGGA-1"	"A"
"TAACAGCGTTTGTGAC-1"	"A"
"TAACAGCTCCTCCATG-1"	"G"
"TAACAGCTCGCACCTT-1"	"G"
"TAACAGCTCGCTTACC-1"	"G"
"TAACAGCTCGTCCCTA-1"	"A"
"TAACAGCTCTATCTCA-1"	"G"
"TAACAGCTCTGAAAGA-1"	"A"
"TAACAGCTCTTAATCC-1"	"G"
"TAACGGTAGAGGCAGG-1"	"G"
"TAACGGTCAAGCAACG-1"	"G"
"TAACGGTCAGATTTGC-1"	"A"
"TAACGGTCATAGATAG-1"	"A"
"TAACGGTGTATCCCTC-1"	"G"
"TAACGGTGTTTAAGGA-1"	"G"
"TAACGGTTCAGGAATA-1"	"A"
"TAACGGTTCCAGCACG-1"	"A"
"TAACGGTTCGGATCGC-1"	"A"
"TAACGGTTCGGTCTCT-1"	"G"
"TAACGGTTCTGAAAGA-1"	"A"
"TAACTTCAGCGCGTTC-1"	"G"
"TAACTTCAGTACGACG-1"	"A"
"TAACTTCAGTCCCTCT-1"	"A"
"TAACTTCAGTCTCCAA-1"	"A"
"TAACTTCCAGGATAGC-1"	"G"
"TAACTTCCATAAAGTG-1"	"A"
"TAACTTCCATTTAGGC-1"	"A"
"TAACTTCGTAGGTCTT-1"	"G"
"TAACTTCGTCACAGTT-1"	"A"
"TAACTTCGTCTGCGCA-1"	"G"
"TAACTTCGTGTGTGTT-1"	"G"
"TAACTTCGTTTAAGGA-1"	"A"
"TAACTTCTCACTGGTA-1"	"G"
"TAACTTCTCCAAGAGG-1"	"A"
"TAACTTCTCGAACCGC-1"	"A"
"TAACTTCTCGTGATAC-1"	"A"
"TAACTTCTCTATCTTG-1"	"A"
"TAAGCCAAGGGTAGTC-1"	"G"
"TAAGCCAAGTCGACCC-1"	"G"
"TAAGCCACATCAGCTA-1"	"A"
"TAAGCCACATGGCCCA-1"	"G"
"TAAGCCAGTACCCACG-1"	"G"
"TAAGCCAGTCCACCAG-1"	"A"
"TAAGCCAGTCCATTGA-1"	"G"
"TAAGCCATCTCGCGTT-1"	"A"
"TAAGTGCAGAAAGCAG-1"	"A"
"TAAGTGCAGTTACACC-1"	"G"
"TAAGTGCCAAGTTGCT-1"	"A"
"TAAGTGCCACCTGGTG-1"	"G"
"TAAGTGCCATCCCAAA-1"	"G"
"TAAGTGCGTTTAAGCC-1"	"G"
"TAAGTGCGTTTGGATC-1"	"G"
"TAAGTGCTCATTCGGA-1"	"A"
"TAAGTGCTCCCAGCGA-1"	"A"
"TAATCGGAGCTCGTTA-1"	"A"
"TAATCGGAGGGTGTTG-1"	"A"
"TAATCGGAGTGAACCG-1"	"A"
"TAATCGGCAATCCATG-1"	"G"
"TAATCGGCATTAACGC-1"	"A"
"TAATCGGGTGACCAGA-1"	"G"
"TAATCGGGTGTCCAGC-1"	"G"
"TAATCGGGTTAGAGAT-1"	"A"
"TAATTCCAGTACTCTG-1"	"A"
"TAATTCCCACAGCTTA-1"	"A"
"TAATTCCCAGAACTTC-1"	"A"
"TAATTCCGTCTCTAAG-1"	"A"
"TAATTCCGTGCAAGCA-1"	"A"
"TAATTCCGTTGGTAAA-1"	"G"
"TAATTCCTCACTCCCA-1"	"A"
"TAATTCCTCCTAGAGT-1"	"G"
"TACAGCACAACTTGGT-1"	"A"
"TACAGCACAAGCCCTG-1"	"A"
"TACAGCACATCCATAG-1"	"A"
"TACAGCACATGGTTTG-1"	"G"
"TACAGCAGTAGGTCTT-1"	"G"
"TACAGCAGTATGCTAC-1"	"A"
"TACAGCAGTGCGCATC-1"	"A"
"TACAGCAGTGTGTGCC-1"	"A"
"TACAGCATCCCACTAC-1"	"A"
"TACAGCATCTGAGTCA-1"	"A"
"TACATGGAGTTGACAA-1"	"A"
"TACATGGCAAGCGTCC-1"	"G"
"TACATGGCAAGTCTCA-1"	"G"
"TACATGGCAATAGCGG-1"	"G"
"TACATGGTCAGCCGAC-1"	"G"
"TACATGGTCTGGCTAA-1"	"A"
"TACATTCAGAATATCG-1"	"G"
"TACATTCAGCTATCGT-1"	"G"
"TACATTCAGCTTCAAC-1"	"G"
"TACATTCAGTCCCGCA-1"	"A"
"TACATTCAGTCCGATT-1"	"A"
"TACATTCCAGGTGTGA-1"	"G"
"TACATTCGTACCTATG-1"	"A"
"TACATTCGTCATCGTA-1"	"A"
"TACATTCGTTTAAGGA-1"	"G"
"TACATTCGTTTGACCA-1"	"A"
"TACATTCTCCAGGTAT-1"	"G"
"TACCCTGGTAGGTAAT-1"	"G"
"TACCCTGGTCGTCGCA-1"	"G"
"TACCCTGGTGGTACTT-1"	"G"
"TACCCTGTCCAACAAC-1"	"G"
"TACCTATAGCTTTCCC-1"	"G"
"TACCTATAGGAATGGA-1"	"A"
"TACCTATAGGCCAGTA-1"	"G"
"TACCTATCAAGAGATT-1"	"A"
"TACCTATCATGCGTTA-1"	"A"
"TACCTATGTCAGACGA-1"	"A"
"TACCTATGTGATGTGG-1"	"A"
"TACCTATGTTACGGAG-1"	"A"
"TACCTATGTTCCGCGA-1"	"A"
"TACCTATTCACGATTG-1"	"G"
"TACCTATTCCCATAGA-1"	"A"
"TACCTATTCTTCCACG-1"	"A"
"TACCTCGAGAGGAATG-1"	"A"
"TACCTCGAGGTTACAA-1"	"G"
"TACCTCGAGTTACCAC-1"	"G"
"TACCTCGCAACACGGA-1"	"A"
"TACCTCGCATCATGTG-1"	"A"
"TACCTCGCATGGGACA-1"	"A"
"TACCTCGGTACCCACG-1"	"G"
"TACCTCGGTGGATTCT-1"	"A"
"TACCTCGTCCGAATTG-1"	"A"
"TACCTCGTCTGAAAGA-1"	"A"
"TACCTCGTCTGGTACA-1"	"A"
"TACCTCGTCTGTAGAC-1"	"A"
"TACGCAAAGACTAGGC-1"	"G"
"TACGCAAAGAGCTGTG-1"	"G"
"TACGCAAAGCGTGTTT-1"	"G"
"TACGCAAAGGAGTAGA-1"	"G"
"TACGCAAAGTTAGAGT-1"	"A"
"TACGCAACACGGCCAT-1"	"A"
"TACGCAAGTACGGAGT-1"	"G"
"TACGCAAGTCAGGCTC-1"	"G"
"TACGCAAGTGCTTACA-1"	"A"
"TACGCAAGTTCTGATG-1"	"G"
"TACGCAAGTTTCTCTA-1"	"G"
"TACGCAATCAGTGTGT-1"	"A"
"TACGCAATCCTGTAGA-1"	"A"
"TACGCAATCGTCAACA-1"	"A"
"TACGCAATCTACCCGT-1"	"A"
"TACGCCTAGAGTCCGA-1"	"G"
"TACGCCTAGGATGTCG-1"	"A"
"TACGCCTAGGCTGGAT-1"	"G"
"TACGCCTAGTACCACT-1"	"A"
"TACGCCTCATGCGCTG-1"	"A"
"TACGCCTGTGGCCTTG-1"	"A"
"TACGCCTGTTCAGAAA-1"	"A"
"TACGCCTTCCTCCAGT-1"	"A"
"TACGGATAGGCTAAAT-1"	"G"
"TACGGATCAAATGTCC-1"	"G"
"TACGGATCAAGGGAGG-1"	"G"
"TACGGATCACAGAAGC-1"	"G"
"TACGGATCACAGATGG-1"	"G"
"TACGGATCAGGATGTG-1"	"G"
"TACGGATCATAGACGG-1"	"G"
"TACGGATCATGCCTTC-1"	"A"
"TACGGATTCCTAGAGT-1"	"A"
"TACGGATTCGACTTAG-1"	"A"
"TACGGATTCGGGATCC-1"	"G"
"TACGGATTCTATCTCA-1"	"A"
"TACTAGGAGAAATCTG-1"	"G"
"TACTAGGAGACACAAT-1"	"A"
"TACTAGGAGACACGGT-1"	"A"
"TACTAGGAGATTGACA-1"	"A"
"TACTAGGAGTAACATG-1"	"G"
"TACTAGGCAAACTACC-1"	"A"
"TACTAGGGTAGCTGTT-1"	"A"
"TACTAGGGTCAAGACG-1"	"A"
"TACTAGGGTTCAGTTG-1"	"G"
"TACTAGGGTTTGCGAT-1"	"A"
"TACTAGGTCCAGTTAG-1"	"G"
"TACTCGCAGCATACCT-1"	"A"
"TACTCGCAGGACTAGC-1"	"A"
"TACTCGCAGGCCAATG-1"	"G"
"TACTCGCAGGCCTCTG-1"	"A"
"TACTCGCCACAGAAGC-1"	"A"
"TACTCGCCACATTGCA-1"	"A"
"TACTCGCCAGGAGCAT-1"	"A"
"TACTCGCCAGTAACCT-1"	"A"
"TACTCGCCATTGCCTC-1"	"A"
"TACTCGCGTAGCAGCA-1"	"G"
"TACTCGCGTAGCGAGT-1"	"A"
"TACTCGCGTGTCTACA-1"	"A"
"TACTCGCGTTCAGTAC-1"	"G"
"TACTCGCTCGATAGGG-1"	"G"
"TACTGCCGTAGTTTGC-1"	"G"
"TACTGCCTCAATGCAC-1"	"A"
"TACTGCCTCCGGCTGA-1"	"G"
"TACTGCCTCTCTGCAC-1"	"G"
"TAGACTGAGACTAGGC-1"	"A"
"TAGACTGCAATGGCAG-1"	"G"
"TAGACTGCATACAACC-1"	"A"
"TAGACTGCATCCCTTG-1"	"A"
"TAGACTGGTAACCATC-1"	"A"
"TAGACTGTCGCTACCT-1"	"A"
"TAGCACAAGAAATTCG-1"	"G"
"TAGCACAAGAGGAAGT-1"	"A"
"TAGCACAAGCTAGCAG-1"	"A"
"TAGCACAAGTGTAATG-1"	"G"
"TAGCACAAGTTGGAAT-1"	"G"
"TAGCACACACCCTTTG-1"	"A"
"TAGCACAGTAGTTTGC-1"	"A"
"TAGCACAGTCAACTGT-1"	"G"
"TAGCACAGTCTGCACG-1"	"G"
"TAGCACAGTCTGGTTA-1"	"G"
"TAGCACAGTGCGCTCA-1"	"G"
"TAGCACAGTTGAAGCG-1"	"A"
"TAGCACATCCACGAGC-1"	"A"
"TAGCACATCGTGCTTC-1"	"A"
"TAGCACATCTTACGGA-1"	"A"
"TAGCATGAGAGTTTGA-1"	"A"
"TAGCATGAGATGTTGA-1"	"G"
"TAGCATGAGGATCCTT-1"	"A"
"TAGCATGAGGCAGTAC-1"	"G"
"TAGCATGAGGTAGGAA-1"	"G"
"TAGCATGCAACGCAAG-1"	"G"
"TAGCATGCAACTCAAC-1"	"G"
"TAGCATGCACAGAAGC-1"	"A"
"TAGCATGCACGTACAT-1"	"A"
"TAGCATGCATACCCGG-1"	"G"
"TAGCATGGTAATGTGA-1"	"A"
"TAGCATGGTCCGCTTT-1"	"A"
"TAGCATGGTCTCGGGT-1"	"G"
"TAGCATGGTGCACTTA-1"	"G"
"TAGCATGGTGTTAGAA-1"	"A"
"TAGCATGGTTCCGGCA-1"	"G"
"TAGCATGGTTTCGACA-1"	"A"
"TAGCATGTCTCTTAAC-1"	"A"
"TAGCCCTAGATTGACA-1"	"G"
"TAGCCCTAGCCAGAAC-1"	"A"
"TAGCCCTAGCTAGTTC-1"	"A"
"TAGCCCTCAAAGGCCA-1"	"G"
"TAGCCCTCAAGGCTTT-1"	"A"
"TAGCCCTCATTCTCGC-1"	"A"
"TAGCCCTGTAAACGGC-1"	"A"
"TAGCCCTGTCAGCAAG-1"	"A"
"TAGCCCTGTTCTGAGT-1"	"G"
"TAGCCCTGTTGTCGGC-1"	"A"
"TAGCCCTTCCTGAAAC-1"	"A"
"TAGCCGGAGAGTTTGA-1"	"G"
"TAGCCGGAGGATGTAT-1"	"A"
"TAGCCGGAGGCCTCGT-1"	"A"
"TAGCCGGAGTAATGTG-1"	"G"
"TAGCCGGCACTTGCGG-1"	"A"
"TAGCCGGGTCATAGCT-1"	"A"
"TAGCCGGGTTAGGAAT-1"	"A"
"TAGCCGGTCACCCGGA-1"	"A"
"TAGCCGGTCATCGCTC-1"	"G"
"TAGCCGGTCCTTCGAC-1"	"A"
"TAGCGGCAGTCTCGAT-1"	"G"
"TAGCGGCAGTGTCGCC-1"	"A"
"TAGCGGCCACGCGTTG-1"	"A"
"TAGCGGCCAGAACTTC-1"	"G"
"TAGCGGCCAGATAAGT-1"	"G"
"TAGCGGCCAGCAACGA-1"	"A"
"TAGCGGCCATCGTACA-1"	"G"
"TAGCGGCGTAATGCCT-1"	"A"
"TAGCGGCGTCTGGATT-1"	"G"
"TAGCGGCGTCTGGGAA-1"	"A"
"TAGCGGCGTGTGAGGT-1"	"G"
"TAGCGGCGTTTGAAGA-1"	"G"
"TAGCGGCTCAGATACC-1"	"G"
"TAGCGGCTCATCGCTC-1"	"G"
"TAGCTTTAGATCCGAG-1"	"A"
"TAGCTTTAGCTGCTCG-1"	"A"
"TAGCTTTCACCTGAAT-1"	"A"
"TAGCTTTCATGGTATC-1"	"G"
"TAGCTTTTCCGTTAGA-1"	"A"
"TAGCTTTTCCTTACGC-1"	"G"
"TAGCTTTTCGTCGCAG-1"	"G"
"TAGCTTTTCTCTTAAC-1"	"A"
"TAGGAGGAGATGAGGA-1"	"A"
"TAGGAGGAGGAGACTC-1"	"G"
"TAGGAGGAGGGAGTTC-1"	"G"
"TAGGAGGCAAAGGAAG-1"	"A"
"TAGGAGGCAATTGCCA-1"	"G"
"TAGGAGGGTATCACAC-1"	"G"
"TAGGAGGTCGCAGATT-1"	"A"
"TAGGAGGTCTGGCACG-1"	"A"
"TAGGTCAAGACACGGT-1"	"G"
"TAGGTCAAGACTTCCA-1"	"A"
"TAGGTCAAGCTCCGGT-1"	"A"
"TAGGTCAAGTCGAGCA-1"	"G"
"TAGGTCACACCACGAC-1"	"A"
"TAGGTCAGTGGTAGAC-1"	"A"
"TAGGTCAGTTGTATCG-1"	"G"
"TAGGTCATCGCGTGAC-1"	"A"
"TAGGTCATCTTCATAC-1"	"A"
"TAGGTGTAGCCTATAC-1"	"A"
"TAGGTGTAGTGCCCTG-1"	"G"
"TAGGTGTCAATTCAGC-1"	"A"
"TAGGTGTCACGCCGAT-1"	"A"
"TAGGTGTCACTGTTAG-1"	"G"
"TAGGTGTCATGTGGGA-1"	"A"
"TAGGTGTGTATGTTCG-1"	"G"
"TAGGTGTGTGCATTCA-1"	"A"
"TAGGTGTGTGTCGTCG-1"	"A"
"TAGGTGTGTTTGCCCT-1"	"A"
"TAGGTGTTCCATACGA-1"	"A"
"TAGGTGTTCCTATCAT-1"	"A"
"TAGGTGTTCCTCTCTT-1"	"A"
"TAGTCCCAGTCATCTG-1"	"G"
"TAGTCCCCAGGATGTG-1"	"A"
"TAGTCCCGTCTCTAAG-1"	"A"
"TAGTCCCTCGGATCGC-1"	"G"
"TATCGAGAGGATATCA-1"	"G"
"TATCGAGAGTGAGTTA-1"	"A"
"TATCGAGAGTGCAACG-1"	"A"
"TATCGAGCAATCCATG-1"	"A"
"TATCGAGCAGTAACGG-1"	"A"
"TATCGAGGTACGTATC-1"	"G"
"TATCGAGGTCCGTGCA-1"	"G"
"TATCGAGGTTCTGAGT-1"	"G"
"TATCGAGGTTTGCATG-1"	"G"
"TATCGAGTCCACGCTT-1"	"G"
"TATCGAGTCGAGGTCC-1"	"A"
"TATCGAGTCGATGTGT-1"	"A"
"TATCGAGTCTGTGTCC-1"	"A"
"TATCGAGTCTTACCTA-1"	"A"
"TATCTGTAGAATACTG-1"	"G"
"TATCTGTAGATATGAC-1"	"A"
"TATCTGTAGGTACTCT-1"	"A"
"TATCTGTAGGTCTTTG-1"	"G"
"TATCTGTCAAAGCTGG-1"	"A"
"TATCTGTCACTCGTGG-1"	"A"
"TATCTGTCAGATTAAG-1"	"G"
"TATCTGTCAGTATCTG-1"	"G"
"TATCTGTCATAGACGG-1"	"A"
"TATCTGTCATGCTATG-1"	"G"
"TATCTGTGTGACGCAA-1"	"G"
"TATCTGTGTGCTTACA-1"	"A"
"TATCTGTTCGGTTGTA-1"	"A"
"TATCTGTTCTTGTGCC-1"	"G"
"TATGTGGAGGCTCAGA-1"	"A"
"TATGTGGCAAGTAACA-1"	"G"
"TATGTGGCAGGCATCC-1"	"A"
"TATGTGGGTAACGGCA-1"	"G"
"TATGTGGGTATTCACG-1"	"A"
"TATGTGGGTGATGCTT-1"	"G"
"TATGTGGGTTTGTGAC-1"	"A"
"TATGTGGTCACGATTG-1"	"A"
"TATGTGGTCAGCACTA-1"	"A"
"TATGTGGTCCATAACG-1"	"A"
"TATGTGGTCTGTTGCC-1"	"G"
"TATGTTCAGATGTTGA-1"	"A"
"TATGTTCTCCGAGAGA-1"	"A"
"TATGTTCTCTGGACAT-1"	"G"
"TATGTTCTCTTCAGAG-1"	"A"
"TATTGCTAGGATATCA-1"	"G"
"TATTGCTAGGGATCCA-1"	"A"
"TATTGCTAGTCTGCTA-1"	"G"
"TATTGCTAGTGAAACT-1"	"G"
"TATTGCTAGTTCGACT-1"	"A"
"TATTGCTCAAGAAACT-1"	"A"
"TATTGCTCACAACGGA-1"	"G"
"TATTGCTGTGTCCAGC-1"	"A"
"TATTGCTTCAGGTCTA-1"	"A"
"TATTGCTTCGCAGATT-1"	"A"
"TATTGCTTCGCTTCAC-1"	"A"
"TATTGCTTCTGGCGCA-1"	"A"
"TCAAAGCAGGAAGGTA-1"	"G"
"TCAAAGCAGGTACATA-1"	"A"
"TCAAAGCGTAGGGTCA-1"	"G"
"TCAAAGCGTTTCCTAT-1"	"A"
"TCAAAGCTCACTAGCA-1"	"A"
"TCAAAGCTCGCTGATA-1"	"A"
"TCAAAGCTCTCATATC-1"	"G"
"TCAAGACAGACTAGGC-1"	"G"
"TCAAGACAGTACAGTA-1"	"A"
"TCAAGACCAGCGTCGT-1"	"A"
"TCAAGACGTAACACTC-1"	"G"
"TCAAGACGTTTCAGCA-1"	"A"
"TCAAGACTCAAATGGA-1"	"A"
"TCAAGACTCATCGCCT-1"	"G"
"TCAAGACTCGGTCTAA-1"	"G"
"TCAAGACTCTACTTTG-1"	"G"
"TCAAGACTCTTCGTTA-1"	"G"
"TCAAGCAAGAGAATTC-1"	"A"
"TCAAGCACAACCTCTC-1"	"A"
"TCAAGCACAATAGCGG-1"	"G"
"TCAAGCACAGTAACGG-1"	"G"
"TCAAGCACAGTCCTGG-1"	"A"
"TCAAGCACATCGACGC-1"	"G"
"TCAAGCAGTACCAAGG-1"	"A"
"TCAAGCAGTATGGATA-1"	"A"
"TCAAGCAGTATTGTCG-1"	"A"
"TCAAGCAGTCGTAGTT-1"	"G"
"TCAAGCAGTGAGCTAG-1"	"G"
"TCAAGCAGTGGAAGCT-1"	"G"
"TCAAGCAGTGTCTACA-1"	"G"
"TCAAGCAGTTACCACA-1"	"A"
"TCAAGCAGTTCAGAAA-1"	"G"
"TCAAGCATCAGTCAAC-1"	"A"
"TCAAGGTAGTGATATG-1"	"G"
"TCAAGGTAGTTACACC-1"	"G"
"TCAAGGTCACTTGCGG-1"	"G"
"TCAAGGTCAGGATAGC-1"	"A"
"TCAAGGTGTAACGGTG-1"	"A"
"TCAAGGTGTATGGGTG-1"	"A"
"TCAAGGTGTTTGTAGC-1"	"G"
"TCAAGGTTCTATATCC-1"	"A"
"TCAATTCAGGAGAACA-1"	"A"
"TCAATTCAGGCAAGCT-1"	"A"
"TCAATTCCAGGTGGTA-1"	"A"
"TCAATTCGTCCAAGAG-1"	"G"
"TCAATTCTCCACGCTT-1"	"G"
"TCAATTCTCCATTGAG-1"	"G"
"TCAATTCTCGGTCAGC-1"	"G"
"TCAATTCTCTCGACCT-1"	"A"
"TCACAAGCACAGTAGG-1"	"A"
"TCACAAGCACGATTAC-1"	"A"
"TCACAAGGTAAGTCTC-1"	"G"
"TCACAAGGTAGAGAGA-1"	"A"
"TCACAAGGTCTTAGCA-1"	"A"
"TCACAAGTCCAAGAGG-1"	"A"
"TCACAAGTCCACGCTT-1"	"G"
"TCACAAGTCTACATCT-1"	"G"
"TCACAAGTCTCGTGAA-1"	"G"
"TCACAGAAGACGCCAA-1"	"G"
"TCACAGAAGAGCGAAA-1"	"A"
"TCACAGACAAAGACGC-1"	"A"
"TCACAGACAACCTCTC-1"	"G"
"TCACAGACAAGAGCGT-1"	"G"
"TCACAGACAATTCTCT-1"	"A"
"TCACAGAGTAAGCCTT-1"	"A"
"TCACAGAGTTAGCTCA-1"	"A"
"TCACAGATCAGGAATA-1"	"A"
"TCACCACAGAGTTTGA-1"	"G"
"TCACCACAGGATGCCA-1"	"G"
"TCACCACAGTAATGTG-1"	"G"
"TCACCACCATCACAAC-1"	"G"
"TCACCACTCCATAACG-1"	"A"
"TCACCTGAGGGAGATA-1"	"G"
"TCACCTGCAAATTCCG-1"	"A"
"TCACCTGCACCTCGTT-1"	"A"
"TCACCTGCATCTCACC-1"	"G"
"TCACCTGGTACCCACG-1"	"G"
"TCACCTGGTCTGCGCA-1"	"G"
"TCACCTGGTGAAACAT-1"	"A"
"TCACCTGGTGACAAGC-1"	"G"
"TCACCTGGTGCGTTTA-1"	"A"
"TCACCTGTCCAGTTAG-1"	"G"
"TCACCTGTCTTCCAGC-1"	"A"
"TCACTCGAGTCATCTG-1"	"G"
"TCACTCGCAGCTGATT-1"	"A"
"TCACTCGGTAACCATC-1"	"A"
"TCACTCGGTGTTTCTT-1"	"A"
"TCACTCGTCCCTAAAG-1"	"G"
"TCACTCGTCGCTCGGA-1"	"A"
"TCACTCGTCTGTCGGG-1"	"A"
"TCAGCTCAGAATCAGT-1"	"G"
"TCAGCTCAGACCCTAT-1"	"A"
"TCAGCTCAGGGAGTTC-1"	"A"
"TCAGCTCAGGGTATCG-1"	"G"
"TCAGCTCAGTATGGGC-1"	"G"
"TCAGCTCAGTCCTTCC-1"	"G"
"TCAGCTCAGTGTCGGA-1"	"A"
"TCAGCTCGTTTCTCTA-1"	"A"
"TCAGCTCTCACTAGCA-1"	"A"
"TCAGCTCTCAGTGTAC-1"	"G"
"TCAGGGCAGAATATCG-1"	"A"
"TCAGGGCAGACCGCAA-1"	"A"
"TCAGGGCAGGAGTACC-1"	"A"
"TCAGGGCAGGATTAAC-1"	"A"
"TCAGGGCAGTCTGTGT-1"	"A"
"TCAGGGCCAAGCAATA-1"	"A"
"TCAGGGCCACGTGAAG-1"	"A"
"TCAGGGCGTGGACGAT-1"	"G"
"TCAGGGCTCACCCGGA-1"	"G"
"TCAGGGCTCAGGCGCT-1"	"G"
"TCAGGGCTCGGTCTAA-1"	"A"
"TCAGGGCTCTTCCAGC-1"	"A"
"TCAGGTAAGAACAGGA-1"	"A"
"TCAGGTAAGCGTTGCC-1"	"A"
"TCAGGTAAGCTGATTC-1"	"G"
"TCAGGTAAGTCGTACT-1"	"G"
"TCAGGTAAGTGATCTC-1"	"A"
"TCAGGTACAATCATCG-1"	"G"
"TCAGGTACACACTAGT-1"	"G"
"TCAGGTACACTGCTTC-1"	"G"
"TCAGGTAGTAACGTAA-1"	"A"
"TCAGGTAGTGTGTGTT-1"	"G"
"TCAGGTAGTTTAGGAA-1"	"G"
"TCAGGTATCCACGGCA-1"	"A"
"TCAGGTATCGGTAGGA-1"	"G"
"TCAGGTATCGTGATAC-1"	"G"
"TCAGTCCAGACTAGGC-1"	"A"
"TCAGTCCAGGGTTCTT-1"	"G"
"TCAGTCCAGTCAGGAC-1"	"A"
"TCAGTCCCAAACAGTA-1"	"A"
"TCAGTCCCAACGCAAG-1"	"G"
"TCAGTCCCAATTAGGA-1"	"G"
"TCAGTCCCATCGAGTT-1"	"G"
"TCAGTCCCATGTGGGA-1"	"A"
"TCAGTCCGTAACTGAA-1"	"A"
"TCAGTCCGTCAGCAAG-1"	"G"
"TCAGTCCGTCGCTACG-1"	"G"
"TCAGTCCTCAGGAATA-1"	"A"
"TCAGTCCTCCAGAATC-1"	"A"
"TCAGTCCTCCCTACCA-1"	"G"
"TCAGTTTAGAGCTGTG-1"	"A"
"TCAGTTTAGGACCGAT-1"	"A"
"TCAGTTTCAGAATGCG-1"	"G"
"TCAGTTTCATGGCCTG-1"	"A"
"TCAGTTTCATTAGCAC-1"	"A"
"TCAGTTTGTAACCATC-1"	"A"
"TCAGTTTGTAGATGAT-1"	"G"
"TCAGTTTTCAAGGCAG-1"	"G"
"TCAGTTTTCCTCCTGA-1"	"G"
"TCAGTTTTCGGTAGGA-1"	"G"
"TCCAGAAAGACACGGT-1"	"G"
"TCCAGAAAGACGCCAA-1"	"G"
"TCCAGAAAGTACAGTA-1"	"G"
"TCCAGAACACACATGT-1"	"A"
"TCCAGAACATTCGTCC-1"	"A"
"TCCAGAAGTCAGGCTC-1"	"A"
"TCCAGAAGTGAAACAT-1"	"G"
"TCCAGAAGTGCTAGTT-1"	"G"
"TCCAGAATCCGATGCG-1"	"A"
"TCCAGAATCGACGGAA-1"	"G"
"TCCAGAATCGCTTACC-1"	"G"
"TCCATCGAGACTTGAA-1"	"G"
"TCCATCGAGCGTTGCC-1"	"A"
"TCCATCGAGGTCACTT-1"	"G"
"TCCATCGAGTATGCTC-1"	"G"
"TCCATCGAGTGTAATG-1"	"G"
"TCCATCGCAAGAGCGT-1"	"G"
"TCCATCGCAATTAGGA-1"	"A"
"TCCATCGCATGTCCCT-1"	"A"
"TCCATCGGTACGTAGG-1"	"G"
"TCCATCGGTATGTTCG-1"	"A"
"TCCATCGGTCTGGTTA-1"	"G"
"TCCATCGGTGTACGCC-1"	"A"
"TCCATCGTCCAGAGAG-1"	"A"
"TCCATCGTCGTGGAAG-1"	"A"
"TCCATCGTCGTTCCGT-1"	"G"
"TCCATCGTCTAGCTGA-1"	"A"
"TCCCACAAGACTAATG-1"	"G"
"TCCCACAAGCTTCAAC-1"	"A"
"TCCCACACAACTGCGC-1"	"A"
"TCCCACACACATTGCA-1"	"A"
"TCCCACAGTAGGGTCA-1"	"A"
"TCCCACAGTGATAAGT-1"	"A"
"TCCGACTAGAGAATTC-1"	"A"
"TCCGACTAGTGTAATG-1"	"A"
"TCCGACTCACCACCAG-1"	"A"
"TCCGACTCAGTTACAC-1"	"A"
"TCCGACTCATACAACC-1"	"G"
"TCCGACTGTTACCCAA-1"	"A"
"TCCGACTGTTCTGAAC-1"	"A"
"TCCGACTTCGATGCAT-1"	"A"
"TCCGACTTCGTGCTGG-1"	"G"
"TCCGACTTCTCTTCCT-1"	"A"
"TCCGACTTCTCTTCTC-1"	"A"
"TCCGACTTCTTGTACT-1"	"A"
"TCGAGCGAGCCTGTAT-1"	"A"
"TCGAGCGCAAGTCCTA-1"	"A"
"TCGAGCGCAGAACAGC-1"	"A"
"TCGAGCGCATATACGC-1"	"A"
"TCGAGCGCATCAGAAA-1"	"A"
"TCGAGCGCATGGGACA-1"	"G"
"TCGAGCGCATGGTATC-1"	"A"
"TCGAGCGGTACGCCCA-1"	"G"
"TCGAGCGGTGTCCCAG-1"	"G"
"TCGAGCGGTTTAAGCC-1"	"G"
"TCGAGCGTCCAGCACG-1"	"A"
"TCGAGCGTCCTTACGC-1"	"A"
"TCGAGCGTCTGAAAGA-1"	"A"
"TCGATTTAGCTACGCC-1"	"G"
"TCGATTTAGCTGAAAT-1"	"A"
"TCGATTTAGGAAGACA-1"	"A"
"TCGATTTAGGATGCCA-1"	"G"
"TCGATTTAGGTAGGCT-1"	"A"
"TCGATTTAGTAGTCGG-1"	"G"
"TCGATTTCAATCATCG-1"	"G"
"TCGATTTCAGCAACCC-1"	"A"
"TCGATTTCAGGAGCAT-1"	"G"
"TCGATTTCATGCTATG-1"	"A"
"TCGATTTCATGGTTTG-1"	"A"
"TCGATTTGTAGCGTTT-1"	"G"
"TCGATTTGTTCTTATC-1"	"G"
"TCGCAGGAGGGAGTTC-1"	"G"
"TCGCAGGCATCCGTAA-1"	"A"
"TCGCAGGGTATTCGAC-1"	"G"
"TCGCAGGGTGAATCGG-1"	"A"
"TCGCAGGGTGAGTTGG-1"	"A"
"TCGCAGGGTTGGCTTA-1"	"G"
"TCGCAGGGTTTGAAGA-1"	"A"
"TCGCAGGTCCCAATGA-1"	"A"
"TCGCAGGTCGAGGTAG-1"	"A"
"TCGCCTACACCGTCTT-1"	"A"
"TCGCCTAGTACGTATC-1"	"G"
"TCGCCTAGTCAACAGG-1"	"A"
"TCGCCTAGTTTAAGCC-1"	"A"
"TCGCCTAGTTTGTCTT-1"	"A"
"TCGCCTATCGGGAAAC-1"	"A"
"TCGGGACCACGCTGTG-1"	"A"
"TCGGGACCAGGGTAAC-1"	"G"
"TCGGGACCATCACAGT-1"	"A"
"TCGGGACCATTTAGGC-1"	"A"
"TCGGGACGTAACGTAA-1"	"A"
"TCGGGACGTAGCCATT-1"	"A"
"TCGGGACGTGCCAAGA-1"	"A"
"TCGGGACGTGCTGTCG-1"	"A"
"TCGGGACGTGGTGGTA-1"	"G"
"TCGGGACTCACGTGTA-1"	"A"
"TCGGGACTCCAACGCG-1"	"G"
"TCGGGACTCTCTATCA-1"	"A"
"TCGTTCGCAGGTCCTG-1"	"G"
"TCGTTCGGTCCACCAG-1"	"G"
"TCGTTCGTCCATTGAG-1"	"A"
"TCGTTCGTCGTGCTTC-1"	"A"
"TCTAGTTAGACTAGCG-1"	"A"
"TCTAGTTAGAGATTAC-1"	"G"
"TCTAGTTAGCAGAATT-1"	"A"
"TCTAGTTAGTACTCTG-1"	"A"
"TCTAGTTCACACGGTC-1"	"G"
"TCTAGTTCATTACCTT-1"	"A"
"TCTAGTTGTCAAATCC-1"	"A"
"TCTAGTTGTTTAGGAA-1"	"A"
"TCTAGTTTCACTGATG-1"	"G"
"TCTAGTTTCCAGGTCG-1"	"A"
"TCTAGTTTCCCACGGA-1"	"A"
"TCTAGTTTCCGCCTAT-1"	"A"
"TCTATTGAGACGAAAG-1"	"A"
"TCTATTGAGCTATCGT-1"	"A"
"TCTATTGAGGCAATTA-1"	"G"
"TCTATTGAGGCTCCTG-1"	"G"
"TCTATTGCAAAGCATA-1"	"A"
"TCTATTGCAACGCAAG-1"	"A"
"TCTATTGCAAGGCTTT-1"	"G"
"TCTATTGCACTTTGGA-1"	"G"
"TCTATTGCAGTAACTC-1"	"A"
"TCTATTGGTCAAACAA-1"	"A"
"TCTATTGGTCATGAGG-1"	"A"
"TCTATTGGTCGAGAAC-1"	"G"
"TCTATTGTCCTTGACC-1"	"A"
"TCTATTGTCGCACAAT-1"	"G"
"TCTATTGTCGGTCGAC-1"	"A"
"TCTATTGTCGTGATAC-1"	"G"
"TCTATTGTCTCGACAA-1"	"A"
"TCTATTGTCTTCTTCC-1"	"A"
"TCTCAGCAGAGTCCGA-1"	"G"
"TCTCAGCAGGTCGTTT-1"	"A"
"TCTCAGCAGTATCTGC-1"	"G"
"TCTCAGCAGTGATAAC-1"	"G"
"TCTCAGCAGTTCCAGT-1"	"A"
"TCTCAGCGTCGACTGC-1"	"G"
"TCTCAGCGTGCGTCCA-1"	"G"
"TCTCAGCGTGCGTTTA-1"	"A"
"TCTCAGCGTTGTATCG-1"	"A"
"TCTCAGCTCACGTGTA-1"	"A"
"TCTCAGCTCCTGGAAT-1"	"A"
"TCTCAGCTCGCAAGCC-1"	"A"
"TCTCTGGAGCGCCTAC-1"	"A"
"TCTCTGGAGGTACACG-1"	"A"
"TCTCTGGAGTGGTGTG-1"	"G"
"TCTCTGGGTAATGTAG-1"	"A"
"TCTCTGGGTACAAATG-1"	"A"
"TCTCTGGGTAGCATGG-1"	"G"
"TCTCTGGGTTCATTTC-1"	"A"
"TCTCTGGTCAAGGCAG-1"	"A"
"TCTCTGGTCACATCCC-1"	"A"
"TCTCTGGTCCCACTTG-1"	"G"
"TCTCTGGTCGATGAAA-1"	"G"
"TCTCTGGTCGCAAGCC-1"	"G"
"TCTCTGGTCTCTTAAC-1"	"A"
"TCTCTGGTCTTACCTA-1"	"A"
"TGAATCGAGACGACTG-1"	"G"
"TGAATCGAGCTTACCA-1"	"A"
"TGAATCGAGTAGGTCG-1"	"A"
"TGAATCGCAACGACAG-1"	"G"
"TGAATCGCAAGTAATG-1"	"A"
"TGAATCGCACAAGGGT-1"	"G"
"TGAATCGCACGCTGTG-1"	"G"
"TGAATCGCAGAGTCGA-1"	"A"
"TGAATCGCAGGCAGAT-1"	"G"
"TGAATCGCAGGGCTTC-1"	"G"
"TGAATCGCAGTTAAAG-1"	"A"
"TGAATCGGTAACAATG-1"	"A"
"TGAATCGGTAACGGTG-1"	"A"
"TGAATCGGTGGTCGAA-1"	"G"
"TGAATCGTCAGTGTAC-1"	"A"
"TGAATCGTCCCTAAAG-1"	"A"
"TGAATCGTCCGATTGA-1"	"A"
"TGAATCGTCTCTGACC-1"	"A"
"TGAATCGTCTTGTACT-1"	"A"
"TGACAACAGATGTTGA-1"	"A"
"TGACAACAGGACCGAT-1"	"G"
"TGACAACAGGAGTACC-1"	"A"
"TGACAACCAATAGCGG-1"	"G"
"TGACAACCATAAAGTG-1"	"A"
"TGACAACGTGCTGTCG-1"	"A"
"TGACAACGTTCTACGA-1"	"G"
"TGACAACTCCCGTATC-1"	"A"
"TGACAACTCGGTTAGT-1"	"A"
"TGACAACTCTGGTACA-1"	"A"
"TGACTCCAGCGTAGCA-1"	"A"
"TGACTCCAGGATTGCG-1"	"A"
"TGACTCCAGGTTGTTC-1"	"G"
"TGACTCCCAAACAGTA-1"	"G"
"TGACTCCCAAGTGGCA-1"	"A"
"TGACTCCCACAGTTAC-1"	"G"
"TGACTCCCAGCAACCC-1"	"G"
"TGACTCCCAGCGTACC-1"	"G"
"TGACTCCGTACGGTTT-1"	"A"
"TGACTCCGTCAGCAAG-1"	"A"
"TGACTCCTCAATCGTG-1"	"A"
"TGACTCCTCAATGCAC-1"	"A"
"TGACTCCTCCTGGGAC-1"	"A"
"TGACTCCTCTGTTTAC-1"	"A"
"TGAGCCGAGAACGTTA-1"	"G"
"TGAGCCGAGAAGGGCG-1"	"A"
"TGAGCCGAGAGAGTTT-1"	"G"
"TGAGCCGAGATTACGA-1"	"A"
"TGAGCCGAGCGTGTTT-1"	"G"
"TGAGCCGCAGGACTGA-1"	"A"
"TGAGCCGCATGGATGG-1"	"G"
"TGAGCCGCATTGCGAT-1"	"A"
"TGAGCCGGTACGACCC-1"	"G"
"TGAGCCGGTGGACGAT-1"	"G"
"TGAGCCGTCAAAGTAG-1"	"G"
"TGAGCCGTCAGGAATA-1"	"G"
"TGAGCCGTCCAAACCA-1"	"G"
"TGAGCCGTCCGGGCAT-1"	"A"
"TGAGCCGTCGGATAGG-1"	"A"
"TGAGCCGTCGTGAACT-1"	"A"
"TGAGTCAAGATAGGTT-1"	"G"
"TGAGTCAAGCTCCATA-1"	"A"
"TGAGTCAAGTAGTCGG-1"	"A"
"TGAGTCAAGTCTCTAG-1"	"A"
"TGAGTCAAGTCTGCTA-1"	"G"
"TGAGTCAAGTTCAACC-1"	"G"
"TGAGTCAAGTTGGAAT-1"	"A"
"TGAGTCAGTAAACCCT-1"	"G"
"TGAGTCAGTCACAGGA-1"	"A"
"TGAGTCAGTTAACCGT-1"	"G"
"TGAGTCATCACAAGCT-1"	"G"
"TGAGTCATCACTGGTA-1"	"A"
"TGAGTCATCGCCGAAC-1"	"A"
"TGATCAGAGCATTCCA-1"	"G"
"TGATCAGCAGCCACGT-1"	"A"
"TGATCAGCAGTGCTCG-1"	"A"
"TGATCAGGTCAGAAGC-1"	"A"
"TGATCAGGTCCTTATT-1"	"A"
"TGATCAGGTCTGGTTA-1"	"G"
"TGATCAGGTGCCCAGT-1"	"G"
"TGATCAGGTTTGCCAA-1"	"G"
"TGATCAGTCCCAGCGA-1"	"A"
"TGATCAGTCGACCCGA-1"	"G"
"TGATCAGTCTCGTGAA-1"	"A"
"TGATGCAAGACGCCAA-1"	"G"
"TGATGCAAGCTGAGGT-1"	"G"
"TGATGCAAGGGCGAAG-1"	"A"
"TGATGCAAGTGAAACT-1"	"A"
"TGATGCACAATTCAGC-1"	"G"
"TGATGCACAATTGGCT-1"	"G"
"TGATGCACACGATTAC-1"	"A"
"TGATGCAGTAGGTAAT-1"	"G"
"TGATGCAGTCGTAATC-1"	"A"
"TGATGCAGTGTCCAGC-1"	"G"
"TGATGCAGTTAGGAGC-1"	"G"
"TGATGCAGTTCGGGAA-1"	"G"
"TGATGCAGTTCTTTCA-1"	"A"
"TGATGCATCCAACCTC-1"	"A"
"TGATGCATCCAGTACA-1"	"G"
"TGATTTCCATCGCTAA-1"	"A"
"TGATTTCGTAGCAGGT-1"	"A"
"TGATTTCGTCATTGGT-1"	"G"
"TGATTTCTCGAGGCTC-1"	"A"
"TGATTTCTCTATCTTG-1"	"G"
"TGCACCTAGATGTTCC-1"	"G"
"TGCACCTCAATGGTCT-1"	"A"
"TGCACCTCACTGCTCT-1"	"G"
"TGCACCTCATGCGCTG-1"	"G"
"TGCACCTGTGCAAAGC-1"	"G"
"TGCACCTTCAGAGTGG-1"	"G"
"TGCACCTTCGCCGAAC-1"	"A"
"TGCACCTTCTCTGTTA-1"	"A"
"TGCATGAAGGCTTCGC-1"	"A"
"TGCATGACACAACGGA-1"	"G"
"TGCATGACAGAACAGC-1"	"A"
"TGCATGAGTAAACGGC-1"	"A"
"TGCATGAGTGCTTACA-1"	"G"
"TGCATGAGTTACGCTA-1"	"A"
"TGCATGAGTTCTTATC-1"	"G"
"TGCATGAGTTTGATCG-1"	"A"
"TGCATGATCAAGAGAT-1"	"A"
"TGCATGATCCCAGCAG-1"	"G"
"TGCATGATCGAGCGCT-1"	"G"
"TGCATGATCGCTGATA-1"	"A"
"TGCATGATCTAAACGC-1"	"A"
"TGCATTTCAACCTCCT-1"	"G"
"TGCATTTCAGAACAGC-1"	"A"
"TGCATTTGTACGGATG-1"	"A"
"TGCATTTGTCTAAGAA-1"	"G"
"TGCATTTGTGGCGCTT-1"	"A"
"TGCATTTTCAATTGGC-1"	"A"
"TGCATTTTCATCATGG-1"	"A"
"TGCATTTTCGATCTTT-1"	"G"
"TGCATTTTCTACTTTG-1"	"G"
"TGCCTCAAGGGAAGCG-1"	"A"
"TGCCTCAAGTTACCAC-1"	"G"
"TGCCTCAAGTTCGACT-1"	"G"
"TGCCTCACACCACCAG-1"	"A"
"TGCCTCACATTACTTC-1"	"G"
"TGCCTCAGTAGAATAC-1"	"G"
"TGCCTCAGTCTGGGAA-1"	"G"
"TGCCTCAGTGATAAGT-1"	"G"
"TGCCTCAGTGCACTTA-1"	"G"
"TGCCTCAGTGTAGGAC-1"	"G"
"TGCCTCAGTTTCGATG-1"	"A"
"TGCCTCATCAGGCCGT-1"	"A"
"TGCCTCATCCTCCCAA-1"	"G"
"TGCCTCATCGCAAACT-1"	"A"
"TGCCTCATCGTGGCGT-1"	"A"
"TGCCTCATCTGATCTT-1"	"G"
"TGCCTGTAGCATGTGG-1"	"G"
"TGCCTGTAGGCAAGGG-1"	"A"
"TGCCTGTAGGCGTCCT-1"	"A"
"TGCCTGTCAACTCGAT-1"	"A"
"TGCCTGTCACGACGAA-1"	"A"
"TGCCTGTCAGTAACCT-1"	"G"
"TGCCTGTCATTCTCGC-1"	"G"
"TGCCTGTGTAACGTAA-1"	"G"
"TGCCTGTGTATTGTCG-1"	"G"
"TGCCTGTGTGTGAGGT-1"	"A"
"TGCCTGTGTTTCACCC-1"	"G"
"TGCCTGTTCCCTACGT-1"	"A"
"TGCCTGTTCGTTGTTT-1"	"A"
"TGCGTAAAGAATATCG-1"	"G"
"TGCGTAAAGAGAAGCA-1"	"A"
"TGCGTAAAGATATGAC-1"	"A"
"TGCGTAAAGCCATTCA-1"	"G"
"TGCGTAAAGGCCAGTA-1"	"A"
"TGCGTAAAGGCTTAAA-1"	"A"
"TGCGTAAAGTCTCTAG-1"	"A"
"TGCGTAACAACTAGAA-1"	"G"
"TGCGTAACAGTCAGCC-1"	"A"
"TGCGTAACATGCACTA-1"	"A"
"TGCGTAAGTACAAGCG-1"	"G"
"TGCGTAAGTAGGTCTT-1"	"G"
"TGCGTAAGTCAATACC-1"	"A"
"TGCGTAAGTTCATTTC-1"	"A"
"TGCGTAATCAGGATCT-1"	"G"
"TGCGTAATCTTCACTA-1"	"A"
"TGCTATTAGAAAGGGT-1"	"G"
"TGCTATTAGGCTTCGC-1"	"A"
"TGCTATTCAATTCAGC-1"	"G"
"TGCTATTCACACATGT-1"	"G"
"TGCTATTCACAGCCAC-1"	"G"
"TGCTATTCAGAAGTGC-1"	"A"
"TGCTATTCAGCCACGT-1"	"A"
"TGCTATTCATGTGGGA-1"	"G"
"TGCTATTGTGCTTTGA-1"	"G"
"TGCTATTTCGAGTTAC-1"	"A"
"TGCTATTTCTTGCGCT-1"	"G"
"TGCTCACAGCTATCCA-1"	"A"
"TGCTCACAGGACTAGC-1"	"A"
"TGCTCACAGGATTTGA-1"	"A"
"TGCTCACAGTTCCAGT-1"	"G"
"TGCTCACCAACAAACA-1"	"G"
"TGCTCACCAAGCAATA-1"	"A"
"TGCTCACCAATCACTG-1"	"A"
"TGCTCACGTCAACTGT-1"	"G"
"TGCTCACGTGGTGGTA-1"	"A"
"TGCTCACGTTGCAGCC-1"	"A"
"TGCTCACGTTTGAAGA-1"	"A"
"TGCTCACTCCTTCGAC-1"	"G"
"TGCTCACTCGAACCGC-1"	"A"
"TGCTCACTCTCTGAGA-1"	"G"
"TGCTCGTAGCGAGAAA-1"	"A"
"TGCTCGTCATAGTCCA-1"	"G"
"TGCTCGTCATCACAGT-1"	"G"
"TGCTCGTCATCGCTAA-1"	"A"
"TGCTCGTCATGGTATC-1"	"A"
"TGCTCGTCATTAGCAC-1"	"G"
"TGCTCGTGTACCCATA-1"	"A"
"TGCTCGTGTCGGCTGT-1"	"A"
"TGCTCGTTCCAGGTCG-1"	"A"
"TGCTCGTTCCGGAAAG-1"	"G"
"TGCTCGTTCCGTCAAA-1"	"A"
"TGCTCGTTCGATAGGG-1"	"A"
"TGCTCGTTCGCAAACT-1"	"G"
"TGCTCGTTCTGGCCAG-1"	"G"
"TGCTCGTTCTTCATAC-1"	"A"
"TGCTTCGAGATTACGA-1"	"A"
"TGCTTCGAGGAAACTT-1"	"A"
"TGCTTCGAGGAGACTC-1"	"G"
"TGCTTCGAGTTGCGCC-1"	"A"
"TGCTTCGCAGCAGGTA-1"	"A"
"TGCTTCGCAGTGCTCG-1"	"G"
"TGCTTCGGTAACCATC-1"	"G"
"TGCTTCGGTGATAGAT-1"	"A"
"TGCTTCGTCCAATCCC-1"	"G"
"TGCTTCGTCGCACCGA-1"	"A"
"TGCTTCGTCTATACCT-1"	"A"
"TGCTTTAAGGTTAACA-1"	"A"
"TGCTTTAAGTACCTCA-1"	"A"
"TGCTTTAAGTAGGTCG-1"	"G"
"TGCTTTAAGTATGGGC-1"	"A"
"TGCTTTACAAGACTTC-1"	"G"
"TGCTTTACACTGGGCT-1"	"G"
"TGCTTTAGTAAAGCTA-1"	"A"
"TGCTTTAGTACGCAAG-1"	"G"
"TGCTTTAGTATATGGA-1"	"A"
"TGCTTTAGTGAAACAT-1"	"A"
"TGCTTTATCCACGCTT-1"	"A"
"TGGAAGGAGATGCGCA-1"	"G"
"TGGAAGGAGGTAAGCC-1"	"A"
"TGGAAGGCAGAGCCAA-1"	"A"
"TGGAAGGCAGGGCTTC-1"	"A"
"TGGAAGGCATACTGCA-1"	"A"
"TGGAAGGGTGCGCATC-1"	"G"
"TGGAAGGGTTATCGAC-1"	"G"
"TGGAAGGTCCCAGCAG-1"	"A"
"TGGAAGGTCGACTGGC-1"	"G"
"TGGAAGGTCGCTACCT-1"	"A"
"TGGACATAGCGGACTA-1"	"A"
"TGGACATCAAACAGTA-1"	"G"
"TGGACATCACTACACA-1"	"A"
"TGGACATGTAAGGTCG-1"	"A"
"TGGACATGTCAATCCA-1"	"G"
"TGGACATGTTCCCAAA-1"	"G"
"TGGACATGTTTCCGGG-1"	"A"
"TGGACATGTTTGTACG-1"	"A"
"TGGCAATAGGAAACTT-1"	"A"
"TGGCAATAGTCCCTCT-1"	"A"
"TGGCAATCAATTCAGC-1"	"G"
"TGGCAATGTAAAGCTA-1"	"A"
"TGGCAATGTCACCCGA-1"	"G"
"TGGCAATGTCAGAAAT-1"	"G"
"TGGCAATGTCTCAAAC-1"	"A"
"TGGCAATGTTACCACA-1"	"A"
"TGGCAATGTTCCGCGA-1"	"A"
"TGGCAATTCACCCTTG-1"	"A"
"TGGCAATTCCTCCTGA-1"	"A"
"TGGCCTTAGAGTGGAA-1"	"A"
"TGGCCTTAGGCTAAAT-1"	"A"
"TGGCCTTAGTCTCTAG-1"	"A"
"TGGCCTTCAAAGAGAG-1"	"G"
"TGGCCTTCATTTGGTG-1"	"A"
"TGGCCTTGTAGACGCA-1"	"A"
"TGGCCTTGTCACCCGA-1"	"G"
"TGGCCTTGTCAGAAAT-1"	"G"
"TGGCCTTTCGAACCGC-1"	"G"
"TGGCCTTTCGGTCAGC-1"	"A"
"TGGCCTTTCGTGAGTT-1"	"A"
"TGGCGCAAGAGAACCC-1"	"A"
"TGGCGCAAGCCAGAAC-1"	"G"
"TGGCGCAAGGTAAGCC-1"	"A"
"TGGCGCAAGGTTAGTA-1"	"G"
"TGGCGCAAGTATGCTC-1"	"A"
"TGGCGCAAGTGGTGTG-1"	"A"
"TGGCGCAAGTGTCGCC-1"	"G"
"TGGCGCACAAACCTAC-1"	"G"
"TGGCGCACAAGCCAGA-1"	"A"
"TGGCGCAGTATGGGTG-1"	"G"
"TGGCGCAGTATTTGCG-1"	"G"
"TGGCGCAGTGAATACA-1"	"A"
"TGGCGCATCAGGCGCT-1"	"G"
"TGGCGCATCTATCCTA-1"	"A"
"TGGGTGCAGGAGTCTG-1"	"A"
"TGGGTGCAGGATCCTT-1"	"A"
"TGGGTGCAGTGGTGTG-1"	"A"
"TGGGTGCCAGTGCGAA-1"	"G"
"TGGGTGCCATCATGTG-1"	"G"
"TGGGTGCTCTGTCGGG-1"	"A"
"TGGGTTAAGACCGCAA-1"	"A"
"TGGGTTAAGTAATCAG-1"	"A"
"TGGGTTACAAACCGAG-1"	"G"
"TGGGTTACAACGGACA-1"	"A"
"TGGGTTACAACGGGTA-1"	"A"
"TGGGTTAGTCCGGTAC-1"	"G"
"TGGGTTAGTCGAGGAT-1"	"A"
"TGGGTTATCGCAAGCC-1"	"A"
"TGGTCAAAGACTTCCA-1"	"A"
"TGGTCAAAGGGTCTGA-1"	"G"
"TGGTCAAAGTGAGTGC-1"	"G"
"TGGTCAACAAATGCTC-1"	"G"
"TGGTCAACAACGTAGG-1"	"A"
"TGGTCAACACAGCTTA-1"	"G"
"TGGTCAAGTAGAGAGA-1"	"A"
"TGGTCAAGTGGTACTT-1"	"G"
"TGGTCAAGTTCCTATT-1"	"A"
"TGGTCAATCAGAATGA-1"	"G"
"TGGTCAATCAGAGTGG-1"	"G"
"TGGTCAATCTCATATC-1"	"G"
"TGGTCCTAGCATGATA-1"	"G"
"TGGTCCTAGTTAGAGT-1"	"G"
"TGGTCCTCAATCAGGG-1"	"A"
"TGGTCCTCACAAGGGT-1"	"A"
"TGGTCCTCATCATAGC-1"	"A"
"TGGTCCTGTACAAATG-1"	"G"
"TGGTCCTGTAGGTGAC-1"	"G"
"TGGTCCTGTATTTGCG-1"	"G"
"TGGTCCTGTCGATAGG-1"	"A"
"TGGTCCTGTTGAATAG-1"	"A"
"TGGTCCTTCGGATAAA-1"	"A"
"TGGTCCTTCTGAAAGA-1"	"G"
"TGGTCCTTCTGGCTAA-1"	"A"
"TGGTCCTTCTTGTGCC-1"	"G"
"TGTAAGCAGGAGTACC-1"	"G"
"TGTAAGCAGTATGGGC-1"	"A"
"TGTAAGCCAAGCCAGA-1"	"A"
"TGTAAGCCACCACGAC-1"	"A"
"TGTAAGCCATAGATAG-1"	"A"
"TGTAAGCGTAACCATC-1"	"G"
"TGTAAGCGTTCACGTA-1"	"A"
"TGTAAGCGTTCTGAGT-1"	"G"
"TGTAAGCTCACCACAA-1"	"A"
"TGTAAGCTCAGGAATA-1"	"A"
"TGTAAGCTCCAATAGC-1"	"G"
"TGTAAGCTCGGATGTT-1"	"A"
"TGTAAGCTCTGCCGAG-1"	"G"
"TGTACAGAGAGAACCC-1"	"A"
"TGTACAGAGTAATCAG-1"	"G"
"TGTACAGCAAAGAGAG-1"	"G"
"TGTACAGCAATGTAAG-1"	"A"
"TGTACAGCACCGATCG-1"	"A"
"TGTACAGCAGTGGTCC-1"	"A"
"TGTACAGGTATCTAGC-1"	"G"
"TGTACAGGTCTGTTGA-1"	"A"
"TGTACAGGTGCTGGCT-1"	"G"
"TGTACAGGTGGACGAT-1"	"A"
"TGTACAGGTGGGTAGT-1"	"G"
"TGTACAGGTTCTTAGG-1"	"A"
"TGTACAGTCAGAATGA-1"	"G"
"TGTACAGTCATCGCAA-1"	"A"
"TGTACAGTCATTGCCC-1"	"A"
"TGTACAGTCCATACCC-1"	"A"
"TGTACAGTCCTGGAAT-1"	"G"
"TGTACAGTCTTATCAC-1"	"G"
"TGTACGAAGATATGAC-1"	"G"
"TGTACGAAGGCAGTGT-1"	"A"
"TGTACGACAATGGCAG-1"	"A"
"TGTACGACAGAGCCAA-1"	"A"
"TGTACGACATCATAGC-1"	"A"
"TGTACGAGTAACGGTG-1"	"A"
"TGTACGAGTCCCGAGT-1"	"G"
"TGTACGAGTGCATCAT-1"	"A"
"TGTACGATCAATCGTG-1"	"G"
"TGTAGCAAGTCGTATC-1"	"A"
"TGTAGCAAGTTCTCCC-1"	"G"
"TGTAGCACAAACTACC-1"	"G"
"TGTAGCACACGCGTTG-1"	"A"
"TGTAGCATCTCAGATG-1"	"G"
"TGTAGCATCTGAAAGA-1"	"A"
"TGTAGCATCTGAGTCA-1"	"G"
"TGTGACAAGGACTAGC-1"	"A"
"TGTGACAAGTGCCCTG-1"	"A"
"TGTGACACAACTGCGC-1"	"G"
"TGTGACACACAGAAGC-1"	"G"
"TGTGACACAGAGATGC-1"	"A"
"TGTGACACAGCGTCGT-1"	"G"
"TGTGACACATTAAGGA-1"	"G"
"TGTGACAGTCAAATCC-1"	"G"
"TGTGACAGTTGTGACT-1"	"A"
"TGTGACATCCACGCTT-1"	"A"
"TGTGACATCCACGGCA-1"	"G"
"TGTGGCGAGAAATACC-1"	"G"
"TGTGGCGAGGCTGGAT-1"	"G"
"TGTGGCGAGGTGAACC-1"	"A"
"TGTGGCGAGTGGACGT-1"	"A"
"TGTGGCGCATGGGTGA-1"	"A"
"TGTGGCGGTCACCCGA-1"	"A"
"TGTGGCGTCTACATCT-1"	"A"
"TGTGTCCAGCGATACG-1"	"G"
"TGTGTCCCACGTTAGT-1"	"G"
"TGTGTCCCAGCCGAAA-1"	"G"
"TGTGTCCCATAGTCCA-1"	"G"
"TGTGTCCCATCATAGC-1"	"A"
"TGTGTCCTCCACGCTT-1"	"G"
"TGTGTCCTCGCATACA-1"	"A"
"TGTGTCCTCTCCCTTT-1"	"A"
"TGTTAGGAGAAGCCGT-1"	"A"
"TGTTAGGAGAATATCG-1"	"A"
"TGTTAGGAGATGAGGA-1"	"G"
"TGTTAGGCACAATAAG-1"	"A"
"TGTTAGGCAGCAATGG-1"	"A"
"TGTTAGGGTTCTTTGT-1"	"G"
"TGTTAGGTCACTGATG-1"	"G"
"TGTTAGGTCTCTTCTC-1"	"A"
"TTAACGGAGCGGACTA-1"	"G"
"TTAACGGCAAGCAACG-1"	"G"
"TTAACGGCACCGAAAG-1"	"A"
"TTAACGGCATGGGACA-1"	"G"
"TTAACGGCATTCACCC-1"	"G"
"TTAACGGCATTCACGA-1"	"G"
"TTAACGGGTAAGCCGA-1"	"A"
"TTAACGGGTGAGCTAG-1"	"A"
"TTAACGGTCTATCTAC-1"	"A"
"TTACCCGAGGCACCTC-1"	"G"
"TTACCCGAGTCTGTGT-1"	"A"
"TTACCCGCAAGGAGGG-1"	"A"
"TTACCCGGTACCGGCT-1"	"A"
"TTACCCGGTCCAAGAG-1"	"G"
"TTACCCGTCACATTCT-1"	"G"
"TTACCCGTCCAAGAGG-1"	"A"
"TTACCCGTCGCAGATT-1"	"G"
"TTACCGCAGGTTTCTG-1"	"A"
"TTACCGCCACATTCTT-1"	"A"
"TTACCGCCAGGTTATC-1"	"A"
"TTACCGCCATCATCGA-1"	"G"
"TTACCGCCATCCGTGG-1"	"A"
"TTACCGCGTAGTCTGT-1"	"A"
"TTACCGCGTCATAGAA-1"	"A"
"TTACCGCGTGAGCTAG-1"	"G"
"TTACCGCGTGATAGAT-1"	"G"
"TTACCGCGTGCAACAG-1"	"G"
"TTACCGCTCGAACCGC-1"	"G"
"TTACCGCTCGGAAAGC-1"	"G"
"TTACGGAAGATCTAAG-1"	"G"
"TTACGGAAGCTGCTCG-1"	"G"
"TTACGGAAGGTTGTGG-1"	"G"
"TTACGGAAGTCCTTCC-1"	"G"
"TTACGGAAGTTAGAGT-1"	"A"
"TTACGGAGTAGATGAT-1"	"A"
"TTACGGAGTTCTGAGT-1"	"A"
"TTACGGATCCAGGGAA-1"	"G"
"TTACGGATCCATAGGT-1"	"A"
"TTACGGATCGTCTAGA-1"	"G"
"TTACGTTAGCACGTAG-1"	"A"
"TTACGTTAGGTACTCT-1"	"A"
"TTACGTTAGTTAGCGG-1"	"G"
"TTACGTTCAAGCCTTA-1"	"G"
"TTACGTTGTAATGTGA-1"	"A"
"TTACGTTGTATGAAGT-1"	"G"
"TTACGTTGTTGGACGA-1"	"A"
"TTACGTTTCGACTGGC-1"	"G"
"TTACTCAAGAAATACC-1"	"G"
"TTACTCAAGCGGACTA-1"	"A"
"TTACTCAAGTTAGAGT-1"	"A"
"TTACTCACAAGCAGGT-1"	"A"
"TTACTCACACACTAGT-1"	"G"
"TTACTCACACGTTAGT-1"	"A"
"TTACTCAGTCAAGACG-1"	"A"
"TTACTCAGTGCTTTGA-1"	"G"
"TTACTCATCGACTGGC-1"	"G"
"TTACTCATCGCTCTAC-1"	"A"
"TTACTCATCTCTGCGT-1"	"G"
"TTACTCATCTGTGTGA-1"	"A"
"TTACTTGAGAGCCACA-1"	"A"
"TTACTTGCAATGCATC-1"	"A"
"TTACTTGCACGGTTAT-1"	"A"
"TTACTTGGTAACACTC-1"	"A"
"TTAGCGAAGAGAGGTA-1"	"G"
"TTAGCGAAGCTGAAAT-1"	"A"
"TTAGCGAAGGTAAGTT-1"	"G"
"TTAGCGAAGTAGACCG-1"	"G"
"TTAGCGAAGTCCGATT-1"	"G"
"TTAGCGACAAGGCTTT-1"	"A"
"TTAGCGACAATGATGA-1"	"G"
"TTAGCGACAGAACAGC-1"	"G"
"TTAGCGAGTAAGTGCG-1"	"A"
"TTAGCGAGTATTCTGG-1"	"A"
"TTAGCGAGTCCGCTTT-1"	"G"
"TTAGCGAGTTGAATAG-1"	"G"
"TTAGCGATCAAGTTGC-1"	"A"
"TTAGCGATCGCTCGGA-1"	"A"
"TTAGCGATCGGTAGGA-1"	"A"
"TTAGCTTAGAATGCTA-1"	"A"
"TTAGCTTAGAGAGGTA-1"	"G"
"TTAGCTTAGCTCGGCT-1"	"A"
"TTAGCTTAGGTCACTT-1"	"G"
"TTAGCTTAGTAGAAGG-1"	"A"
"TTAGCTTCAAAGACGC-1"	"A"
"TTAGCTTCACCGTTGG-1"	"A"
"TTAGCTTCATCTCACC-1"	"G"
"TTAGCTTCATTACCTT-1"	"G"
"TTAGCTTGTAGAACGC-1"	"A"
"TTAGGTGAGATCTAAG-1"	"A"
"TTAGGTGAGCCCATTA-1"	"G"
"TTAGGTGAGGTTACAA-1"	"A"
"TTAGGTGCAAGGAACC-1"	"A"
"TTAGGTGCAAGTAATG-1"	"G"
"TTAGGTGCACAGTAGG-1"	"A"
"TTAGGTGCACTGTTAG-1"	"G"
"TTAGGTGCAGACTAAA-1"	"G"
"TTAGGTGGTGATCAGG-1"	"A"
"TTAGGTGGTGCAAGAC-1"	"A"
"TTAGGTGGTGTGCTTA-1"	"A"
"TTAGGTGGTTTCACCC-1"	"A"
"TTAGGTGTCACCCTTG-1"	"A"
"TTATGTCAGATATGTG-1"	"A"
"TTATGTCGTCTGGGCT-1"	"A"
"TTATGTCGTGCAAGAC-1"	"G"
"TTATGTCGTGCTTCCT-1"	"A"
"TTATGTCTCAAAGTAG-1"	"G"
"TTATGTCTCACCCTTG-1"	"G"
"TTATGTCTCACGTGTA-1"	"A"
"TTATGTCTCGGTGATT-1"	"G"
"TTATGTCTCTTATCAC-1"	"A"
"TTCAACTAGGAGTAGA-1"	"A"
"TTCAACTAGTCTTAGC-1"	"G"
"TTCAACTCAAATTGAG-1"	"G"
"TTCAACTCAAGGATGC-1"	"A"
"TTCAACTCAGAACGAC-1"	"G"
"TTCAACTCAGATGGCA-1"	"G"
"TTCAACTCAGGTTATC-1"	"A"
"TTCAACTCATGACTGT-1"	"A"
"TTCAACTCATGTCCCT-1"	"A"
"TTCAACTGTCAGAAAT-1"	"G"
"TTCAACTGTCGTAATC-1"	"A"
"TTCAACTGTGAGGGTT-1"	"G"
"TTCAACTGTGCCAAGA-1"	"G"
"TTCAACTGTTCTACGA-1"	"G"
"TTCATCAAGACGTCAG-1"	"G"
"TTCATCAAGGCTCAGA-1"	"A"
"TTCATCAAGGGTCCCT-1"	"G"
"TTCATCAAGGTGATGC-1"	"G"
"TTCATCACAATGCATC-1"	"A"
"TTCATCACAGCACATT-1"	"G"
"TTCATCAGTCTAAAGA-1"	"A"
"TTCATCAGTTTGCATG-1"	"G"
"TTCATCAGTTTGGATC-1"	"A"
"TTCATCATCACCGCGA-1"	"G"
"TTCATCATCGGATGTT-1"	"A"
"TTCATTGAGTAACACA-1"	"A"
"TTCATTGCATAGCCAT-1"	"G"
"TTCATTGCATTTGGTG-1"	"A"
"TTCATTGGTGTCCAGC-1"	"G"
"TTCATTGGTTTAGGAA-1"	"A"
"TTCATTGTCCAGTACA-1"	"A"
"TTCATTGTCTTCGTTA-1"	"A"
"TTCGATTAGATGCGCA-1"	"G"
"TTCGATTAGGAAGAAC-1"	"A"
"TTCGATTAGGTTGTGG-1"	"G"
"TTCGATTTCCTAAAGC-1"	"G"
"TTCGATTTCTGGCTAA-1"	"G"
"TTCGCGTAGAAACGCC-1"	"G"
"TTCGCGTAGAACTAAC-1"	"A"
"TTCGCGTAGGCAGATC-1"	"G"
"TTCGCGTAGGGACGTT-1"	"A"
"TTCGCGTCAAGACACG-1"	"A"
"TTCGCGTCAATCATCG-1"	"A"
"TTCGCGTCACCTGTGG-1"	"G"
"TTCGCGTCACGTACAT-1"	"A"
"TTCGCGTGTGCAGACA-1"	"A"
"TTCGCGTGTTTCGTTT-1"	"G"
"TTCGCGTTCTTGTCAT-1"	"A"
"TTCGGTCAGAACGTTA-1"	"A"
"TTCGGTCAGATCTCAC-1"	"A"
"TTCGGTCAGGGTCCCT-1"	"G"
"TTCGGTCCAAGAGCGT-1"	"A"
"TTCGGTCTCCTTTGAT-1"	"A"
"TTCGGTCTCGACTTAG-1"	"A"
"TTCGGTCTCTATATCC-1"	"G"
"TTCGGTCTCTGTTGCC-1"	"A"
"TTCGTTAAGCTCCATA-1"	"A"
"TTCGTTAAGTAGTCGG-1"	"G"
"TTCGTTACAATTAGGA-1"	"G"
"TTCGTTACACCACAGC-1"	"A"
"TTCGTTACAGCCACGT-1"	"G"
"TTCGTTACAGTAAGAT-1"	"G"
"TTCGTTACATCTCTCG-1"	"A"
"TTCGTTAGTCTGCGCA-1"	"G"
"TTCGTTAGTGCTTGAT-1"	"G"
"TTCGTTAGTTCAGAAA-1"	"A"
"TTCGTTAGTTGCAGCC-1"	"G"
"TTCGTTAGTTGGACGA-1"	"A"
"TTCTAACAGACCCTAT-1"	"A"
"TTCTAACAGGCGACTA-1"	"A"
"TTCTAACCACATTCTT-1"	"G"
"TTCTAACGTACGACCC-1"	"A"
"TTCTAACGTGATAACA-1"	"A"
"TTCTAACGTGCTAGTT-1"	"A"
"TTCTAACGTGCTGAAG-1"	"A"
"TTCTAACGTTATCGAC-1"	"A"
"TTCTAACTCAAGGCAG-1"	"G"
"TTCTAACTCAGGAATA-1"	"G"
"TTCTAACTCCCAGCGA-1"	"A"
"TTCTAACTCCCAGTAA-1"	"A"
"TTCTAACTCGAGTTAC-1"	"G"
"TTCTGTAAGTAACTCC-1"	"A"
"TTCTGTAGTTCATTTC-1"	"G"
"TTCTGTAGTTGCAGAG-1"	"A"
"TTCTGTAGTTTGACCA-1"	"G"
"TTCTGTATCTATCTAC-1"	"G"
"TTGACGAAGAACGCCA-1"	"A"
"TTGACGAAGAGCAGCT-1"	"G"
"TTGACGAAGGAGTCTG-1"	"A"
"TTGACGACAAAGGAAG-1"	"A"
"TTGACGACAAGATTAG-1"	"G"
"TTGACGAGTAACTCCA-1"	"A"
"TTGACGAGTAATGCCT-1"	"A"
"TTGACGAGTGTGTGCC-1"	"A"
"TTGACGAGTTCCAGTA-1"	"A"
"TTGACGAGTTGCTTGA-1"	"A"
"TTGACGAGTTTGCCCT-1"	"G"
"TTGACGATCAGTGTGT-1"	"A"
"TTGACGATCGCATAAC-1"	"G"
"TTGACGATCGCTGATA-1"	"G"
"TTGAGCAAGTGTCGCC-1"	"G"
"TTGAGCACACAAACGG-1"	"G"
"TTGAGCACACTGCTCT-1"	"G"
"TTGAGCACAGAAAGAG-1"	"A"
"TTGAGCACATTGATGC-1"	"A"
"TTGAGCAGTACTAGAA-1"	"G"
"TTGAGCAGTGATCAGG-1"	"A"
"TTGAGCAGTTTCAGCA-1"	"A"
"TTGAGCATCAACACGT-1"	"A"
"TTGAGCATCCACGCTT-1"	"G"
"TTGAGTGCAACACGGA-1"	"A"
"TTGAGTGCAGAGAGAA-1"	"G"
"TTGAGTGCAGGTAGGT-1"	"A"
"TTGAGTGGTGGAAAGA-1"	"A"
"TTGAGTGTCGCACCTT-1"	"A"
"TTGAGTGTCTGAGTAC-1"	"G"
"TTGCACCAGCTGATTC-1"	"A"
"TTGCACCAGGGAAGCG-1"	"A"
"TTGCACCAGTTACACC-1"	"A"
"TTGCACCCAACTCAAC-1"	"A"
"TTGCACCCAGTAGTCT-1"	"G"
"TTGCACCCATACTGCA-1"	"G"
"TTGCACCGTGCGCTCA-1"	"G"
"TTGCACCGTTAGCTCA-1"	"G"
"TTGCACCGTTTAAGCC-1"	"A"
"TTGCACCTCCGTACGG-1"	"A"
"TTGCACCTCGGTTCCT-1"	"A"
"TTGCACCTCTGTGTGA-1"	"A"
"TTGCAGAAGAAATGGG-1"	"G"
"TTGCAGAAGAGAACCC-1"	"A"
"TTGCAGAAGCCCATGC-1"	"A"
"TTGCAGACAATCAGGG-1"	"G"
"TTGCAGACACAACGGA-1"	"A"
"TTGCAGACAGTAGGCA-1"	"G"
"TTGCAGAGTAAACGGC-1"	"A"
"TTGCAGAGTAACTGAA-1"	"A"
"TTGCAGAGTAGAAAGG-1"	"G"
"TTGCAGAGTATCTAGC-1"	"A"
"TTGCAGAGTGTGACCC-1"	"A"
"TTGCAGATCACCACAA-1"	"G"
"TTGCCCAAGATCACCT-1"	"G"
"TTGCCCAAGTATCTGC-1"	"A"
"TTGCCCACAATTAGGA-1"	"A"
"TTGCCCACACCTGAAT-1"	"A"
"TTGCCCACACTGATTG-1"	"A"
"TTGCCCACATACTGCA-1"	"A"
"TTGCCCAGTTCCTATT-1"	"A"
"TTGCCCATCCAATAGC-1"	"G"
"TTGCCCATCCGCTCTA-1"	"G"
"TTGCCCATCTACCCGT-1"	"A"
"TTGCCCATCTGTTTAC-1"	"A"
"TTGCGAAAGGAGGCGA-1"	"G"
"TTGCGAAAGGAGTAGA-1"	"A"
"TTGCGAAAGTATAGTG-1"	"A"
"TTGCGAACACCTATTT-1"	"A"
"TTGCGAAGTAATGTGA-1"	"G"
"TTGCGAAGTAGGGTTG-1"	"A"
"TTGCGAAGTCTGTGTA-1"	"A"
"TTGCGAAGTGTCCAGC-1"	"G"
"TTGCGAATCCCACGGA-1"	"A"
"TTGCGAATCGGTTAGT-1"	"A"
"TTGCGGGAGCTGAATA-1"	"A"
"TTGCGGGCACATTCTT-1"	"A"
"TTGCGGGGTACTTCGA-1"	"G"
"TTGCGGGTCCTGACCT-1"	"A"
"TTGCGGGTCTTCCGTG-1"	"G"
"TTGCTATAGTCTGCTA-1"	"G"
"TTGCTATCAGCCGAAA-1"	"A"
"TTGCTATCAGGTAACG-1"	"A"
"TTGCTATCAGTTGGAG-1"	"A"
"TTGCTATCATTCTTTG-1"	"G"
"TTGCTATGTAACGGTG-1"	"G"
"TTGCTATGTAGCATGG-1"	"A"
"TTGCTATGTATACGCT-1"	"G"
"TTGCTATGTCAATCCA-1"	"A"
"TTGCTATGTGCGTCCA-1"	"A"
"TTGCTATGTGGACTGA-1"	"A"
"TTGCTATGTTGCCGCA-1"	"A"
"TTGCTATTCCTTTGCG-1"	"A"
"TTGCTATTCGCAGATT-1"	"G"
"TTGCTTAAGGGTTCCC-1"	"G"
"TTGCTTACACATAAAG-1"	"G"
"TTGCTTACATGTAGAA-1"	"A"
"TTGCTTAGTCAACAGG-1"	"G"
"TTGCTTAGTGGTAAGC-1"	"G"
"TTGCTTAGTGTCGTCG-1"	"G"
"TTGCTTAGTTGTATCG-1"	"G"
"TTGCTTATCAAAGTAG-1"	"A"
"TTGCTTATCCCGATTC-1"	"A"
"TTGCTTATCGTATAGC-1"	"A"
"TTGCTTATCTCGTGAA-1"	"A"
"TTGCTTATCTTCACTA-1"	"G"
"TTGGTCCAGCATGTGG-1"	"A"
"TTGGTCCAGCTCCGGT-1"	"A"
"TTGGTCCAGCTGCTCG-1"	"A"
"TTGGTCCAGTGGTGTG-1"	"A"
"TTGGTCCCAACCTCTC-1"	"A"
"TTGGTCCCAAGGCGTA-1"	"A"
"TTGGTCCGTACAAATG-1"	"G"
"TTGGTCCGTAGAACGC-1"	"G"
"TTGGTCCGTCGAGGAT-1"	"A"
"TTGGTCCGTGCAAAGC-1"	"G"
"TTGTCTACATTACACG-1"	"A"
"TTGTCTACATTTAGGC-1"	"G"
"TTGTCTAGTCCAGACC-1"	"G"
"TTGTCTAGTGCACATT-1"	"G"
"TTGTCTAGTGTAGGAC-1"	"G"
"TTGTCTAGTTATCGAC-1"	"G"
"TTGTCTATCGGTTAGT-1"	"G"
"TTGTCTATCTTGGCCT-1"	"A"
"TTGTTCAAGAGTTCGG-1"	"A"
"TTGTTCAAGCGGACAT-1"	"G"
"TTGTTCAAGCTGGAGT-1"	"G"
"TTGTTCAAGTTCAACC-1"	"A"
"TTGTTCACAAGCGGTA-1"	"A"
"TTGTTCACACGATATC-1"	"A"
"TTGTTCACACGCTAAT-1"	"G"
"TTGTTCACACTGTAAC-1"	"A"
"TTGTTCACATAGGCGA-1"	"G"
"TTGTTCAGTAGTTTGC-1"	"G"
"TTGTTCAGTCATAAGA-1"	"A"
"TTGTTCAGTGCCCTAG-1"	"A"
"TTGTTCAGTGGAAAGA-1"	"A"
"TTGTTCAGTGTCCAGC-1"	"A"
"TTGTTCATCCATCATT-1"	"G"
"TTGTTCATCGACTATG-1"	"G"
"TTGTTCATCGTGAGTT-1"	"A"
"TTGTTCATCTCATCCG-1"	"G"
"TTGTTCATCTGCTACC-1"	"A"
"TTGTTGTAGACTAGGC-1"	"G"
"TTGTTGTAGCTATCGT-1"	"G"
"TTGTTGTAGTACAGTA-1"	"A"
"TTGTTGTAGTCATCTG-1"	"A"
"TTGTTGTCAAGAAACT-1"	"A"
"TTGTTGTCAATGTAAG-1"	"A"
"TTGTTGTCAATTCGTG-1"	"A"
"TTGTTGTCACCAAGGA-1"	"G"
"TTGTTGTCACCACAGC-1"	"A"
"TTGTTGTCACTAAACC-1"	"G"
"TTGTTGTCATGGTAAA-1"	"G"
"TTGTTGTGTCATCGTA-1"	"A"
"TTGTTGTGTTAACCAC-1"	"A"
"TTTACGTAGATGTTGA-1"	"A"
"TTTACGTAGTACGACG-1"	"G"
"TTTACGTCAGTAGTTC-1"	"G"
"TTTACGTGTCATAAGA-1"	"A"
"TTTACGTGTGAATGGC-1"	"G"
"TTTACGTGTGCACTTA-1"	"G"
"TTTACGTGTGCCCAGT-1"	"A"
"TTTACGTTCGATAGGG-1"	"A"
"TTTACGTTCGGTCAGC-1"	"A"
"TTTGAGGAGAACTCCT-1"	"A"
"TTTGAGGAGCTGCTCG-1"	"G"
"TTTGAGGCAACTCAAC-1"	"G"
"TTTGAGGCAGGACCTC-1"	"G"
"TTTGAGGCAGTGGTCC-1"	"G"
"TTTGAGGGTCGATTAC-1"	"A"
"TTTGAGGGTCTGTGTA-1"	"G"
"TTTGAGGGTGGACCAA-1"	"A"
"TTTGAGGGTGTCGTGC-1"	"A"
"TTTGAGGTCGGTTCCT-1"	"G"
"TTTGAGGTCTAGTCGA-1"	"A"
"TTTGCGCAGATTCCGT-1"	"G"
"TTTGCGCAGGCGTCCT-1"	"A"
"TTTGCGCAGTTCAGGG-1"	"A"
"TTTGCGCCAACGGACA-1"	"G"
"TTTGCGCCAGCAACGA-1"	"A"
"TTTGCGCCATCCCTTG-1"	"A"
"TTTGCGCGTCAACGGA-1"	"A"
"TTTGCGCGTCATAGAA-1"	"G"
"TTTGCGCGTCTGGGCT-1"	"A"
"TTTGCGCGTGACCAGA-1"	"A"
"TTTGCGCTCGGATGTT-1"	"A"
"TTTGCGCTCTATATCC-1"	"G"
"TTTGGCCAGATGAGGA-1"	"G"
"TTTGGCCAGCAATAAC-1"	"A"
"TTTGGCCAGGCTCCTG-1"	"A"
"TTTGGCCAGGTCGGTA-1"	"G"
"TTTGGCCCAAAGCATA-1"	"G"
"TTTGGCCCACCTGGTG-1"	"A"
"TTTGGCCCACTTACAG-1"	"G"
"TTTGGCCCATAGATAG-1"	"A"
"TTTGGCCGTAATGTAG-1"	"A"
"TTTGGCCGTATCTGCA-1"	"A"
"TTTGGCCGTCACATTG-1"	"A"
"TTTGGCCGTCAGCAAG-1"	"G"
"TTTGGCCTCAAGGCCC-1"	"A"
"TTTGGCCTCGCAAACT-1"	"G"
"TTTGGCCTCTCGCGTT-1"	"A"
"TTTGGTTAGACCATAA-1"	"A"
"TTTGGTTAGCATTGGG-1"	"A"
"TTTGGTTAGGTCTTTG-1"	"A"
"TTTGGTTAGTAACACA-1"	"G"
"TTTGGTTAGTGAATAC-1"	"A"
"TTTGGTTAGTTCGACT-1"	"A"
"TTTGGTTCAATGTAAG-1"	"G"
"TTTGGTTCATTGATGC-1"	"G"
"TTTGGTTGTTACGAAA-1"	"A"
"TTTGGTTTCAAACCAC-1"	"G"
"TTTGGTTTCAGTGTAC-1"	"A"
"TTTGGTTTCGCGCTGA-1"	"G"
"TTTGGTTTCGCGTGAC-1"	"G"
"TTTGGTTTCTGAAAGA-1"	"G"
"TTTGTGTCACCGAAAG-1"	"G"
"TTTGTGTCAGATGGCA-1"	"G"
"TTTGTGTCATCGAGTT-1"	"A"
"TTTGTGTGTCGAGAAC-1"	"G"
"TTTGTGTTCGCTATAG-1"	"A"
