"AAACGAACAAGCAATA-1"	"A"
"AAACGAACATTATGGC-1"	"G"
"AAACGAAGTAGCGTTT-1"	"A"
"AAACTCGAGCCAGAAC-1"	"A"
"AAACTCGAGGCCTAAG-1"	"A"
"AAACTCGGTTTAGAAG-1"	"A"
"AAACTGCCATCCCGGA-1"	"G"
"AAACTGCTCGGTTAGT-1"	"G"
"AAAGATGCAACTGCGC-1"	"A"
"AAAGGATAGGATCCTT-1"	"A"
"AAAGGATTCGTCTTAT-1"	"G"
"AAAGGGCAGACTTGAA-1"	"G"
"AAAGGGCAGCACCATT-1"	"G"
"AAAGGGCCAAAGCTGG-1"	"A"
"AAAGGGCGTCGGCTGT-1"	"G"
"AAATGAGAGACTCTTG-1"	"A"
"AAATGAGAGTAACACA-1"	"G"
"AAATGCCAGATGCGAC-1"	"G"
"AAATGCCAGATTCCGT-1"	"A"
"AAATGCCAGGCACCTC-1"	"A"
"AACAAAGAGCATGTGG-1"	"A"
"AACAAAGTCTACTGCC-1"	"A"
"AACAGTCAGATTACGA-1"	"G"
"AACAGTCCAACAACTC-1"	"A"
"AACATCGTCTATAGGC-1"	"G"
"AACCAACAGTGTTCCA-1"	"A"
"AACCAACGTCTTAGCA-1"	"A"
"AACCAACTCAGAATGA-1"	"A"
"AACCGATAGAGTTTGA-1"	"G"
"AACCGATCACAGGTAG-1"	"G"
"AACCGATGTCTGGTCG-1"	"A"
"AACCGATTCACCCGGA-1"	"A"
"AACCGATTCCACGAGC-1"	"A"
"AACCGATTCCCGAAGC-1"	"G"
"AACCTGAAGTTCAACC-1"	"G"
"AACCTGACAGCAACAG-1"	"G"
"AACCTGAGTATACGCT-1"	"A"
"AACCTTTAGTCCGGAA-1"	"A"
"AACCTTTCAAGACTAA-1"	"G"
"AACCTTTCAGCCACGT-1"	"G"
"AACCTTTGTACCCATA-1"	"G"
"AACGAGGGTGCTGAAG-1"	"A"
"AACGGGAGTGAATGTA-1"	"G"
"AACGTACAGAAAGCAG-1"	"G"
"AACGTACAGAGGCGGA-1"	"A"
"AACGTACAGTAGGAAG-1"	"A"
"AACGTACCATCATGTG-1"	"A"
"AACGTACCATGTCCCT-1"	"G"
"AACGTACGTAAGTCTC-1"	"G"
"AACTGGTAGCCTGTAT-1"	"A"
"AACTGGTAGGCGCTTC-1"	"A"
"AACTGGTCAATTCTCT-1"	"A"
"AACTGGTCAGGTTATC-1"	"A"
"AACTGGTGTACGACCC-1"	"G"
"AACTGGTGTTCTGAGT-1"	"A"
"AACTGGTTCAGATACC-1"	"G"
"AACTGTGAGAACGACC-1"	"G"
"AACTGTGAGAGCTGTG-1"	"A"
"AACTTGGGTGCTGTGC-1"	"G"
"AACTTGGTCTTCGTTA-1"	"G"
"AAGATAGCAGATGGCA-1"	"A"
"AAGGAGCGTACTAGAA-1"	"A"
"AAGGAGCGTCTGTTGA-1"	"A"
"AAGGTTCAGGTTAGTA-1"	"G"
"AATACGCAGATATGAC-1"	"G"
"AATACGCGTTGGAGGT-1"	"A"
"AATGCCAAGACGCCAA-1"	"G"
"AATGCCAAGACTCGGA-1"	"G"
"AATGCCAAGCACGTAG-1"	"A"
"AATGGAACAACTCGAT-1"	"A"
"AATGGAACACCGTCTT-1"	"A"
"AATGGAATCGAAGCCC-1"	"A"
"AATGGCTGTTTCACCC-1"	"A"
"AATGGCTTCGCTATTT-1"	"G"
"AATGTCGAGGTACTCT-1"	"A"
"AATGTCGGTAGAATAC-1"	"G"
"AATGTCGTCCTTGACC-1"	"G"
"ACAAACCAGCCATGGA-1"	"G"
"ACAAACCGTCCTTCAC-1"	"A"
"ACAAAGACAACTCAAC-1"	"G"
"ACAAAGAGTTGCAGCC-1"	"G"
"ACAAAGATCACAACAC-1"	"G"
"ACAAAGATCGGTCCGA-1"	"G"
"ACAAGCTCAACGGGTA-1"	"A"
"ACAATCGAGCTTTCCC-1"	"G"
"ACAATCGTCGATCTTT-1"	"A"
"ACAATCGTCGCACAAT-1"	"G"
"ACAATCGTCGGATAGG-1"	"A"
"ACAGAAACAATAGCGG-1"	"G"
"ACAGAAACACGATTAC-1"	"G"
"ACAGAAAGTACGGAGT-1"	"A"
"ACAGACTCAATTGTGC-1"	"A"
"ACAGACTCACCGTTGG-1"	"G"
"ACAGCGCAGATCTCAC-1"	"A"
"ACAGCGCAGTCAACTC-1"	"G"
"ACAGCGCCAAGAAACT-1"	"A"
"ACAGCGCGTTTGACCA-1"	"G"
"ACAGGCCAGATTAGAC-1"	"A"
"ACAGGCCAGTGTCGGA-1"	"A"
"ACAGGCCTCGTCAACA-1"	"G"
"ACATGCAAGATTAGAC-1"	"G"
"ACATGCAAGGGTATCG-1"	"G"
"ACATGCAGTTGAAGCG-1"	"G"
"ACATGGTCATCCGTGG-1"	"G"
"ACATGGTTCACATTCT-1"	"A"
"ACATGGTTCGGGAATG-1"	"A"
"ACCAAACAGTTGACAA-1"	"G"
"ACCAAACCAACCTCCT-1"	"G"
"ACCAAACCAAGGGTAC-1"	"A"
"ACCATCCAGTCGTACT-1"	"G"
"ACCCAAACATGGCCGT-1"	"G"
"ACCCAAATCTCTATCA-1"	"A"
"ACCGAATAGGAATGGA-1"	"A"
"ACCGAATGTATTGTCG-1"	"A"
"ACCGCAGGTAGGGTCA-1"	"G"
"ACCGCAGGTTTCGTTT-1"	"A"
"ACCGGGTGTGTGTGCC-1"	"G"
"ACCGGGTTCAGTCAAC-1"	"A"
"ACCTGCTCAACGTCGC-1"	"G"
"ACCTGCTCACTTGCGG-1"	"A"
"ACGGATTAGCTAGCAG-1"	"A"
"ACGGATTGTAGCTGTT-1"	"G"
"ACGGATTGTAGGTCTT-1"	"G"
"ACGTGGCCAACCTCTC-1"	"A"
"ACGTGGCGTAGTCTGT-1"	"A"
"ACGTGGCTCCCGTAGG-1"	"G"
"ACGTGGCTCCGCTATC-1"	"A"
"ACGTTAGAGGTGTTGG-1"	"G"
"ACGTTAGGTACGGTTT-1"	"G"
"ACGTTAGTCGTTGTTT-1"	"A"
"ACTAACGAGAAATCTG-1"	"G"
"ACTAACGCATCGGCTG-1"	"G"
"ACTAACGTCACTACCC-1"	"A"
"ACTACCCAGCGAATAT-1"	"G"
"ACTACCCCACTAAACC-1"	"G"
"ACTACCCCATACCCGG-1"	"G"
"ACTACGAAGAATACTG-1"	"A"
"ACTACGAGTGATAAGT-1"	"A"
"ACTAGGTTCCAAGAGG-1"	"G"
"ACTATTCAGATGTTGA-1"	"A"
"ACTATTCGTTCGGGAA-1"	"G"
"ACTATTCTCGACGGAA-1"	"A"
"ACTCGGGCAAACGTTC-1"	"A"
"ACTCGGGCACAATAAG-1"	"A"
"ACTCGGGGTCACAGGA-1"	"G"
"ACTCGGGTCGCACAAT-1"	"G"
"ACTCGGGTCGTTTGAG-1"	"A"
"ACTGCAAAGGCAGTAC-1"	"A"
"ACTGCAACAAACTACC-1"	"G"
"ACTGCAACAAGCAACG-1"	"A"
"ACTGCAACACTGTCAA-1"	"A"
"ACTGCAACAGAACGAC-1"	"A"
"ACTGCAAGTAACGGAC-1"	"A"
"ACTGCAAGTTTGATCG-1"	"G"
"ACTGCAATCGAACCGC-1"	"A"
"ACTGCGGAGGAGAACA-1"	"A"
"ACTGCGGAGTTGGAAT-1"	"G"
"ACTGCGGGTAACGGAC-1"	"A"
"ACTGCGGTCAGAACGG-1"	"G"
"ACTGTCCAGCAGAATT-1"	"G"
"ACTGTCCCAAGTCCTA-1"	"G"
"ACTGTCCCATGATCGT-1"	"G"
"ACTGTCCGTCAATCCA-1"	"A"
"ACTGTCCTCATGTTCT-1"	"A"
"ACTGTCCTCGCGGCAT-1"	"A"
"ACTTCCGTCGCAACTA-1"	"A"
"ACTTCCGTCGGATGTT-1"	"A"
"ACTTTCAAGGACCGAT-1"	"A"
"ACTTTCACAAGACACG-1"	"A"
"ACTTTCACAATGAAAC-1"	"A"
"AGACAAACAAGGTTCT-1"	"A"
"AGACAAACATAGATAG-1"	"G"
"AGACAAACATCCCTTG-1"	"G"
"AGACAAATCACCCGGA-1"	"A"
"AGACAAATCATTCGGA-1"	"G"
"AGACAAATCTCTTCTC-1"	"A"
"AGATAGACACCTCGTT-1"	"G"
"AGATTCGCATACAACC-1"	"A"
"AGATTCGGTATCGCGC-1"	"G"
"AGATTCGGTCTCGGGT-1"	"A"
"AGCCAGCAGGATCCTT-1"	"A"
"AGCCAGCGTAGTACAA-1"	"G"
"AGCCAGCTCAGGCCGT-1"	"A"
"AGCCCGAAGAGCCACA-1"	"G"
"AGCCCGAGTCGGCTGT-1"	"G"
"AGCCCGAGTCTGGGAA-1"	"G"
"AGCCCGAGTTCTACCC-1"	"A"
"AGCCCGAGTTTGCATG-1"	"A"
"AGCCCGATCTCAGATG-1"	"A"
"AGCCGCACAAACTACC-1"	"A"
"AGCCGCAGTGCTTGAT-1"	"A"
"AGCCGCAGTGTGAGGT-1"	"A"
"AGCCGCATCCATTGTT-1"	"G"
"AGCCGCATCGCTATTT-1"	"G"
"AGCCTCTCAATTAGGA-1"	"G"
"AGCCTCTGTTCTACCC-1"	"A"
"AGCCTGGAGTTCAAGA-1"	"A"
"AGCCTGGCAAGTCCTA-1"	"A"
"AGCCTGGGTAACTCCA-1"	"G"
"AGCCTGGGTGGAGTGT-1"	"G"
"AGCCTGGTCGAGGTAG-1"	"A"
"AGCCTGGTCGCCAGAC-1"	"A"
"AGCCTGGTCTAAACGC-1"	"G"
"AGCCTGGTCTTCCACG-1"	"A"
"AGCCTTCCACTCCTCA-1"	"A"
"AGCCTTCCATCGACCG-1"	"A"
"AGCCTTCGTGTTAGAA-1"	"G"
"AGCCTTCTCTTAGTGG-1"	"A"
"AGCGATTAGCGTCAAG-1"	"G"
"AGCGATTAGTCTAGAA-1"	"A"
"AGCGTATCACGCGCAT-1"	"G"
"AGCGTATGTCAACGGA-1"	"A"
"AGCGTGCCAAACCTAC-1"	"A"
"AGCGTGCCAGCAACAG-1"	"G"
"AGCGTGCGTCTGTTGA-1"	"G"
"AGCGTGCTCACAACAC-1"	"A"
"AGCGTGCTCCACGGCA-1"	"A"
"AGCGTGCTCCCGATTC-1"	"A"
"AGCGTGCTCTGATCCC-1"	"G"
"AGCTATGAGTCCAGAG-1"	"G"
"AGCTATGGTAACCCAT-1"	"G"
"AGCTATGGTACTAGAA-1"	"G"
"AGCTATGTCACTCCCA-1"	"G"
"AGCTATGTCATTCTTG-1"	"A"
"AGCTGGCGTCAGTGCC-1"	"G"
"AGCTGGCGTTCAGTAC-1"	"G"
"AGCTGGCTCCGCCTAT-1"	"G"
"AGGACGAAGAACGTTA-1"	"A"
"AGGACGAAGAGCACTG-1"	"A"
"AGGCCCACATCGCCTT-1"	"G"
"AGGCCCACATGGTATC-1"	"A"
"AGGCCTGAGAAGCCTG-1"	"A"
"AGGCCTGCAGTAAGAT-1"	"A"
"AGGCCTGGTAGGTGAC-1"	"A"
"AGGCGAAAGGCACCTC-1"	"A"
"AGGCGAATCATTCATC-1"	"G"
"AGGCGAATCCTGGAAT-1"	"G"
"AGGCGAATCGCTATAG-1"	"G"
"AGGCGTCAGCGTTGCC-1"	"A"
"AGGCGTCAGGATGTCG-1"	"G"
"AGGCGTCTCGGCAATT-1"	"A"
"AGTCAACCATCGCCTT-1"	"A"
"AGTCAACGTTATAGAG-1"	"A"
"AGTCAACGTTCAGAAA-1"	"A"
"AGTCAACTCGAGGTAG-1"	"G"
"AGTCAACTCGGATAGG-1"	"A"
"AGTCCGGAGAAGGGCG-1"	"A"
"AGTCCGGCACAAACAA-1"	"G"
"AGTCCGGTCACGATTG-1"	"A"
"AGTGCCGAGGCTCAGA-1"	"G"
"AGTGCCGAGTGCCCTG-1"	"A"
"AGTGCCGCAAATGTCC-1"	"G"
"AGTGCGCAGGCAGATC-1"	"A"
"AGTGCGCGTAACTCCA-1"	"G"
"AGTGCGCGTAGAAGCC-1"	"G"
"AGTGCGCGTCTCTGGG-1"	"G"
"AGTGTACAGAAATGGG-1"	"A"
"AGTGTACAGTGATATG-1"	"A"
"AGTGTACGTCGGCTGT-1"	"G"
"AGTGTACGTGGACGAT-1"	"A"
"AGTGTACTCAAACCAC-1"	"G"
"AGTTACGCACGTTGTA-1"	"A"
"AGTTACGCATGGGACA-1"	"G"
"AGTTACGTCCGATGCG-1"	"A"
"AGTTTGGAGACTCTTG-1"	"G"
"AGTTTGGAGTCGACCC-1"	"G"
"AGTTTGGAGTCGTACT-1"	"A"
"AGTTTGGGTTTGCCAA-1"	"A"
"ATAGGCTGTACCCATA-1"	"G"
"ATAGTCGAGAAATCTG-1"	"G"
"ATAGTCGCAATTCTCT-1"	"A"
"ATAGTCGGTATTTGCG-1"	"A"
"ATAGTCGTCGGCATAT-1"	"G"
"ATATTCCCACAGAAGC-1"	"A"
"ATATTCCCATCGGCCA-1"	"A"
"ATATTCCGTAGTGATA-1"	"A"
"ATATTCCGTCAAACAA-1"	"G"
"ATCCAGAAGGCCAGTA-1"	"G"
"ATCCAGAGTTACGCTA-1"	"A"
"ATCCAGATCCCAATAG-1"	"A"
"ATCCAGATCCGAATTG-1"	"G"
"ATCCTCGCAACATAAG-1"	"G"
"ATCCTGCAGATCTCAC-1"	"A"
"ATCCTGCTCGCTGATA-1"	"A"
"ATGCATGCATTGAACC-1"	"A"
"ATGCATGGTTTAAGGA-1"	"A"
"ATGCATGTCTGTCGGG-1"	"A"
"ATGGATCAGGCAATTA-1"	"A"
"ATGGATCCAAGGTTCT-1"	"G"
"ATGGATCCAATGACTC-1"	"A"
"ATGGATCGTGGACCAA-1"	"G"
"ATGTACGAGTGGACGT-1"	"A"
"ATGTACGCACTGTCGG-1"	"A"
"ATGTACGGTATTCGCA-1"	"A"
"ATGTACGGTCCTTCAC-1"	"G"
"ATGTCGAGTATTCGCA-1"	"A"
"ATGTCGAGTGTGTGCC-1"	"A"
"ATGTCTTCAAGTCTGT-1"	"G"
"ATGTCTTCAGCCACGT-1"	"A"
"ATGTCTTGTATGAAGT-1"	"A"
"ATGTTTCCAGTATACC-1"	"G"
"ATGTTTCGTTTAGACC-1"	"A"
"ATGTTTCTCACTAGGT-1"	"A"
"ATGTTTCTCTGAACGT-1"	"A"
"ATTACCTAGGAATGGA-1"	"G"
"ATTACCTCATATACGC-1"	"G"
"ATTACCTTCTGCTACC-1"	"A"
"ATTACTCCACATGATC-1"	"A"
"ATTACTCGTTTGAAGA-1"	"A"
"ATTACTCTCCACGCTT-1"	"G"
"ATTCGTTAGTGAAACT-1"	"A"
"ATTCGTTCAGCGTCGT-1"	"A"
"ATTGTCTCACATCATG-1"	"G"
"ATTGTCTGTCGATTAC-1"	"A"
"ATTGTCTTCTACCCGT-1"	"A"
"ATTGTGGGTGACAAGC-1"	"G"
"ATTGTGGGTGCTGTCG-1"	"G"
"ATTGTGGTCCTCATTA-1"	"G"
"ATTGTGGTCGTTCCGT-1"	"A"
"ATTTGTCAGGTAAGTT-1"	"G"
"ATTTGTCAGTCTGCTA-1"	"A"
"ATTTGTCGTCATAGCT-1"	"A"
"ATTTGTCGTTAACCGT-1"	"G"
"CAACCAAGTCCCGTGA-1"	"G"
"CAACGGCAGAGTTTGA-1"	"A"
"CAACGGCTCCATCATT-1"	"G"
"CAACGTAAGACGTCAG-1"	"G"
"CAACGTACATCAGCTA-1"	"A"
"CAACGTAGTAGGGTCA-1"	"A"
"CAACGTAGTCACAGTT-1"	"G"
"CAAGAAAAGAACAGGA-1"	"A"
"CAAGAAAAGTGAGCTG-1"	"A"
"CAAGAAATCACTGGTA-1"	"A"
"CAAGAAATCAGTCACA-1"	"A"
"CAAGAAATCTTGTACT-1"	"A"
"CAAGGCCAGCGTCAAG-1"	"A"
"CAAGGCCTCAACTTGG-1"	"A"
"CAAGGCCTCCAACCTC-1"	"A"
"CAAGGCCTCGCGGCAT-1"	"A"
"CAAGGCCTCTGACATG-1"	"A"
"CAATCCCAGCGAATAT-1"	"A"
"CAATCCCAGTATACCC-1"	"G"
"CAATCCCGTCCCTAAA-1"	"G"
"CACAACATCAGGCGCT-1"	"A"
"CACAACATCGGTTGTA-1"	"A"
"CACAGATAGTGGACGT-1"	"A"
"CACATGAAGCTAGTTC-1"	"A"
"CACATGACACTTACAG-1"	"A"
"CACATGAGTGTCTCGG-1"	"A"
"CACATGAGTGTTGTTG-1"	"G"
"CACATGATCTCCTTAA-1"	"A"
"CACCACTAGAACTCCT-1"	"A"
"CACCTGTCACATTCTT-1"	"G"
"CACCTGTGTGCGTCCA-1"	"A"
"CACCTTGAGTGAGCAC-1"	"G"
"CACCTTGCAAACAGTA-1"	"A"
"CACCTTGCACCCTTTG-1"	"G"
"CACCTTGCAGCAACGA-1"	"G"
"CACCTTGCATGTAGAA-1"	"A"
"CACCTTGGTACCCACG-1"	"A"
"CACCTTGTCCAACAAC-1"	"A"
"CACGTTCAGTTGTCCA-1"	"A"
"CACGTTCCAGTAGGCA-1"	"A"
"CACTAAGGTGCCCAGT-1"	"G"
"CACTAAGTCGAGTTAC-1"	"G"
"CACTAAGTCGCTCTAC-1"	"G"
"CACTGAAAGATATGTG-1"	"G"
"CACTGAACATCGTACA-1"	"G"
"CACTGAATCCACTAGA-1"	"A"
"CACTGAATCCGGAAAG-1"	"G"
"CACTGAATCTATATCC-1"	"G"
"CAGCCTTCAGATAAGT-1"	"G"
"CAGCCTTGTTAGTAGA-1"	"A"
"CAGCTAAAGTCTGCTA-1"	"G"
"CAGCTAACAAAGCTTC-1"	"G"
"CAGCTAATCGTATAGC-1"	"A"
"CAGCTGGCATTGATGC-1"	"A"
"CAGCTGGTCTCTGAGA-1"	"A"
"CAGGATTCAACACGGA-1"	"A"
"CAGGGCTAGTCGAGCA-1"	"A"
"CAGGGCTAGTTGCTTG-1"	"G"
"CAGGGCTGTATTGTCG-1"	"G"
"CAGGGCTGTGGAAGCT-1"	"G"
"CAGGGCTTCTGCTACC-1"	"A"
"CAGTGCGGTCTGGGAA-1"	"G"
"CAGTGCGTCACTCGGG-1"	"G"
"CAGTGTACACGAACGA-1"	"A"
"CATAACGAGTGCTAGG-1"	"A"
"CATAACGCACAAACGG-1"	"G"
"CATAACGCAGAGATGC-1"	"A"
"CATAACGTCCCTACGT-1"	"G"
"CATGCCTAGGAAGACA-1"	"G"
"CATGCCTAGTGAGTTA-1"	"A"
"CATGCCTCATGATCGT-1"	"A"
"CATGCCTTCACTTACT-1"	"A"
"CATGCCTTCTGCTACC-1"	"G"
"CATGTTTCACATGATC-1"	"A"
"CATGTTTGTACGTATC-1"	"A"
"CATGTTTTCACTTACT-1"	"A"
"CATTCATAGAAGGGCG-1"	"G"
"CATTCATAGACCCTAT-1"	"A"
"CATTCATAGTAGGAAG-1"	"A"
"CATTCATAGTGTCGCC-1"	"A"
"CATTCATCATCTCACC-1"	"A"
"CATTCATTCCCTAAAG-1"	"A"
"CATTCCGGTAGGTCTT-1"	"G"
"CATTCCGGTTGCCGCA-1"	"A"
"CATTGGAAGAGGAATG-1"	"G"
"CCAATGAAGTGTCACT-1"	"A"
"CCAATGAGTAAGCCGA-1"	"G"
"CCAATGATCCTATCAT-1"	"G"
"CCACAGGCAAGGATGC-1"	"G"
"CCACAGGTCACAGGGA-1"	"G"
"CCACAGGTCGGTAGGA-1"	"A"
"CCACGTTCACTACACA-1"	"A"
"CCACGTTGTTGTGAGG-1"	"G"
"CCAGAATAGTCGACCC-1"	"A"
"CCAGAATCAGGCAGAT-1"	"A"
"CCAGAATGTAACCATC-1"	"G"
"CCAGAATGTACAAATG-1"	"G"
"CCAGATACAACTAGAA-1"	"A"
"CCAGATATCAGGCCGT-1"	"G"
"CCATACCAGTTGGAAT-1"	"G"
"CCATACCCACATGATC-1"	"A"
"CCATACCCAGTAACTC-1"	"A"
"CCATACCCATGATCGT-1"	"A"
"CCATACCGTTAAGTCC-1"	"G"
"CCATACCTCCTAAGTG-1"	"G"
"CCCACATAGCTAACAA-1"	"G"
"CCCACATCAAGTTCGT-1"	"G"
"CCCACATGTGATAACA-1"	"G"
"CCCACATTCAAGAGGC-1"	"G"
"CCCACATTCATGTTCT-1"	"G"
"CCCAGAGAGAGGAACA-1"	"A"
"CCCAGAGTCACTACCC-1"	"A"
"CCCGTTAAGCCAGAAC-1"	"A"
"CCCGTTAGTATGGATA-1"	"A"
"CCCGTTAGTGTGAGGT-1"	"A"
"CCCTAACCAAGGACCA-1"	"G"
"CCCTAACCAATTCTCT-1"	"G"
"CCCTAACGTCCTATTT-1"	"G"
"CCCTAACGTTAAGTCC-1"	"A"
"CCCTAGTAGGAAGACA-1"	"A"
"CCCTAGTAGGGCATTG-1"	"A"
"CCCTAGTGTCGCGCTA-1"	"A"
"CCCTCTCAGTTGGAAT-1"	"A"
"CCCTCTCCACTGTCGG-1"	"A"
"CCCTCTCCATTAACGC-1"	"A"
"CCCTCTCGTAGGTGAC-1"	"A"
"CCCTCTCGTGGTGGTA-1"	"G"
"CCCTCTCTCGATGTGT-1"	"G"
"CCCTGATAGTTCAGGG-1"	"G"
"CCCTGATGTAGTATCC-1"	"A"
"CCCTGATGTTGTGAGG-1"	"G"
"CCCTGATTCGTGCTGG-1"	"A"
"CCGCATTAGTCAACTC-1"	"A"
"CCGCATTCAGCTATAC-1"	"A"
"CCGCATTGTAACCCAT-1"	"A"
"CCGCATTTCTCAGATG-1"	"A"
"CCGTACTCAATGTGCT-1"	"A"
"CCGTACTCATTGCGAT-1"	"G"
"CCGTACTGTCAGAAGC-1"	"A"
"CCGTACTTCTTCACTA-1"	"G"
"CCGTAGGAGGTTAGTA-1"	"G"
"CCGTAGGCAGCAGGTA-1"	"G"
"CCGTAGGCATGATCGT-1"	"G"
"CCGTGAGAGAAATACC-1"	"A"
"CCGTGAGTCAACTTGG-1"	"A"
"CCGTGAGTCGGATCGC-1"	"G"
"CCTAAAGAGAGGTACC-1"	"A"
"CCTAAAGCACGCGTTG-1"	"A"
"CCTAAAGCAGTTAAAG-1"	"G"
"CCTATTAAGTGAAACT-1"	"A"
"CCTATTAGTGCTGGCT-1"	"A"
"CCTATTATCTTCATAC-1"	"G"
"CCTCCCTCAGAGCCAA-1"	"G"
"CCTCCCTGTGCCAAGA-1"	"G"
"CCTCCCTGTTTGGATC-1"	"G"
"CCTCCCTTCTAGCAGT-1"	"A"
"CCTGCTAAGAACGTCG-1"	"A"
"CCTGCTACAAACAGTA-1"	"G"
"CCTGCTATCTGTCGGG-1"	"A"
"CCTGGGACAAGATTAG-1"	"A"
"CCTGGGACAGAACTTC-1"	"A"
"CCTGGGACATCACAAC-1"	"G"
"CCTGGGAGTATTGTGC-1"	"G"
"CCTGGGATCATTGCCC-1"	"A"
"CCTGGGATCTTGTCGC-1"	"A"
"CCTTAATCAGGTGGTA-1"	"A"
"CCTTAATGTTCCCAAA-1"	"G"
"CCTTAATGTTCTGATG-1"	"A"
"CCTTAATGTTGGGAAC-1"	"G"
"CCTTAATGTTTCGACA-1"	"G"
"CCTTGCAAGCAACGGT-1"	"G"
"CCTTGCAAGCGCGTTC-1"	"G"
"CCTTGCACAGGCATTT-1"	"A"
"CCTTGCAGTCGAGGAT-1"	"A"
"CCTTGCAGTTCAGAAA-1"	"A"
"CCTTGCATCCTCCAGT-1"	"A"
"CCTTGGTCACGCGATC-1"	"G"
"CCTTGGTGTAGGTAAT-1"	"G"
"CGAGTTAAGGGTTCCC-1"	"G"
"CGAGTTAAGTCCCGCA-1"	"A"
"CGAGTTACAGGGTACA-1"	"A"
"CGAGTTACAGTGCTCG-1"	"G"
"CGAGTTATCCATTGTT-1"	"A"
"CGAGTTATCGGGTCCA-1"	"A"
"CGATGATGTTACTACG-1"	"A"
"CGATGATTCAACACGT-1"	"G"
"CGATGATTCTCTATTG-1"	"A"
"CGCAATAGTAAACCCT-1"	"G"
"CGCAATATCACAACAC-1"	"G"
"CGCAATATCAGTCTTT-1"	"G"
"CGCAATATCGTGGTAT-1"	"A"
"CGCACAGGTAAGTCTC-1"	"A"
"CGCACAGGTTCCAATG-1"	"G"
"CGCAGGTCAGCCACGT-1"	"A"
"CGCGCAACAAGGAGGG-1"	"G"
"CGCGCAACAGATTAAG-1"	"A"
"CGCGCAATCGTTCAGA-1"	"G"
"CGCTAGGAGTCGAGCA-1"	"A"
"CGCTAGGCAGACTAAA-1"	"A"
"CGCTAGGCAGGTGGTA-1"	"A"
"CGCTAGGGTCTGGTTA-1"	"A"
"CGCTATCCATTTAGGC-1"	"A"
"CGCTATCTCCGGAAAG-1"	"A"
"CGCTGGACATAGAATG-1"	"G"
"CGCTGGACATCCGTAA-1"	"G"
"CGGACCACAGTAACTC-1"	"A"
"CGGACCAGTATCCCTC-1"	"G"
"CGGACCATCGCACCGA-1"	"G"
"CGGACTGAGGGCTTCC-1"	"A"
"CGGACTGAGTGATCTC-1"	"A"
"CGGACTGCAACAACTC-1"	"G"
"CGGACTGCAGATACAA-1"	"G"
"CGGACTGCATGGTATC-1"	"G"
"CGGACTGTCGCACCTT-1"	"A"
"CGGTGCAAGACCCATT-1"	"G"
"CGGTGCAGTTCTTATC-1"	"A"
"CGTACAAAGGGCTTCC-1"	"G"
"CGTACAATCCATTGTT-1"	"A"
"CGTGGCACAAGCGTCC-1"	"G"
"CGTGGCACAGCGTGAA-1"	"G"
"CGTGGCATCGAAGCCC-1"	"G"
"CGTGGCATCGTTGTTT-1"	"A"
"CGTTCCAAGTATGGGC-1"	"A"
"CTAACTTAGTGAGCTG-1"	"G"
"CTAACTTTCCTTTGAT-1"	"A"
"CTACTTAAGGCAGTGT-1"	"A"
"CTACTTACAAATTGAG-1"	"A"
"CTACTTAGTAACGGTG-1"	"A"
"CTACTTATCGGTTCCT-1"	"A"
"CTAGCGGAGCAATGTA-1"	"A"
"CTAGCGGGTTTGCATG-1"	"G"
"CTAGGATAGAGGAACA-1"	"A"
"CTAGGATGTCAGACGA-1"	"A"
"CTAGGATTCCAGGTAT-1"	"A"
"CTAGGGCAGTAGCAAT-1"	"G"
"CTAGGGCCACGCTCAG-1"	"A"
"CTAGGGCCAGCAAACG-1"	"A"
"CTCAACCAGAATCAAC-1"	"G"
"CTCAACCGTTTCGACA-1"	"G"
"CTCAACCTCTCGTAGA-1"	"A"
"CTCACCACACACATGT-1"	"G"
"CTCACCATCGCTTACC-1"	"A"
"CTCAGCTTCGAGGTCC-1"	"G"
"CTCAGCTTCTAGCAAC-1"	"A"
"CTCATGCAGTCCTTCC-1"	"G"
"CTCATGCTCGTCTAGA-1"	"A"
"CTCCCAACAAGCCTTA-1"	"A"
"CTCCCAACATGCCCTT-1"	"A"
"CTCCCAAGTCTGTGTA-1"	"A"
"CTCCCAAGTGTTTCTT-1"	"G"
"CTCGCTAAGGATGTCG-1"	"A"
"CTCGCTAAGTTCCAGT-1"	"G"
"CTCGCTAGTAGCGAGT-1"	"A"
"CTCGCTATCAGAGTGG-1"	"G"
"CTCGCTATCCGATGCG-1"	"A"
"CTCGCTATCTAGTCGA-1"	"A"
"CTCGCTATCTGGTACA-1"	"A"
"CTCTACGAGATACCAA-1"	"G"
"CTCTACGTCAGAACGG-1"	"A"
"CTCTAGCAGAGAGGTA-1"	"G"
"CTCTAGCCATGGGTGA-1"	"A"
"CTCTCAGAGCGAATAT-1"	"G"
"CTCTCAGAGGTACATA-1"	"A"
"CTCTCAGGTGCGCTCA-1"	"A"
"CTCTCGAAGTATACCC-1"	"A"
"CTCTCGAGTGCACTTA-1"	"A"
"CTCTCGATCTTAAGCG-1"	"G"
"CTGAATGAGATCGATA-1"	"A"
"CTGAATGAGTCCGATT-1"	"A"
"CTGAATGCACATTGCA-1"	"A"
"CTGAATGGTGCTGTGC-1"	"A"
"CTGCGTTGTAAGTGCG-1"	"A"
"CTGCGTTGTAGTCCAT-1"	"A"
"CTGCGTTTCTGATCTT-1"	"A"
"CTGCTCAAGTTAGCAA-1"	"A"
"CTGGCAGAGAACAGGA-1"	"A"
"CTGGCAGGTTCATTTC-1"	"A"
"CTGGCAGGTTCGGGAA-1"	"G"
"CTGGCAGTCGGTCTAA-1"	"G"
"CTGGGACCATTTAGGC-1"	"G"
"CTGGGACGTATGGATA-1"	"A"
"CTGGGACGTCCAGACC-1"	"A"
"CTGTATTAGATACCAA-1"	"G"
"CTGTATTGTTTGCCAA-1"	"A"
"CTGTATTTCGCCAGAC-1"	"G"
"CTGTTCGCATCCCTCA-1"	"G"
"CTGTTCGGTAACGGTG-1"	"G"
"CTGTTCGTCTGAACGT-1"	"G"
"CTTAATCTCTTCGTTA-1"	"A"
"CTTCCAGAGGGCGAAG-1"	"G"
"CTTCCAGCAGGACTGA-1"	"G"
"CTTCCAGGTCATTGCA-1"	"G"
"CTTCCAGGTGGATTTC-1"	"G"
"CTTCTAAGTAATGTAG-1"	"G"
"CTTGAAGAGGAAGACA-1"	"G"
"CTTGAAGGTTTGTCTT-1"	"A"
"CTTGAAGTCACATTCT-1"	"A"
"CTTGAAGTCTGAAAGA-1"	"G"
"CTTGAAGTCTTAACGG-1"	"G"
"CTTGCCACAAGTCTCA-1"	"A"
"CTTGCCACAATGTGCT-1"	"A"
"CTTGCCAGTCACTCTC-1"	"G"
"CTTGCTGAGATAGGTT-1"	"G"
"CTTGCTGAGGCTCCTG-1"	"A"
"CTTGCTGTCAGGAAGC-1"	"A"
"CTTGTCGAGGCCAATG-1"	"G"
"CTTGTCGCATGGGACA-1"	"G"
"CTTGTCGTCAAGTTGC-1"	"G"
"CTTTGCGGTAAGGTCG-1"	"A"
"CTTTGCGGTAGAATAC-1"	"A"
"CTTTGCGGTGCATTCA-1"	"G"
"CTTTGCGTCAAACCCA-1"	"A"
"GAAACAACAAGCAACG-1"	"G"
"GAAACAAGTCATTGGT-1"	"A"
"GAAAGTAAGGCCTAAG-1"	"A"
"GAAAGTAAGGTTGACG-1"	"G"
"GAAAGTACATCGTACA-1"	"A"
"GAAATGAAGCCATGGA-1"	"A"
"GAAATGAAGTGTAATG-1"	"G"
"GAAATGAGTACAAGCG-1"	"G"
"GAAATGATCACGTGTA-1"	"G"
"GAAATGATCGAGGTAG-1"	"A"
"GAAATGATCTTCACTA-1"	"G"
"GAACCGCCACGCGTTG-1"	"G"
"GAACCGCTCCAATAGC-1"	"G"
"GAACCTAAGAATCAGT-1"	"A"
"GAACCTAGTTCTTTCA-1"	"A"
"GAACCTATCTTGTCAT-1"	"G"
"GAACGTTGTAGTAACA-1"	"A"
"GAACGTTTCCATTGTT-1"	"G"
"GAACGTTTCGGTTCCT-1"	"G"
"GAACTTGAGCTTTCCC-1"	"A"
"GAACTTGCAGCTATAC-1"	"G"
"GAACTTGCATGCGACC-1"	"G"
"GAACTTGGTTACGCTA-1"	"G"
"GAACTTGTCGGATCGC-1"	"G"
"GAAGAGCCAGCGCGTT-1"	"G"
"GAAGAGCGTCTGGGCT-1"	"G"
"GAAGAGCTCAATTCCT-1"	"G"
"GAAGAGCTCCCACGGA-1"	"A"
"GAAGTCTAGATATGAC-1"	"G"
"GAAGTCTTCAGAGTGG-1"	"A"
"GAAGTCTTCCCACGGA-1"	"G"
"GAAGTCTTCCCGAAGC-1"	"A"
"GAAGTCTTCGAACCGC-1"	"A"
"GAAGTGGAGAGAGGTA-1"	"A"
"GAAGTGGGTCAGTGTT-1"	"A"
"GAAGTGGTCCTCTCTT-1"	"A"
"GAAGTGGTCTTGTCAT-1"	"A"
"GAATCTGCACTGAAGG-1"	"A"
"GAATCTGCATTACACG-1"	"G"
"GAATCTGCATTTGGCA-1"	"A"
"GAATCTGTCCCATAGA-1"	"A"
"GACCAATGTATCTCAG-1"	"A"
"GACCAATTCTTGTCAT-1"	"G"
"GACCCAGAGGTTTCTG-1"	"A"
"GACCCAGCAAACTACC-1"	"G"
"GACCCAGGTTACTACG-1"	"G"
"GACCGACCATCAGAAA-1"	"A"
"GACCGACGTCCGTAGC-1"	"A"
"GACCTTCGTGACGCAA-1"	"A"
"GACCTTCGTGGAGTGT-1"	"A"
"GACTAACAGTTGAATG-1"	"G"
"GACTAACGTCAACAGG-1"	"G"
"GACTAACGTGGTTCTA-1"	"G"
"GACTAACTCAGAGTGG-1"	"A"
"GACTAGTCAACGCAAG-1"	"G"
"GACTAGTCACCACCAG-1"	"G"
"GACTAGTGTGTAGGAC-1"	"A"
"GAGAACGCATACTGCA-1"	"A"
"GAGAACGTCCAATAGC-1"	"G"
"GAGACTTTCAACGTGT-1"	"A"
"GAGATTCCAGGTGGTA-1"	"G"
"GAGATTCCATGGCCTG-1"	"G"
"GAGATTCTCCGGCGAT-1"	"G"
"GAGATTCTCGCACCTT-1"	"G"
"GAGCATTAGCATTGGG-1"	"A"
"GAGCATTAGGTGTTGG-1"	"A"
"GAGCATTCAAGGCGTA-1"	"G"
"GAGCATTGTATGGGTG-1"	"A"
"GAGCGCTCAATGGCTT-1"	"A"
"GAGCGCTGTGGATTTC-1"	"A"
"GAGCGCTTCCGCTATC-1"	"A"
"GAGCGCTTCCTATCCG-1"	"A"
"GAGGATGAGCTGAAAT-1"	"G"
"GAGGATGAGTAGGAAG-1"	"A"
"GAGGATGGTCCCTAAA-1"	"A"
"GAGGATGTCCCAGCGA-1"	"A"
"GAGGCTCCACGTTGTA-1"	"A"
"GAGGCTCGTCAATCCA-1"	"G"
"GAGGCTCGTTCCGCGA-1"	"A"
"GAGGCTCTCAGGATCT-1"	"G"
"GAGGCTCTCCACGGCA-1"	"A"
"GAGGCTCTCCTAAAGC-1"	"G"
"GAGGTCCCACTCGCAG-1"	"A"
"GAGGTCCGTGGTGGTA-1"	"G"
"GAGGTCCGTTGGCGAA-1"	"A"
"GAGGTCCTCGTCCCTA-1"	"A"
"GAGTGAGCAGAACGAC-1"	"A"
"GAGTGAGGTTGAATAG-1"	"G"
"GAGTGAGTCTTGTCAT-1"	"A"
"GATCATGCAGCAACCC-1"	"G"
"GATCATGGTATGGTTC-1"	"A"
"GATCGTAAGTTAGCGG-1"	"G"
"GATCGTACATAGGCGA-1"	"A"
"GATCGTATCGCCACTT-1"	"G"
"GATGATCCAATTCGTG-1"	"G"
"GATGATCGTTTCCACC-1"	"A"
"GATGGCCAGGCGTAGT-1"	"A"
"GATGGCCGTGATGCGA-1"	"A"
"GATGGCCTCATTCGGA-1"	"A"
"GATGGCCTCGATGCAT-1"	"G"
"GATTAGCGTCGATAGG-1"	"A"
"GATTGACCACCGAAAG-1"	"A"
"GATTGACGTCGACTGC-1"	"G"
"GATTGACGTGGTACTT-1"	"A"
"GCAAAGGAGGTTGACG-1"	"G"
"GCAAAGGCACACTAGT-1"	"G"
"GCAAAGGGTAGCGTTT-1"	"A"
"GCAAAGGGTGATAGAT-1"	"A"
"GCAAAGGTCCGTCAAA-1"	"G"
"GCAACCGCATCCGTAA-1"	"A"
"GCAACCGTCGTTCTAT-1"	"A"
"GCACGCAAGTTGCCGC-1"	"G"
"GCACGCAGTGCGCTCA-1"	"G"
"GCACGCATCCTGACCT-1"	"A"
"GCACGGTAGATCGAGC-1"	"A"
"GCACGGTCAATTCGTG-1"	"G"
"GCACGGTGTACCAAGG-1"	"A"
"GCAGATTGTGGCATAG-1"	"A"
"GCAGCCATCTGGCCAG-1"	"A"
"GCAGCCATCTTACGGA-1"	"G"
"GCAGCCATCTTACTCA-1"	"G"
"GCAGCTGAGTAGCAAT-1"	"A"
"GCAGCTGGTCCACCAG-1"	"A"
"GCAGCTGGTTCCCGGA-1"	"G"
"GCAGCTGTCACAAGCT-1"	"A"
"GCAGCTGTCGCTTACC-1"	"G"
"GCAGCTGTCGTCCCTA-1"	"A"
"GCATGATAGTACTCTG-1"	"G"
"GCATGATTCGACCCGA-1"	"A"
"GCATGATTCGCTTGAA-1"	"A"
"GCATTCCGTACCCACG-1"	"A"
"GCATTCCTCGACTGGC-1"	"A"
"GCATTGACAAACCGAG-1"	"G"
"GCATTGAGTCAGGTGA-1"	"G"
"GCATTGATCGAACCGC-1"	"A"
"GCCAGACCATGCACTA-1"	"A"
"GCCAGACGTTATGCAC-1"	"G"
"GCCAGCAAGATGCGCA-1"	"G"
"GCCAGCACATAGCAGG-1"	"G"
"GCCAGCACATTTGGTG-1"	"G"
"GCCAGCAGTAGTACAA-1"	"A"
"GCCAGCAGTCTGTCCT-1"	"G"
"GCCATAAGTCAACAGG-1"	"A"
"GCCATAAGTTAAGTCC-1"	"G"
"GCCATAATCTACTTTG-1"	"A"
"GCCCAGATCGGTGATT-1"	"G"
"GCCCGAAAGCGCACAA-1"	"G"
"GCCTACTCATGACTGT-1"	"G"
"GCCTACTTCTTGGCCT-1"	"G"
"GCCTAGGGTGCGTCCA-1"	"A"
"GCCTAGGGTTCTTTGT-1"	"A"
"GCGAGAAAGGCTGGAT-1"	"A"
"GCGAGAACAAGTCCTA-1"	"G"
"GCGAGAATCATGAACC-1"	"A"
"GCGATCGCAACGAGGT-1"	"A"
"GCGATCGTCAGGGTTT-1"	"G"
"GCGATCGTCGCAAACT-1"	"A"
"GCGATCGTCGTGATAC-1"	"A"
"GCGCCAATCGGATAGG-1"	"A"
"GCGGAAAAGGTTGTTC-1"	"G"
"GCGGAAACAGGCATCC-1"	"A"
"GCGGAAAGTACGACCC-1"	"G"
"GCGGAAATCACCGCGA-1"	"A"
"GCGGAAATCGGTCTAA-1"	"A"
"GCGGGTTAGACTAGGC-1"	"G"
"GCGGGTTAGATCGAGC-1"	"G"
"GCGGGTTCAACAAACA-1"	"G"
"GCGGGTTTCCATACGA-1"	"A"
"GCGGTGTAGTCTCCAA-1"	"A"
"GCGGTGTTCCCTATTA-1"	"A"
"GCGTAGCGTGAATCGG-1"	"A"
"GCGTAGCTCTTTGCAT-1"	"G"
"GCGTTGGCAATCCATG-1"	"G"
"GCGTTGGGTCTCTGGG-1"	"A"
"GCGTTGGTCATTCATC-1"	"A"
"GCTCACTAGACTTCCA-1"	"G"
"GCTCACTCAAAGGTCG-1"	"G"
"GCTCACTTCTATCTAC-1"	"A"
"GCTCAGGAGAGATTAC-1"	"A"
"GCTCAGGGTGCACCCA-1"	"G"
"GCTCAGGTCAACACGT-1"	"A"
"GCTCCTAAGGAGTCTG-1"	"G"
"GCTCCTAAGTCTCCAA-1"	"G"
"GCTCCTACAAGGCGTA-1"	"G"
"GCTCCTATCGAGTGTT-1"	"G"
"GCTCGAGCAGAGCCAA-1"	"A"
"GCTGAGCAGGGATCCA-1"	"A"
"GCTGAGCAGGTCACTT-1"	"G"
"GCTGAGCGTGTAGGAC-1"	"A"
"GCTGCGAAGGCCAATG-1"	"G"
"GCTGCGAAGTGATATG-1"	"A"
"GCTGCGATCACAGGGA-1"	"A"
"GCTGTTCGTGTGTGCC-1"	"G"
"GCTGTTCTCCGATGCG-1"	"A"
"GCTGTTCTCCGGGCAT-1"	"G"
"GCTTAAGCAAATGCTC-1"	"A"
"GCTTGCTAGACTTGAA-1"	"A"
"GCTTGCTCAATAGCGG-1"	"G"
"GCTTGCTCAATGCATC-1"	"G"
"GCTTGCTGTAGTTTGC-1"	"A"
"GCTTGCTTCTCGACCT-1"	"A"
"GCTTTCGAGGTCACTT-1"	"A"
"GCTTTCGTCGAGTTAC-1"	"G"
"GGAACTTCACATCATG-1"	"G"
"GGAACTTCACTCAGCG-1"	"G"
"GGAACTTTCCCGATTC-1"	"A"
"GGAATCTTCTCTGAGA-1"	"G"
"GGACACCAGGATGTCG-1"	"G"
"GGACACCCACTGATAC-1"	"A"
"GGACACCGTTACGCTA-1"	"G"
"GGACACCGTTCTTTCA-1"	"A"
"GGAGAACAGCCTATAC-1"	"G"
"GGAGAACCATGGCCCA-1"	"G"
"GGAGGATCAGAAGTGC-1"	"G"
"GGAGGATCAGGCATTT-1"	"G"
"GGAGGATGTCTGAGCC-1"	"G"
"GGAGGATTCGCGTGAC-1"	"G"
"GGAGGATTCTTACTCA-1"	"G"
"GGAGTAGAGGATTGAT-1"	"A"
"GGAGTAGCATAGAATG-1"	"G"
"GGAGTAGGTCCAAGAG-1"	"A"
"GGAGTAGGTGCTTACA-1"	"A"
"GGAGTAGGTGTCGTGC-1"	"A"
"GGATAGGGTTCGGGAA-1"	"G"
"GGATAGGTCTTAATCC-1"	"G"
"GGATAGGTCTTTGCAT-1"	"G"
"GGATGAGCAATCAGGG-1"	"A"
"GGATGAGCACAGGAAC-1"	"A"
"GGATGAGGTGTCTACA-1"	"A"
"GGATGAGTCTCCAACC-1"	"A"
"GGCATTAGTCCTTATT-1"	"A"
"GGCATTATCGATATGC-1"	"A"
"GGCGAAAAGTTACCAC-1"	"G"
"GGCGAAACACATCATG-1"	"G"
"GGCGAAAGTACGGATG-1"	"A"
"GGCGAAAGTATTCTGG-1"	"A"
"GGCGTTGGTGGTAGAC-1"	"G"
"GGCGTTGGTTACGGAG-1"	"A"
"GGCGTTGTCGATGCAT-1"	"A"
"GGCGTTGTCTACATCT-1"	"G"
"GGCGTTGTCTGGTACA-1"	"A"
"GGGAACAAGCCCATTA-1"	"A"
"GGGAACACAATCATCG-1"	"A"
"GGGAACATCGCTGATA-1"	"A"
"GGGAACATCGGATAAA-1"	"A"
"GGGAACATCGGATGTT-1"	"A"
"GGGACCTCATCGGCTG-1"	"G"
"GGGACCTTCCGGCGAT-1"	"A"
"GGGACCTTCCGTACGG-1"	"A"
"GGGACCTTCGGCTATA-1"	"A"
"GGGCCATAGACACAAT-1"	"G"
"GGGCCATAGTTCAGGG-1"	"A"
"GGGCCATCAAGATGCG-1"	"A"
"GGGCCATCACCGAATT-1"	"A"
"GGGCCATGTACGCCCA-1"	"A"
"GGGTCTGAGGTGTTGG-1"	"G"
"GGGTCTGCATACAACC-1"	"A"
"GGGTCTGTCTAGCAGT-1"	"A"
"GGGTGTCCAGTTGCAT-1"	"G"
"GGGTGTCGTATCTGCA-1"	"A"
"GGGTGTCGTGCAAAGC-1"	"A"
"GGGTGTCGTTACGAAA-1"	"A"
"GGGTTATGTATCTGCA-1"	"G"
"GGGTTATTCACATTCT-1"	"A"
"GGTACCGTCCGAGGAA-1"	"G"
"GGTAGGAAGCTCCATA-1"	"A"
"GGTAGGAAGCTGATTC-1"	"G"
"GGTAGGAAGGATTAAC-1"	"G"
"GGTAGGACAAGCGAAC-1"	"A"
"GGTAGGACAGAGTCGA-1"	"A"
"GGTAGGATCCTCCATG-1"	"A"
"GGTAGGATCGGTGATT-1"	"A"
"GGTCATAAGGATGCCA-1"	"A"
"GGTCATACACGTTGTA-1"	"A"
"GGTCATACAGCGTACC-1"	"A"
"GGTCATATCAATCGTG-1"	"A"
"GGTCATATCCACGAGC-1"	"A"
"GGTCATATCGTGGTAT-1"	"A"
"GGTGAAGCATTGAACC-1"	"G"
"GGTGAAGTCACTGGTA-1"	"G"
"GGTGAAGTCTCCTTAA-1"	"A"
"GGTGCTGCAATGATGA-1"	"A"
"GGTGCTGCAGAACAGC-1"	"A"
"GGTGCTGCATAGACGG-1"	"A"
"GGTGCTGTCTACTTTG-1"	"A"
"GGTGTCGAGATATGAC-1"	"G"
"GGTGTCGAGGACTAGC-1"	"G"
"GGTGTCGGTCAGAAGC-1"	"G"
"GGTGTCGTCCACGAGC-1"	"G"
"GGTTGCGAGACGCCAA-1"	"G"
"GGTTGCGGTATTCTTC-1"	"G"
"GGTTGCGTCTTGCGCT-1"	"G"
"GTAATCGCAGCAGGTA-1"	"A"
"GTAATCGCAGTGGTCC-1"	"A"
"GTACTTTCAATCATCG-1"	"G"
"GTAGACTGTGGCATAG-1"	"A"
"GTAGACTTCGGCTATA-1"	"A"
"GTAGACTTCGTGGCGT-1"	"G"
"GTAGGAGAGTGGACGT-1"	"A"
"GTAGGAGCAATGTGCT-1"	"G"
"GTAGGAGCAGGTCCTG-1"	"G"
"GTAGGAGGTCTGGGAA-1"	"A"
"GTAGGAGGTGGATTCT-1"	"A"
"GTAGGAGTCATACTTC-1"	"G"
"GTAGTACAGGCAATTA-1"	"A"
"GTAGTACTCCATCTAT-1"	"A"
"GTCACAAGTCTAACCA-1"	"A"
"GTCACCTGTGGATTTC-1"	"A"
"GTCACCTTCGGGTCCA-1"	"A"
"GTCACCTTCGTGTGCG-1"	"G"
"GTCACGGAGAGGCAGG-1"	"A"
"GTCACGGCACCGAATT-1"	"G"
"GTCACGGGTAGCTGTT-1"	"A"
"GTCACGGGTATCCTTT-1"	"A"
"GTCACGGGTCGTAGTT-1"	"A"
"GTCACGGTCAATGCAC-1"	"G"
"GTCACGGTCCAAGAGG-1"	"A"
"GTCACTCGTGCTTCCT-1"	"A"
"GTCACTCTCCGTGCAG-1"	"G"
"GTCACTCTCGTCTAGA-1"	"G"
"GTCGTAAAGAGAAGCA-1"	"G"
"GTCGTAAAGGCGACTA-1"	"G"
"GTCGTAAAGGCTCAGA-1"	"A"
"GTCGTAACACAGAAGC-1"	"G"
"GTCTACCCATAGCCGC-1"	"A"
"GTCTACCGTATGGTTC-1"	"A"
"GTCTACCGTTTGAAGA-1"	"G"
"GTGATCATCGACGGAA-1"	"A"
"GTGCACGGTCGACTGC-1"	"G"
"GTGCCAGCAGCTATAC-1"	"A"
"GTGCCAGGTATCTAGC-1"	"A"
"GTGCCAGGTTGCCTGG-1"	"G"
"GTGCCAGTCCACCTAC-1"	"A"
"GTGCCAGTCCGAATTG-1"	"A"
"GTGCTGGAGCACCATT-1"	"A"
"GTGCTGGAGCATTGGG-1"	"A"
"GTGCTGGAGTGAAGGA-1"	"A"
"GTGCTGGGTAACCATC-1"	"G"
"GTGCTGGGTCATAGAA-1"	"A"
"GTGCTGGTCTCCTTAA-1"	"G"
"GTGGATTAGGCAAGCT-1"	"A"
"GTGGATTAGTATGGGC-1"	"A"
"GTGGATTCAACACGGA-1"	"A"
"GTGGATTCACACTAGT-1"	"A"
"GTGGCGTCAACTGCGC-1"	"A"
"GTGGCGTCAATGTAAG-1"	"A"
"GTGGCGTTCAGAGTGG-1"	"A"
"GTGGCGTTCCCGCAAG-1"	"A"
"GTGTCAACAAGTTCGT-1"	"A"
"GTGTCAATCGACTGGC-1"	"A"
"GTGTCCTGTCTGGGCT-1"	"G"
"GTGTCCTGTGCAGACA-1"	"A"
"GTGTCCTGTGCTGTCG-1"	"G"
"GTGTCCTGTTACGCTA-1"	"A"
"GTGTCCTTCTTGCGCT-1"	"A"
"GTGTGATAGAGGTACC-1"	"A"
"GTGTGATAGTCTGTGT-1"	"G"
"GTGTGATCAAAGAGAG-1"	"G"
"GTGTGATTCCATACCC-1"	"A"
"GTTACGAAGCGAGCTA-1"	"A"
"GTTACGAAGGGAAATG-1"	"A"
"GTTACTTAGATTCCGT-1"	"A"
"GTTCAAGAGTAGTTCC-1"	"G"
"GTTCAAGCATCGCTAA-1"	"A"
"GTTCAAGGTATCTCAG-1"	"A"
"GTTGGGCAGTAACACA-1"	"G"
"GTTGGGCCAAGCCAGA-1"	"G"
"GTTGGGCGTTCCGGCA-1"	"A"
"GTTGGGCTCCTCATTA-1"	"A"
"GTTGGTAAGTACAACA-1"	"G"
"GTTGGTAAGTTACACC-1"	"G"
"GTTGGTACATGGTAAA-1"	"G"
"GTTGGTAGTGAATACA-1"	"A"
"GTTGGTATCATTGCCC-1"	"G"
"TAAACCGAGCCATCAT-1"	"A"
"TAAACCGAGCGTGTTT-1"	"G"
"TAAACCGAGGAGTCTG-1"	"A"
"TAACAGCCACATATCG-1"	"A"
"TAACAGCGTCGATAGG-1"	"G"
"TAACTTCTCGACTCGG-1"	"G"
"TAAGCCACAATTCTCT-1"	"G"
"TAAGCCACATTTGGTG-1"	"A"
"TAAGCCAGTATTCACG-1"	"A"
"TAAGCCAGTGCTAGTT-1"	"G"
"TAAGCCATCAGCACTA-1"	"G"
"TAAGTGCAGATAGGTT-1"	"A"
"TAAGTGCAGATGCGCA-1"	"A"
"TAAGTGCAGTACTCTG-1"	"A"
"TAAGTGCAGTTTGGAA-1"	"G"
"TAAGTGCGTGCCGGTT-1"	"A"
"TAATCGGCACTGCTTC-1"	"G"
"TAATCGGCAGCGTGAA-1"	"G"
"TAATTCCAGTACGACG-1"	"G"
"TAATTCCAGTACGCGA-1"	"G"
"TAATTCCCAGTATACC-1"	"G"
"TAATTCCTCGGATAAA-1"	"A"
"TACAGCAAGAACCATA-1"	"A"
"TACAGCACAAGTCTCA-1"	"A"
"TACATGGCAATGTAAG-1"	"G"
"TACATGGCAGTATACC-1"	"G"
"TACATGGGTAAACCCT-1"	"A"
"TACATGGTCTACCCGT-1"	"A"
"TACATTCAGAGGCCTA-1"	"A"
"TACATTCAGTAACACA-1"	"G"
"TACATTCGTCTAAAGA-1"	"G"
"TACCCTGAGATAGGTT-1"	"A"
"TACCTATCAACAAACA-1"	"G"
"TACCTATTCCAGAATC-1"	"G"
"TACCTATTCTTGTCAT-1"	"A"
"TACCTCGCATAGCCGC-1"	"A"
"TACGCAACACACACAT-1"	"A"
"TACGCAACATTAGCCA-1"	"A"
"TACGCAATCACTCGGG-1"	"A"
"TACGCCTAGTCATCTG-1"	"G"
"TACGCCTGTGCCAAGA-1"	"G"
"TACGGATCAGCTGATT-1"	"G"
"TACGGATGTCACAGTT-1"	"A"
"TACGGATGTCCGGTAC-1"	"A"
"TACGGATTCAGTCACA-1"	"G"
"TACGGATTCCCACTTG-1"	"A"
"TACTAGGAGGCACCTC-1"	"G"
"TACTAGGTCGAGAACG-1"	"G"
"TACTCGCCACAGGAAC-1"	"A"
"TACTCGCCATTGATGC-1"	"A"
"TACTGCCAGCAGGAGG-1"	"G"
"TACTGCCCATACAACC-1"	"G"
"TACTGCCGTAACGGTG-1"	"G"
"TACTGCCTCATGAACC-1"	"G"
"TAGACTGCAAATTCCG-1"	"G"
"TAGACTGCAACAAACA-1"	"G"
"TAGACTGGTGACCAGA-1"	"G"
"TAGACTGGTTTAAGCC-1"	"A"
"TAGACTGTCATGTTCT-1"	"G"
"TAGACTGTCCATCTAT-1"	"G"
"TAGCACAGTCCTTATT-1"	"G"
"TAGCACAGTTAACTCG-1"	"G"
"TAGCACATCAGCACTA-1"	"G"
"TAGCACATCGAGGTCC-1"	"A"
"TAGCATGCAGGTAACG-1"	"G"
"TAGCATGCATGGGACA-1"	"A"
"TAGCATGCATGGTTTG-1"	"A"
"TAGCATGTCGTTTGAG-1"	"A"
"TAGCCCTGTCATAGCT-1"	"G"
"TAGCCCTGTGAATACA-1"	"A"
"TAGCCCTGTTTGCGAT-1"	"A"
"TAGCCCTTCACCCTTG-1"	"G"
"TAGCCCTTCTTAAGCG-1"	"A"
"TAGCCGGAGATATGAC-1"	"G"
"TAGCCGGAGTCGTATC-1"	"A"
"TAGCCGGCATTACCTT-1"	"G"
"TAGCCGGGTTTGATCG-1"	"G"
"TAGCCGGTCACAGGGA-1"	"A"
"TAGCGGCAGAGTTTGA-1"	"G"
"TAGCGGCGTCTCTGGG-1"	"A"
"TAGCGGCGTGTGACCC-1"	"G"
"TAGCTTTGTCACTCTC-1"	"G"
"TAGCTTTGTTAACCGT-1"	"A"
"TAGCTTTTCCTGGGAC-1"	"G"
"TAGCTTTTCGCACCGA-1"	"A"
"TAGCTTTTCGGTCTCT-1"	"A"
"TAGGAGGAGACCAATA-1"	"A"
"TAGGAGGTCCATTGTT-1"	"A"
"TAGGTCAAGGCCTCTG-1"	"G"
"TAGGTGTCAACGACAG-1"	"A"
"TAGGTGTCATTCTCGC-1"	"G"
"TAGGTGTGTACGGAGT-1"	"A"
"TAGGTGTGTCTGTCCT-1"	"G"
"TAGGTGTTCTTATCAC-1"	"G"
"TAGTCCCAGAATATCG-1"	"G"
"TAGTCCCGTAGAATAC-1"	"A"
"TATCGAGGTACTTCAG-1"	"G"
"TATCGAGTCGCAACTA-1"	"A"
"TATCTGTTCCAAACCA-1"	"A"
"TATGTGGCAACAACTC-1"	"G"
"TATGTGGCAGGGTAAC-1"	"A"
"TATGTTCAGCAGAGCT-1"	"G"
"TATGTTCCATAGGCGA-1"	"A"
"TATGTTCTCTGGTACA-1"	"A"
"TATTGCTAGAGTTCGG-1"	"G"
"TATTGCTTCAGTGGTT-1"	"A"
"TCAAAGCAGAAACGCC-1"	"A"
"TCAAAGCAGAATAGTC-1"	"G"
"TCAAAGCGTCGCGCTA-1"	"A"
"TCAAAGCGTTCATTTC-1"	"G"
"TCAAAGCTCCATACCC-1"	"A"
"TCAAGACGTGAGCTAG-1"	"G"
"TCAAGACGTTCTGATG-1"	"G"
"TCAAGACTCCATACCC-1"	"A"
"TCAAGACTCCCGCAAG-1"	"G"
"TCAAGACTCCTAAGTG-1"	"G"
"TCAAGACTCGATAGCT-1"	"G"
"TCAAGGTGTATTGTGC-1"	"G"
"TCAAGGTTCCACGAGC-1"	"G"
"TCACAAGAGGGAGATA-1"	"A"
"TCACAAGGTCATGAGG-1"	"G"
"TCACAAGGTTCCCGGA-1"	"A"
"TCACAGAAGGGTTCCC-1"	"A"
"TCACAGAGTTATAGAG-1"	"A"
"TCACCACAGAATATCG-1"	"A"
"TCACCACCAATTGGCT-1"	"G"
"TCACCTGTCCGCGATG-1"	"G"
"TCACTCGGTTGAATAG-1"	"A"
"TCAGCTCCATCTGCAA-1"	"G"
"TCAGCTCTCAGTCACA-1"	"G"
"TCAGCTCTCCCAGCAG-1"	"A"
"TCAGGGCCAACAAACA-1"	"G"
"TCAGGGCGTAGTATCC-1"	"A"
"TCAGGGCGTGGCCTCA-1"	"G"
"TCAGGGCTCGGATAAA-1"	"A"
"TCAGGTAAGAAGCCGT-1"	"A"
"TCAGGTAAGGAAGAAC-1"	"G"
"TCAGGTACAGGTTATC-1"	"A"
"TCAGTCCCATTAGCAC-1"	"G"
"TCAGTCCGTAACTCCA-1"	"A"
"TCAGTCCGTACGGAGT-1"	"A"
"TCAGTCCTCGACTATG-1"	"G"
"TCAGTTTGTCTCTGGG-1"	"A"
"TCAGTTTGTGATAGAT-1"	"G"
"TCAGTTTTCAATTGGC-1"	"A"
"TCAGTTTTCTACTGCC-1"	"A"
"TCCAGAAAGCGCAATG-1"	"G"
"TCCAGAACACTCCTCA-1"	"A"
"TCCAGAACATGGGACA-1"	"G"
"TCCAGAATCCAGGGAA-1"	"G"
"TCCATCGCAACTAGAA-1"	"A"
"TCCCACAGTCCGTGCA-1"	"G"
"TCCCACATCCCTACCA-1"	"A"
"TCCGACTCAATGGCAG-1"	"A"
"TCGAGCGTCGTTCCGT-1"	"G"
"TCGATTTGTATCCCTC-1"	"A"
"TCGATTTTCTTCTCTC-1"	"G"
"TCGCAGGCAATTAGGA-1"	"A"
"TCGCAGGCATAGAATG-1"	"A"
"TCGCAGGTCCATGACA-1"	"A"
"TCGCCTAAGGAGTCTG-1"	"A"
"TCGCCTATCCACACCT-1"	"G"
"TCGGGACCACTGCTTC-1"	"G"
"TCGGGACTCAAAGTAG-1"	"G"
"TCGGGACTCGAGAAGC-1"	"A"
"TCGGGACTCGATGCAT-1"	"G"
"TCGTTCGTCTGAGTCA-1"	"G"
"TCTAGTTCAGGATGTG-1"	"A"
"TCTAGTTGTAATGTAG-1"	"A"
"TCTAGTTGTCATAGCT-1"	"G"
"TCTATTGTCAAGAGAT-1"	"A"
"TCTATTGTCTCTTCTC-1"	"G"
"TCTCAGCGTCAGGTGA-1"	"G"
"TCTCAGCGTTCCGCGA-1"	"G"
"TCTCTGGCATAGATAG-1"	"A"
"TGAATCGAGCTAACAA-1"	"A"
"TGAATCGAGTCTCGAT-1"	"A"
"TGACAACAGGATCCTT-1"	"A"
"TGACAACCACATTCTT-1"	"G"
"TGACAACGTATCATGC-1"	"A"
"TGACAACGTGCTAGTT-1"	"A"
"TGACAACTCAATGCAC-1"	"A"
"TGACAACTCCGTTAGA-1"	"G"
"TGACTCCAGTGGGACT-1"	"G"
"TGACTCCCAAGCAATA-1"	"G"
"TGACTCCCAGTAACGG-1"	"A"
"TGACTCCGTAGCAGCA-1"	"G"
"TGACTCCTCCATTGAG-1"	"G"
"TGAGCCGAGAGCGGTT-1"	"A"
"TGAGTCAAGCCGCAAA-1"	"A"
"TGAGTCACAATCACTG-1"	"G"
"TGAGTCAGTCGCTAGC-1"	"A"
"TGAGTCAGTTCAGAAA-1"	"G"
"TGATCAGTCGGTTGTA-1"	"A"
"TGATGCACAACATAAG-1"	"G"
"TGATTTCAGTACCACT-1"	"A"
"TGATTTCTCCAACGCG-1"	"A"
"TGCACCTCACGCCGAT-1"	"A"
"TGCACCTCAGATTTGC-1"	"G"
"TGCACCTGTTCTGAGT-1"	"G"
"TGCATGAAGCGTTAGG-1"	"A"
"TGCATGAAGTGCTAGG-1"	"A"
"TGCATGATCTATTTCG-1"	"A"
"TGCATGATCTTCTCTC-1"	"A"
"TGCATTTAGGGCGAAG-1"	"A"
"TGCATTTCAAGGGTAC-1"	"A"
"TGCATTTGTCGTCGCA-1"	"A"
"TGCATTTTCCACGGCA-1"	"G"
"TGCCTCAAGTCCGATT-1"	"G"
"TGCCTCAGTGAGTAAT-1"	"G"
"TGCCTCATCTGGAAGG-1"	"G"
"TGCCTGTGTCCAAGTT-1"	"A"
"TGCCTGTTCTGACTTT-1"	"A"
"TGCGTAACATGCCCTT-1"	"G"
"TGCGTAAGTGTCCAGC-1"	"G"
"TGCGTAAGTTGGCGAA-1"	"A"
"TGCGTAATCCAGTACA-1"	"G"
"TGCGTAATCTCTATCA-1"	"G"
"TGCTATTAGCGAATAT-1"	"A"
"TGCTATTGTAGACGCA-1"	"G"
"TGCTATTTCGGAGTTT-1"	"G"
"TGCTCACCACCCATCT-1"	"A"
"TGCTCACTCGGTCCGA-1"	"G"
"TGCTCGTAGCTTACCA-1"	"A"
"TGCTCGTTCAGGAATA-1"	"A"
"TGCTCGTTCCTGGAAT-1"	"A"
"TGCTTCGAGTCGATAA-1"	"G"
"TGGAAGGAGTTCCCGG-1"	"G"
"TGGAAGGCATATTGGC-1"	"A"
"TGGAAGGGTAACCCAT-1"	"G"
"TGGACATAGGCAGATC-1"	"G"
"TGGACATAGTTATGAG-1"	"A"
"TGGACATGTGCCGGTT-1"	"A"
"TGGCAATGTACCAAGG-1"	"G"
"TGGCAATTCTAGCAGT-1"	"A"
"TGGCCTTAGGGTCCCT-1"	"G"
"TGGCCTTCAAAGGAAG-1"	"A"
"TGGCCTTCAGTATCTG-1"	"A"
"TGGCCTTCAGTCCTGG-1"	"A"
"TGGCCTTGTGCTGAAG-1"	"G"
"TGGCGCAAGAGGTCCA-1"	"A"
"TGGCGCACACACACAT-1"	"G"
"TGGCGCACAGGGAGTT-1"	"A"
"TGGGTGCGTAGCTGTT-1"	"A"
"TGGGTGCTCGCCCTTA-1"	"A"
"TGGGTTACATGGGACA-1"	"G"
"TGGGTTAGTAGGGTTG-1"	"G"
"TGGTCAACACATGATC-1"	"A"
"TGGTCAATCTTAATCC-1"	"G"
"TGGTCCTGTGTTGGTT-1"	"G"
"TGGTCCTGTTTCACCC-1"	"A"
"TGTAAGCGTTCTCGAA-1"	"G"
"TGTAAGCTCAAGGCCC-1"	"G"
"TGTACAGCAATTGTGC-1"	"A"
"TGTACAGTCAGGTCTA-1"	"G"
"TGTACAGTCGACTATG-1"	"G"
"TGTACGAAGTCTGCTA-1"	"G"
"TGTACGATCGATAGGG-1"	"A"
"TGTAGCAAGAAATGGG-1"	"G"
"TGTAGCAGTCCGTAGC-1"	"A"
"TGTGACAAGGATTTGA-1"	"G"
"TGTGACACACGATATC-1"	"G"
"TGTGACAGTCTAACCA-1"	"G"
"TGTGACATCAACTTGG-1"	"A"
"TGTGGCGAGAGTGGAA-1"	"G"
"TGTGTCCAGAAAGGGT-1"	"A"
"TGTGTCCAGACGACTG-1"	"G"
"TGTGTCCAGGCGATTG-1"	"A"
"TGTGTCCGTCTGGATT-1"	"A"
"TTACCCGAGCGGACTA-1"	"G"
"TTACCCGCAACAAACA-1"	"A"
"TTACCCGCATGGTAAA-1"	"G"
"TTACCGCCAGTAACTC-1"	"G"
"TTACCGCGTGCGCTCA-1"	"G"
"TTACGGACAGCAACCC-1"	"A"
"TTACGGACAGTCAGAG-1"	"A"
"TTACGGATCGCTTACC-1"	"G"
"TTACGGATCTGTCGGG-1"	"G"
"TTACGTTAGATAGGTT-1"	"A"
"TTACGTTAGCATGATA-1"	"G"
"TTACGTTGTCTGTGTA-1"	"A"
"TTACGTTTCAGGCCGT-1"	"A"
"TTACTCACAAAGCTGG-1"	"G"
"TTACTCACAATGACTC-1"	"G"
"TTACTTGAGGCTTCGC-1"	"A"
"TTACTTGCAATACTGC-1"	"A"
"TTAGCGACAAGGCTTT-1"	"A"
"TTAGCGATCGTGGAAG-1"	"A"
"TTAGCTTGTCCTCAGG-1"	"A"
"TTAGGTGAGCGAATAT-1"	"A"
"TTAGGTGCAAAGGCCA-1"	"A"
"TTATGTCCAGCAACGA-1"	"A"
"TTATGTCCATATAGAG-1"	"A"
"TTATGTCCATTTCACT-1"	"A"
"TTATGTCGTACCCATA-1"	"G"
"TTATGTCGTCGGCTGT-1"	"A"
"TTCAACTCAAGATTAG-1"	"A"
"TTCAACTCAAGCAGGT-1"	"A"
"TTCAACTCAGTTGCAT-1"	"A"
"TTCAACTGTAAGTGCG-1"	"A"
"TTCATCACACGATTAC-1"	"A"
"TTCATCAGTATTGTGC-1"	"A"
"TTCATCATCTTGTACT-1"	"G"
"TTCATTGAGTCACGCC-1"	"A"
"TTCATTGTCTGCGTCT-1"	"G"
"TTCGATTAGTGATATG-1"	"G"
"TTCGATTCAGCGTAGA-1"	"A"
"TTCGATTGTTCTTATC-1"	"A"
"TTCGCGTAGTCCCGCA-1"	"A"
"TTCGCGTGTACGTAGG-1"	"G"
"TTCGCGTTCTCGTAGA-1"	"A"
"TTCGGTCAGTTGAATG-1"	"A"
"TTCGGTCGTTTGTACG-1"	"G"
"TTCGGTCTCAGTGTGT-1"	"A"
"TTCGTTACAGGTGTGA-1"	"A"
"TTCGTTACATGCTATG-1"	"A"
"TTCGTTAGTCCGTGCA-1"	"G"
"TTCTAACCATTCTCGC-1"	"G"
"TTCTAACTCGCGATGC-1"	"A"
"TTCTGTAAGTCCTTCC-1"	"A"
"TTCTGTACATCATGTG-1"	"A"
"TTGACGAGTGCAGACA-1"	"A"
"TTGAGCACAACCTCTC-1"	"A"
"TTGAGCACACGATATC-1"	"A"
"TTGAGCACATGCGCTG-1"	"A"
"TTGAGCAGTCTCTGCT-1"	"A"
"TTGAGTGAGATATGTG-1"	"G"
"TTGAGTGCAATCATCG-1"	"G"
"TTGAGTGGTAAACCCT-1"	"A"
"TTGAGTGTCGATTACG-1"	"A"
"TTGCACCAGAAGCCTG-1"	"A"
"TTGCAGAAGACCGCAA-1"	"A"
"TTGCAGACACGACGAA-1"	"A"
"TTGCAGACATCAACTG-1"	"A"
"TTGCCCACAAACAGTA-1"	"A"
"TTGCCCACACTTATGG-1"	"A"
"TTGCCCATCGCAACTA-1"	"G"
"TTGCGAACAGCAACAG-1"	"A"
"TTGCGAACATGGGACA-1"	"A"
"TTGCGGGCAATCAGGG-1"	"G"
"TTGCGGGCAATTAGGA-1"	"G"
"TTGCGGGCAGTAACTC-1"	"G"
"TTGCGGGCATTTGGTG-1"	"A"
"TTGCTATAGATGTTCC-1"	"A"
"TTGCTATTCATTGCCC-1"	"G"
"TTGCTTATCGAAGCCC-1"	"A"
"TTGGTCCAGCGAGAAA-1"	"A"
"TTGGTCCAGTGTCCCG-1"	"A"
"TTGGTCCGTACGGAGT-1"	"G"
"TTGGTCCGTTAGTAGA-1"	"A"
"TTGGTCCTCAATTGGC-1"	"G"
"TTGGTCCTCTCGACAA-1"	"A"
"TTGTCTAAGCACGTAG-1"	"A"
"TTGTCTACAACGCACC-1"	"A"
"TTGTCTACAAGCCAGA-1"	"G"
"TTGTCTAGTGATTCCA-1"	"A"
"TTGTCTAGTGTCCTTC-1"	"G"
"TTGTCTATCTTACGGA-1"	"A"
"TTGTTCAAGTAGACCG-1"	"A"
"TTGTTCACACATATCG-1"	"A"
"TTGTTCAGTCCTCAGG-1"	"G"
"TTGTTGTCAAGCTTTG-1"	"G"
"TTGTTGTCATGGCCCA-1"	"G"
"TTGTTGTCATTGCGAT-1"	"G"
"TTTACGTAGAACGTCG-1"	"A"
"TTTACGTAGCTATCGT-1"	"G"
"TTTACGTGTCGGCTGT-1"	"G"
"TTTGAGGTCGCACAAT-1"	"G"
"TTTGAGGTCTCGACAA-1"	"G"
"TTTGCGCGTACCCACG-1"	"A"
"TTTGCGCTCCATCATT-1"	"A"
"TTTGCGCTCGATAGCT-1"	"A"
"TTTGGCCAGATATGAC-1"	"G"
"TTTGGCCAGGAAGAAC-1"	"G"
"TTTGGCCCAGAAAGAG-1"	"A"
"TTTGGTTCACCACAGC-1"	"A"
"TTTGGTTGTAACTCCA-1"	"A"
"TTTGGTTGTCAGTGTT-1"	"G"
"TTTGGTTTCGTCAACA-1"	"A"
"TTTGTGTCAAATAGTG-1"	"A"
"TTTGTGTCAACGGACA-1"	"A"
"TTTGTGTCAATGACTC-1"	"A"
"TTTGTGTCAGGGTAAC-1"	"A"
"TTTGTGTCATGCTATG-1"	"A"
