"AAACGAAAGAGTCCGA-1"	"A"
"AAACGAACAATGGTCT-1"	"A"
"AAACGAACAGGTGTGA-1"	"A"
"AAACGAAGTCATAAGA-1"	"A"
"AAACGAATCCCACTAC-1"	"A"
"AAACGAATCGTGAGTT-1"	"G"
"AAACGAATCTGTCGGG-1"	"A"
"AAACTCGAGCGTGTTT-1"	"A"
"AAACTCGAGGGAGTTC-1"	"G"
"AAACTCGAGTAATCAG-1"	"A"
"AAACTCGAGTGATTAG-1"	"A"
"AAACTCGCAGTGGTCC-1"	"G"
"AAACTCGCATTTAGGC-1"	"G"
"AAACTCGGTAAACCCT-1"	"A"
"AAACTCGTCTATGAGC-1"	"A"
"AAACTGCCAGACTAAA-1"	"A"
"AAACTGCCATGGCCTG-1"	"A"
"AAACTGCTCGTGGCGT-1"	"G"
"AAAGATGAGGATATCA-1"	"G"
"AAAGATGCAAGGACCA-1"	"G"
"AAAGATGCACACTAGT-1"	"A"
"AAAGATGGTCCGAGCT-1"	"G"
"AAAGATGTCCCTACGT-1"	"G"
"AAAGATGTCTTATCAC-1"	"G"
"AAAGGATCAATGGTCT-1"	"A"
"AAAGGATCAGCACATT-1"	"A"
"AAAGGATTCCAACAAC-1"	"G"
"AAAGGATTCCGGCTGA-1"	"A"
"AAAGGATTCTCATCCG-1"	"A"
"AAAGGGCAGGTCGGTA-1"	"A"
"AAAGGGCCAGAGTCGA-1"	"G"
"AAAGGGCTCACTCCCA-1"	"G"
"AAATGAGGTATGGATA-1"	"A"
"AAATGAGGTGGAAGCT-1"	"A"
"AAATGAGGTTACCACA-1"	"A"
"AAATGAGTCCATACCC-1"	"A"
"AAATGAGTCTCTTAAC-1"	"G"
"AAATGCCCACGGCCAT-1"	"G"
"AAATGCCCACTTTGGA-1"	"A"
"AAATGCCTCAGTGTAC-1"	"G"
"AAATGCCTCGATGAAA-1"	"A"
"AACAAAGAGGTTTCTG-1"	"A"
"AACAAAGCAATTCTCT-1"	"G"
"AACAAAGCACCCATCT-1"	"G"
"AACAAAGCACGATATC-1"	"G"
"AACAAAGCACTAGCCG-1"	"G"
"AACAAAGGTAGCAGCA-1"	"A"
"AACAAAGGTCTGGGCT-1"	"A"
"AACAAAGGTGGCATAG-1"	"G"
"AACAAAGTCCGGCTGA-1"	"G"
"AACAGTCAGGTCGTTT-1"	"G"
"AACAGTCAGTTGAATG-1"	"G"
"AACAGTCCAAGTCCTA-1"	"G"
"AACAGTCCAGGTGTGA-1"	"G"
"AACAGTCCATTGTGAC-1"	"A"
"AACAGTCGTGATTCCA-1"	"A"
"AACAGTCTCGCCACTT-1"	"A"
"AACATCGCACCTCGTT-1"	"A"
"AACATCGGTTTGCCAA-1"	"G"
"AACATCGTCGGTCAGC-1"	"A"
"AACCAACAGAGAACCC-1"	"G"
"AACCAACCAATCATCG-1"	"A"
"AACCAACGTAAGTGCG-1"	"G"
"AACCGATAGTCTCTAG-1"	"A"
"AACCGATCAATCAGGG-1"	"A"
"AACCGATGTCACAGTT-1"	"G"
"AACCGATGTTTCTTAC-1"	"A"
"AACCGATTCGCGCTGA-1"	"G"
"AACCTGAAGCCGCAAA-1"	"A"
"AACCTGAAGTTCAACC-1"	"A"
"AACCTGACAAGTTCGT-1"	"A"
"AACCTGAGTAGAAAGG-1"	"A"
"AACCTGAGTCCGCTTT-1"	"G"
"AACCTGATCTCGACAA-1"	"A"
"AACCTTTAGGGAAGCG-1"	"A"
"AACCTTTAGTGATCTC-1"	"G"
"AACCTTTCAAGTGGCA-1"	"G"
"AACCTTTCACGTACAT-1"	"G"
"AACGAGGAGAACCCGA-1"	"G"
"AACGAGGAGCGTTGCC-1"	"A"
"AACGAGGAGTAGAAGG-1"	"A"
"AACGAGGCAACAAACA-1"	"A"
"AACGAGGGTGAGTAAT-1"	"A"
"AACGAGGGTTATAGAG-1"	"G"
"AACGAGGGTTCAGTTG-1"	"A"
"AACGAGGGTTCCCGGA-1"	"G"
"AACGAGGGTTCTGAAC-1"	"G"
"AACGAGGGTTGCTTGA-1"	"A"
"AACGAGGTCGGGCTCA-1"	"G"
"AACGGGACACGCTAAT-1"	"A"
"AACGGGAGTCCTTATT-1"	"A"
"AACGGGATCGAACCGC-1"	"A"
"AACGTACCACTGAAGG-1"	"A"
"AACGTACCAGGATAGC-1"	"G"
"AACGTACGTACGTAAA-1"	"A"
"AACGTACGTATCGCGC-1"	"A"
"AACGTACGTGTCCCAG-1"	"G"
"AACGTACTCGTTTGAG-1"	"G"
"AACTGGTAGAAGACTT-1"	"G"
"AACTGGTGTAGCTGTT-1"	"G"
"AACTGGTGTTTCCGGG-1"	"G"
"AACTGGTTCGATATGC-1"	"A"
"AACTGGTTCGTCCCAT-1"	"A"
"AACTGTGAGCACGTAG-1"	"G"
"AACTGTGAGGTTGTGG-1"	"G"
"AACTGTGGTGAGGTCA-1"	"A"
"AACTGTGGTGTTGGTT-1"	"A"
"AACTGTGTCTAGTCGA-1"	"A"
"AACTGTGTCTTCCGTG-1"	"A"
"AACTTGGAGATCGAGC-1"	"G"
"AACTTGGAGTTTGGAA-1"	"A"
"AACTTGGCATCGTGAT-1"	"A"
"AACTTGGTCGCACCTT-1"	"G"
"AAGATAGAGTTGCGCC-1"	"A"
"AAGATAGCACTAAACC-1"	"A"
"AAGATAGCATAGTCCA-1"	"G"
"AAGATAGGTTACCACA-1"	"A"
"AAGATAGGTTGTGAGG-1"	"G"
"AAGGAGCAGAGCGAAA-1"	"G"
"AAGGAGCCAAGGGAGG-1"	"G"
"AAGGAGCCAGTTGCAT-1"	"A"
"AAGGAGCGTAGGGTCA-1"	"A"
"AAGGAGCGTCCAAGAG-1"	"A"
"AAGGAGCGTGAAACAT-1"	"A"
"AAGGTTCAGGAAACTT-1"	"G"
"AAGGTTCAGGGAGTTC-1"	"A"
"AAGGTTCTCCTTGACC-1"	"A"
"AATACGCAGCAATAAC-1"	"G"
"AATACGCAGTCCGTGC-1"	"A"
"AATACGCCATTTCTTG-1"	"A"
"AATACGCGTGCAAAGC-1"	"A"
"AATGCCAAGGATCCTT-1"	"G"
"AATGCCACAACACGGA-1"	"A"
"AATGCCAGTGCTTGAT-1"	"A"
"AATGCCAGTTCAGAAA-1"	"A"
"AATGCCAGTTGAATAG-1"	"A"
"AATGGAACAATGATGA-1"	"A"
"AATGGAACATCGTGAT-1"	"A"
"AATGGAAGTCCGCTTT-1"	"A"
"AATGGCTAGCCTTTGA-1"	"G"
"AATGGCTAGTTAGAGT-1"	"G"
"AATGGCTAGTTTACGC-1"	"A"
"AATGGCTCAGACCTGC-1"	"A"
"AATGGCTCAGATTTGC-1"	"A"
"AATGGCTGTACCGGCT-1"	"G"
"AATGTCGAGATGAGGA-1"	"A"
"AATGTCGCATTGAACC-1"	"G"
"AATGTCGGTGATCAGG-1"	"G"
"AATGTCGGTTCTCGAA-1"	"A"
"AATGTCGTCTTCGTTA-1"	"G"
"ACAAACCAGCTGCCAC-1"	"A"
"ACAAACCCAATGCACT-1"	"A"
"ACAAACCCACACATGT-1"	"G"
"ACAAACCCAGGTAGGT-1"	"G"
"ACAAACCCATCGAGTT-1"	"G"
"ACAAACCTCTTCTTCC-1"	"A"
"ACAAAGAAGAGGAATG-1"	"A"
"ACAAAGAAGGAGGCGA-1"	"A"
"ACAAAGACACACACCG-1"	"A"
"ACAAAGATCGCGTGAC-1"	"A"
"ACAAAGATCGCTAGTA-1"	"G"
"ACAAGCTAGAATCAAC-1"	"G"
"ACAAGCTAGCAGAGCT-1"	"A"
"ACAAGCTAGTTGTCCA-1"	"G"
"ACAAGCTCATAGCAGG-1"	"G"
"ACAAGCTCATCGCTAA-1"	"A"
"ACAAGCTTCAATCGTG-1"	"A"
"ACAATCGAGACCATAA-1"	"G"
"ACAATCGCATCCGTAA-1"	"A"
"ACAATCGGTAACATAG-1"	"G"
"ACAATCGTCCATTGAG-1"	"G"
"ACAGAAAAGTCAACTC-1"	"G"
"ACAGAAAAGTTTGGAA-1"	"G"
"ACAGAAACACTGCTTC-1"	"A"
"ACAGAAAGTGTTTCTT-1"	"A"
"ACAGAAAGTTGAAGCG-1"	"A"
"ACAGAAATCAGAATGA-1"	"A"
"ACAGACTAGTAGTCGG-1"	"A"
"ACAGACTGTATGGTTC-1"	"A"
"ACAGACTGTCTGGTCG-1"	"G"
"ACAGACTTCAAGGCCC-1"	"A"
"ACAGCGCAGGAAGGTA-1"	"A"
"ACAGCGCAGTCTTAGC-1"	"A"
"ACAGCGCCAGTCCTGG-1"	"A"
"ACAGCGCGTTCCCTTG-1"	"A"
"ACAGCGCTCAGTCTTT-1"	"G"
"ACAGGCCGTATTCACG-1"	"G"
"ACAGGCCTCCGCGATG-1"	"G"
"ACAGGCCTCGTTCAGA-1"	"G"
"ACAGGCCTCTTTATCG-1"	"G"
"ACATGCAAGAATATCG-1"	"G"
"ACATGCAAGTAGTTCC-1"	"A"
"ACATGCAAGTGCTAGG-1"	"A"
"ACATGCACACGCTAAT-1"	"A"
"ACATGCACAGTAGGCA-1"	"G"
"ACATGCATCAGGATCT-1"	"A"
"ACATGCATCAGTCTTT-1"	"A"
"ACATGCATCCTATCAT-1"	"A"
"ACATGGTAGACTAATG-1"	"A"
"ACATGGTAGTCCGATT-1"	"A"
"ACATGGTAGTTCGACT-1"	"A"
"ACATGGTCACCGAATT-1"	"G"
"ACATGGTGTTCCCTTG-1"	"A"
"ACATGGTTCAATCGTG-1"	"G"
"ACCAAACAGAGATTAC-1"	"A"
"ACCAAACAGGACTAGC-1"	"G"
"ACCAAACAGTTGCCGC-1"	"A"
"ACCAAACCATTTGGTG-1"	"A"
"ACCAAACGTCCTCAGG-1"	"G"
"ACCAAACGTGGTAAGC-1"	"A"
"ACCATCCGTACCCATA-1"	"G"
"ACCATCCGTCTGCACG-1"	"G"
"ACCATCCGTCTGTCCT-1"	"G"
"ACCATCCGTTCCGCGA-1"	"G"
"ACCCAAAAGGTCGGTA-1"	"A"
"ACCCAAAAGTCCGTGC-1"	"A"
"ACCCAAACAAACGTTC-1"	"A"
"ACCCAAACAGTCCTGG-1"	"G"
"ACCCAAAGTCGACTGC-1"	"A"
"ACCCAAATCCTTTGAT-1"	"G"
"ACCGAATAGCTGCCAC-1"	"G"
"ACCGAATGTAATGTGA-1"	"A"
"ACCGAATTCACTGGTA-1"	"A"
"ACCGCAGAGTTCAACC-1"	"A"
"ACCGCAGCAAGTTGCT-1"	"A"
"ACCGCAGCAATGCACT-1"	"G"
"ACCGCAGCAGTAACCT-1"	"A"
"ACCGCAGCAGTCCTGG-1"	"A"
"ACCGCAGCATTGTGAC-1"	"G"
"ACCGCAGGTCACAGTT-1"	"G"
"ACCGCAGGTTACGCTA-1"	"G"
"ACCGGGTAGGACCGAT-1"	"G"
"ACCGGGTAGTGGTGTG-1"	"G"
"ACCGGGTCAGAGCCAA-1"	"A"
"ACCTGCTCAACTCGAT-1"	"A"
"ACCTGCTCAGTCCTGG-1"	"A"
"ACCTGCTTCCCAATGA-1"	"A"
"ACCTGCTTCGTGAGTT-1"	"G"
"ACGGATTCATGTGGGA-1"	"G"
"ACGGATTGTACAAGCG-1"	"A"
"ACGGATTGTAGGTAAT-1"	"G"
"ACGGATTGTCCGTCGA-1"	"G"
"ACGGATTGTTAGTAGA-1"	"G"
"ACGTGGCCAATGGTCT-1"	"G"
"ACGTGGCTCCCTACGT-1"	"A"
"ACGTGGCTCGAGGTAG-1"	"G"
"ACGTGGCTCTTAAGCG-1"	"A"
"ACGTTAGAGAGTGGAA-1"	"G"
"ACGTTAGAGGAAGACA-1"	"A"
"ACGTTAGAGGGCGAAG-1"	"G"
"ACGTTAGCAGAACAGC-1"	"A"
"ACGTTAGTCCAGGGAA-1"	"G"
"ACGTTAGTCCGGACTG-1"	"G"
"ACGTTAGTCCTGTAGA-1"	"A"
"ACTAACGAGCCTATAC-1"	"G"
"ACTAACGAGGTTCTCA-1"	"G"
"ACTAACGCAAGAAACT-1"	"G"
"ACTAACGCAAGGACCA-1"	"G"
"ACTAACGCACGATTAC-1"	"G"
"ACTAACGCATCGAGTT-1"	"A"
"ACTAACGTCGCTTGAA-1"	"A"
"ACTACCCAGCTGCCAC-1"	"G"
"ACTACCCAGTATAGTG-1"	"G"
"ACTACCCCAGGTGTGA-1"	"A"
"ACTACCCGTTCCGCGA-1"	"G"
"ACTACCCTCCCGCAAG-1"	"G"
"ACTACCCTCCCGTATC-1"	"A"
"ACTACCCTCGCTATTT-1"	"G"
"ACTACGAAGGAGGCGA-1"	"A"
"ACTACGAAGGATGCCA-1"	"A"
"ACTACGACAACATAAG-1"	"A"
"ACTACGACATTCACGA-1"	"A"
"ACTACGAGTAACTGAA-1"	"A"
"ACTACGAGTGGTAAGC-1"	"A"
"ACTACGAGTTGCTTGA-1"	"G"
"ACTACGAGTTTCGATG-1"	"A"
"ACTAGGTAGCAATGTA-1"	"A"
"ACTAGGTAGGTTGTTC-1"	"G"
"ACTAGGTAGTAGCAAT-1"	"G"
"ACTAGGTAGTGAGCAC-1"	"A"
"ACTAGGTCACAAGGGT-1"	"G"
"ACTAGGTGTAAACCCT-1"	"G"
"ACTAGGTGTATCCTTT-1"	"G"
"ACTAGGTTCACTCCCA-1"	"G"
"ACTAGGTTCGCTAGTA-1"	"A"
"ACTAGGTTCTGACATG-1"	"G"
"ACTATTCAGATGGCAC-1"	"G"
"ACTATTCAGTCCGATT-1"	"G"
"ACTATTCAGTCTTAGC-1"	"A"
"ACTATTCGTTATCGAC-1"	"G"
"ACTATTCGTTGTCGGC-1"	"A"
"ACTCGGGAGCCAGAAC-1"	"A"
"ACTCGGGCACGTACAT-1"	"A"
"ACTCGGGCATAAAGTG-1"	"G"
"ACTCGGGGTGGCGCTT-1"	"A"
"ACTCGGGTCTGTGTCC-1"	"A"
"ACTGCAAAGTGTGTAA-1"	"A"
"ACTGCAACAAGACTAA-1"	"G"
"ACTGCAACACACACAT-1"	"A"
"ACTGCAAGTAACAATG-1"	"A"
"ACTGCAAGTCACAGTT-1"	"A"
"ACTGCGGAGAGCTGTG-1"	"A"
"ACTGCGGAGGGAAATG-1"	"A"
"ACTGCGGCACCATTCC-1"	"A"
"ACTGCGGGTGAATCGG-1"	"G"
"ACTGTCCAGAGCTCCC-1"	"G"
"ACTGTCCAGCACACCC-1"	"G"
"ACTGTCCAGTGAAGGA-1"	"A"
"ACTGTCCCAGGCAGAT-1"	"A"
"ACTGTCCCATCGTACA-1"	"A"
"ACTGTCCGTGCACATT-1"	"G"
"ACTGTCCTCCCTAAAG-1"	"G"
"ACTGTCCTCGTGAACT-1"	"A"
"ACTTCCGAGAGAGTTT-1"	"A"
"ACTTCCGAGGTTCTCA-1"	"A"
"ACTTCCGCATCAGAAA-1"	"A"
"ACTTCCGTCCAGAATC-1"	"G"
"ACTTTCAGTCACAGGA-1"	"G"
"ACTTTCATCAGGATCT-1"	"A"
"ACTTTCATCATCGCAA-1"	"A"
"AGACAAACACAGTAGG-1"	"A"
"AGACAAACACGATATC-1"	"G"
"AGACAAAGTTTGCCAA-1"	"A"
"AGATAGAAGCTCCGGT-1"	"A"
"AGATAGAAGTACCTCA-1"	"A"
"AGATAGAAGTGTAATG-1"	"A"
"AGATAGACACGCTGTG-1"	"A"
"AGATAGAGTACTAGAA-1"	"G"
"AGATAGAGTGCACCCA-1"	"A"
"AGATAGAGTTTCACCC-1"	"A"
"AGATAGATCTGAAAGA-1"	"A"
"AGATTCGAGACCCTAT-1"	"A"
"AGATTCGAGGTTCGTT-1"	"A"
"AGATTCGCATGGGTGA-1"	"G"
"AGATTCGGTGTGACCC-1"	"G"
"AGATTCGGTTCTGATG-1"	"A"
"AGATTCGTCAAACCCA-1"	"G"
"AGCCAGCAGAGTTTGA-1"	"A"
"AGCCAGCAGTAGGAAG-1"	"A"
"AGCCAGCGTTCCGGCA-1"	"G"
"AGCCAGCTCGAGCGCT-1"	"A"
"AGCCAGCTCTTCACTA-1"	"A"
"AGCCCGACACGCGACT-1"	"A"
"AGCCCGAGTGAGTCGA-1"	"G"
"AGCCCGAGTTCTTTCA-1"	"A"
"AGCCCGATCTATCCTA-1"	"A"
"AGCCGCAAGCAATGTA-1"	"G"
"AGCCGCAAGGAAGAAC-1"	"A"
"AGCCGCAAGGAAGACA-1"	"A"
"AGCCGCAAGTGCTCGC-1"	"A"
"AGCCGCAGTTGTCGGC-1"	"A"
"AGCCGCATCGAACACT-1"	"G"
"AGCCTCTAGCCTTTGA-1"	"A"
"AGCCTCTCACGCCGAT-1"	"A"
"AGCCTCTCAGGTAACG-1"	"G"
"AGCCTCTGTAGCGGTA-1"	"A"
"AGCCTCTGTTGTCGGC-1"	"A"
"AGCCTCTTCATCGCTC-1"	"G"
"AGCCTTCAGATGCGCA-1"	"A"
"AGCCTTCAGCGTTGCC-1"	"A"
"AGCCTTCAGTGAACCG-1"	"G"
"AGCCTTCCACTCCACT-1"	"A"
"AGCCTTCTCCTGGAAT-1"	"A"
"AGCCTTCTCTTGTACT-1"	"G"
"AGCGATTCAAGGCGTA-1"	"G"
"AGCGATTCAAGGTTCT-1"	"A"
"AGCGATTGTTTGACCA-1"	"G"
"AGCGATTTCCCGCAAG-1"	"A"
"AGCGATTTCTATCTAC-1"	"G"
"AGCGATTTCTTCAGAG-1"	"A"
"AGCGTATAGACCCTAT-1"	"A"
"AGCGTATTCTGGAAGG-1"	"A"
"AGCGTGCAGTCACGCC-1"	"A"
"AGCGTGCCAAAGGAAG-1"	"A"
"AGCGTGCCAATTAGGA-1"	"G"
"AGCGTGCCATCGCTAA-1"	"A"
"AGCGTGCTCACTGATG-1"	"G"
"AGCTATGAGGCTTAAA-1"	"A"
"AGCTATGAGTTCGACT-1"	"A"
"AGCTATGCAGAAGTGC-1"	"G"
"AGCTATGGTACTATGC-1"	"A"
"AGCTATGGTTCTGAAC-1"	"G"
"AGCTGATAGAACGTCG-1"	"A"
"AGCTGATAGTGAAGGA-1"	"G"
"AGCTGATCAAATTCCG-1"	"A"
"AGCTGATGTTAACCGT-1"	"A"
"AGCTGATTCTCTTCTC-1"	"A"
"AGCTGGCAGCCAGAAC-1"	"G"
"AGCTGGCAGCTCCGGT-1"	"A"
"AGCTGGCTCCTCTCTT-1"	"A"
"AGCTGGCTCTTACTCA-1"	"G"
"AGCTGTAAGGGACGTT-1"	"G"
"AGCTGTACAAGCAACG-1"	"G"
"AGCTGTACACCTATTT-1"	"A"
"AGCTGTACACTTACAG-1"	"G"
"AGCTGTACATCTCTCG-1"	"G"
"AGCTGTACATGCACTA-1"	"A"
"AGCTGTACATTCACCC-1"	"A"
"AGGACGAAGAAATTCG-1"	"G"
"AGGACGAAGGTCTTTG-1"	"A"
"AGGACGACAATGGTCT-1"	"G"
"AGGACGAGTCACCCGA-1"	"A"
"AGGACGATCCCTACGT-1"	"G"
"AGGACGATCTATCTTG-1"	"G"
"AGGCCCAAGAAGCCGT-1"	"A"
"AGGCCCACATTCGTCC-1"	"A"
"AGGCCCAGTACGTAGG-1"	"A"
"AGGCCTGCAAGTTGCT-1"	"A"
"AGGCCTGCACGCGATC-1"	"A"
"AGGCCTGGTACGGATG-1"	"A"
"AGGCCTGTCCTAAAGC-1"	"A"
"AGGCCTGTCGCAACTA-1"	"A"
"AGGCGAAAGAGGTGGG-1"	"G"
"AGGCGAAAGTGATATG-1"	"G"
"AGGCGTCAGAAGAGTG-1"	"G"
"AGGCGTCAGAGGCGGA-1"	"A"
"AGGCGTCCATAGACGG-1"	"A"
"AGGCGTCGTAGTTTGC-1"	"A"
"AGGCGTCGTATGGGTG-1"	"A"
"AGGCGTCGTTCTTTGT-1"	"G"
"AGGCGTCTCCCAGTAA-1"	"G"
"AGGCGTCTCTTGCGCT-1"	"A"
"AGTCAACAGAACCCGA-1"	"A"
"AGTCAACCACGAACGA-1"	"A"
"AGTCAACGTTAACCAC-1"	"A"
"AGTCAACTCTTATCAC-1"	"A"
"AGTCCGGTCAGGTTTG-1"	"G"
"AGTCCGGTCAGTTGAC-1"	"A"
"AGTGCCGAGACTTGAA-1"	"A"
"AGTGCCGAGCAGGACT-1"	"G"
"AGTGCCGGTTGGGAAC-1"	"A"
"AGTGCCGTCTTACTCA-1"	"A"
"AGTGCGCAGGTGATGC-1"	"A"
"AGTGCGCCAGATTTGC-1"	"G"
"AGTGCGCCAGTATACC-1"	"G"
"AGTGCGCCATCGTGAT-1"	"G"
"AGTGCGCGTCATAGCT-1"	"A"
"AGTGTACAGACAGCTG-1"	"G"
"AGTGTACCAATGCCAT-1"	"G"
"AGTGTACGTGTAGGAC-1"	"A"
"AGTTACGCAAGAAACT-1"	"A"
"AGTTACGCAATACTGC-1"	"G"
"AGTTACGCACCTGAAT-1"	"G"
"AGTTACGCAGCGTAGA-1"	"A"
"AGTTACGGTTACTACG-1"	"A"
"AGTTACGGTTGAATAG-1"	"A"
"AGTTTGGAGATATGAC-1"	"G"
"AGTTTGGCATAAAGTG-1"	"A"
"AGTTTGGGTACAAATG-1"	"A"
"AGTTTGGGTACGGAGT-1"	"A"
"AGTTTGGTCGATAGGG-1"	"G"
"ATAGGCTAGAGTGGAA-1"	"G"
"ATAGGCTAGTAGTGTA-1"	"A"
"ATAGGCTGTGTCGTCG-1"	"A"
"ATAGGCTTCCACGGCA-1"	"A"
"ATAGTCGAGAGCACTG-1"	"G"
"ATAGTCGAGGCTAAAT-1"	"G"
"ATAGTCGGTCGCTAGC-1"	"A"
"ATAGTCGTCAATCGTG-1"	"G"
"ATAGTCGTCCCTACGT-1"	"G"
"ATATTCCAGTGGGACT-1"	"A"
"ATATTCCCACGTTAGT-1"	"A"
"ATATTCCCATTACACG-1"	"A"
"ATCCAGAAGGGATCCA-1"	"G"
"ATCCAGAAGTACCTCA-1"	"A"
"ATCCAGAGTATTCGAC-1"	"A"
"ATCCAGAGTCAGAAAT-1"	"A"
"ATCCCTGAGGGAGTTC-1"	"A"
"ATCCCTGCACACTAGT-1"	"G"
"ATCCCTGCATAGAATG-1"	"A"
"ATCCCTGCATGCCTTC-1"	"A"
"ATCCCTGGTGATAAGT-1"	"G"
"ATCCTCGAGACTCGGA-1"	"A"
"ATCCTCGAGTCTCGAT-1"	"G"
"ATCCTCGTCGCTATTT-1"	"G"
"ATCCTGCAGATGAGGA-1"	"G"
"ATCCTGCAGGGCATTG-1"	"G"
"ATCCTGCCAAAGAGAG-1"	"G"
"ATCCTGCGTACTAGAA-1"	"G"
"ATCCTGCGTCCGGTAC-1"	"A"
"ATCCTGCTCTGGCACG-1"	"A"
"ATCGAGTAGACCGCAA-1"	"A"
"ATCGAGTAGTACAGTA-1"	"G"
"ATCGAGTCATCCCTCA-1"	"G"
"ATCGAGTGTGAATACA-1"	"A"
"ATCGAGTTCGCTAGTA-1"	"A"
"ATCGAGTTCTGTGTGA-1"	"G"
"ATGCATGAGACCCATT-1"	"A"
"ATGCATGAGCTTACCA-1"	"A"
"ATGCATGAGGATTTGA-1"	"A"
"ATGCATGGTCCAAGAG-1"	"G"
"ATGCATGGTGTGACCC-1"	"A"
"ATGCATGGTTACGGAG-1"	"G"
"ATGCATGGTTTCTCTA-1"	"A"
"ATGCATGTCTCGCGTT-1"	"G"
"ATGGATCAGCAGAATT-1"	"G"
"ATGGATCAGGGTCCCT-1"	"A"
"ATGGATCCAACGGGTA-1"	"A"
"ATGGATCCACACACCG-1"	"A"
"ATGGATCCATGATCGT-1"	"G"
"ATGTACGAGCGTTAGG-1"	"A"
"ATGTACGCAAATGCTC-1"	"A"
"ATGTACGCATGCGTTA-1"	"A"
"ATGTACGTCCAGAATC-1"	"G"
"ATGTACGTCGCCTTAC-1"	"A"
"ATGTCGAGTAGCGAGT-1"	"G"
"ATGTCTTAGATGTTCC-1"	"A"
"ATGTCTTGTGCCAAGA-1"	"A"
"ATGTCTTTCAATCGTG-1"	"A"
"ATGTCTTTCGCTTACC-1"	"G"
"ATGTCTTTCTATTTCG-1"	"A"
"ATGTTTCAGGCGTAGT-1"	"G"
"ATGTTTCCAAGCCAGA-1"	"A"
"ATGTTTCGTGCTTACA-1"	"G"
"ATGTTTCTCCAGAGAG-1"	"G"
"ATGTTTCTCGATAGCT-1"	"G"
"ATTACCTGTGCGTAGA-1"	"G"
"ATTACCTGTGGACTGA-1"	"G"
"ATTACCTTCCCGGGTA-1"	"A"
"ATTACCTTCTGCTACC-1"	"A"
"ATTACTCCAGGTTATC-1"	"G"
"ATTACTCGTTGGGAAC-1"	"G"
"ATTACTCTCGACTGGC-1"	"G"
"ATTACTCTCTGTTGCC-1"	"G"
"ATTCGTTAGCTAGCAG-1"	"G"
"ATTCGTTAGTAATGTG-1"	"A"
"ATTCGTTCAAAGGAAG-1"	"A"
"ATTCGTTCAGCTGATT-1"	"A"
"ATTCGTTGTTGGCTAT-1"	"A"
"ATTCGTTTCTTACGGA-1"	"A"
"ATTGTCTAGGACTTTC-1"	"A"
"ATTGTCTAGGGAGTTC-1"	"G"
"ATTGTCTCAACAAACA-1"	"G"
"ATTGTCTCACAGAAGC-1"	"G"
"ATTGTCTCAGATACAA-1"	"G"
"ATTGTCTGTCAGCAAG-1"	"G"
"ATTGTCTTCACCGCGA-1"	"G"
"ATTGTCTTCTTACCTA-1"	"G"
"ATTGTGGCAAGCCAGA-1"	"G"
"ATTGTGGGTCCCTAAA-1"	"G"
"ATTGTGGTCATCGCTC-1"	"A"
"ATTGTGGTCTCGCGGA-1"	"G"
"ATTTGTCCAAGCGACA-1"	"G"
"ATTTGTCCACACACCG-1"	"A"
"ATTTGTCTCCATAACG-1"	"G"
"CAAAGCTAGAGAGGTA-1"	"A"
"CAAAGCTCAAGACTAA-1"	"G"
"CAAAGCTTCGTGATAC-1"	"A"
"CAACCAAAGTGTCGGA-1"	"A"
"CAACCAAGTGCTGTCG-1"	"A"
"CAACCAATCGCAAACT-1"	"G"
"CAACGGCAGCGTAGCA-1"	"G"
"CAACGGCCAAGACTAA-1"	"G"
"CAACGGCCAAGGCGTA-1"	"A"
"CAACGGCGTCAACTAC-1"	"G"
"CAACGGCGTCCGTCGA-1"	"A"
"CAACGTAAGCATGTGG-1"	"G"
"CAACGTACAAGTCTCA-1"	"A"
"CAACGTACAATACTGC-1"	"A"
"CAACGTAGTGCATTGT-1"	"A"
"CAACGTATCTCCTTAA-1"	"A"
"CAAGAAAAGAATCAGT-1"	"A"
"CAAGAAAAGTGGACGT-1"	"A"
"CAAGAAACACCACCAG-1"	"G"
"CAAGAAACAGTAGTTC-1"	"A"
"CAAGAAAGTCACAGTT-1"	"A"
"CAAGCTAAGGGCGAAG-1"	"A"
"CAAGCTAAGTTGTCCA-1"	"A"
"CAAGCTACACAACGGA-1"	"A"
"CAAGCTATCGGTTGTA-1"	"G"
"CAAGCTATCTTTCGAT-1"	"G"
"CAAGGCCAGACTTCCA-1"	"G"
"CAAGGCCCACAGGTAG-1"	"A"
"CAAGGCCCATTGCCTC-1"	"A"
"CAAGGCCCATTTGGCA-1"	"A"
"CAAGGCCGTTTAGGAA-1"	"A"
"CAATCCCAGGTTGTGG-1"	"G"
"CAATCCCCACATTGCA-1"	"G"
"CAATCCCCATTGATGC-1"	"A"
"CAATCCCGTCAAGACG-1"	"A"
"CAATCCCTCCACGGCA-1"	"A"
"CAATCCCTCCGATGCG-1"	"G"
"CAATCCCTCCGGCGAT-1"	"G"
"CACAACAAGGTTCGAG-1"	"A"
"CACAACACACCAAGGA-1"	"A"
"CACAACAGTCAGAAAT-1"	"A"
"CACAACAGTGTAGGAC-1"	"A"
"CACAACATCCCGATTC-1"	"G"
"CACAACATCCTTTGCG-1"	"A"
"CACAGATGTCTAAGAA-1"	"A"
"CACAGATGTTGAAGCG-1"	"G"
"CACAGATTCGATTACG-1"	"A"
"CACATGAAGCGTTGCC-1"	"A"
"CACATGAGTGAGTAAT-1"	"G"
"CACATGAGTTTCCACC-1"	"A"
"CACATGATCCTAAGTG-1"	"A"
"CACATGATCGCGTGAC-1"	"G"
"CACCACTAGCAGGAGG-1"	"G"
"CACCACTCAAGGTTCT-1"	"A"
"CACCACTCACCACAGC-1"	"G"
"CACCACTGTTGTATCG-1"	"G"
"CACCACTTCCGCTATC-1"	"G"
"CACCTGTAGACGCCCT-1"	"G"
"CACCTGTAGAGCTACG-1"	"G"
"CACCTGTAGGTCACTT-1"	"A"
"CACCTGTAGTCATCTG-1"	"G"
"CACCTGTAGTGAGCTG-1"	"G"
"CACCTGTGTCCGTGCA-1"	"A"
"CACCTGTGTCGCTAGC-1"	"G"
"CACCTGTTCGGGATCC-1"	"A"
"CACCTGTTCTAGCTGA-1"	"G"
"CACCTTGCAAGGGTAC-1"	"G"
"CACCTTGGTCAGAGTG-1"	"A"
"CACCTTGGTCCATTGA-1"	"A"
"CACCTTGTCCGGAAAG-1"	"A"
"CACGTTCAGGCAGATC-1"	"A"
"CACGTTCCACAGATGG-1"	"G"
"CACGTTCGTGCTGTCG-1"	"G"
"CACGTTCTCGAAGCCC-1"	"A"
"CACTAAGAGAGGAATG-1"	"G"
"CACTAAGAGGTAAGCC-1"	"G"
"CACTAAGAGTTCCAGT-1"	"A"
"CACTAAGCAGGGAGTT-1"	"A"
"CACTAAGCATCATGTG-1"	"G"
"CACTAAGCATGCGCTG-1"	"G"
"CACTAAGGTTTGGATC-1"	"G"
"CACTGAACAAGCGAAC-1"	"A"
"CACTGAACAATAGCGG-1"	"A"
"CACTGAACACTGTTAG-1"	"G"
"CACTGAACAGGTGTGA-1"	"G"
"CACTGAATCTATTTCG-1"	"G"
"CAGCCTTAGCAGGAGG-1"	"G"
"CAGCCTTAGTGAGCAC-1"	"A"
"CAGCCTTGTAAGTGCG-1"	"G"
"CAGCCTTGTCGAGGAT-1"	"G"
"CAGCCTTGTTGTGAGG-1"	"A"
"CAGCCTTTCAGGTTTG-1"	"G"
"CAGCCTTTCCGTGCGA-1"	"A"
"CAGCTAAAGATTGACA-1"	"G"
"CAGCTAAAGCATGTGG-1"	"G"
"CAGCTAACACTAAACC-1"	"G"
"CAGCTAACATGCGTTA-1"	"G"
"CAGCTAAGTATCGCGC-1"	"G"
"CAGCTAAGTTCTTTGT-1"	"A"
"CAGCTAATCAGCACGC-1"	"A"
"CAGCTAATCATCATGG-1"	"A"
"CAGCTGGCACTGTTAG-1"	"G"
"CAGGATTAGGGCTTCC-1"	"G"
"CAGGATTGTCCGGTAC-1"	"A"
"CAGGATTGTTTCACCC-1"	"G"
"CAGGGCTAGCGGACAT-1"	"G"
"CAGGGCTTCCATAACG-1"	"A"
"CAGGGCTTCTGTTTAC-1"	"A"
"CAGTATGAGACGAAAG-1"	"A"
"CAGTATGCACGTGAAG-1"	"A"
"CAGTATGGTAACACTC-1"	"A"
"CAGTATGGTTGGACGA-1"	"G"
"CAGTATGTCATTCTCA-1"	"G"
"CAGTATGTCCGAATTG-1"	"G"
"CAGTGCGAGACTAATG-1"	"A"
"CAGTGCGCATCAGAAA-1"	"A"
"CAGTGCGCATGCCTTC-1"	"G"
"CAGTGCGGTCAACAGG-1"	"A"
"CAGTGCGGTCCGCTTT-1"	"A"
"CAGTGCGGTTGCCGCA-1"	"G"
"CAGTGCGTCACTAGGT-1"	"G"
"CAGTGCGTCCACACCT-1"	"A"
"CAGTGCGTCGTCCCAT-1"	"A"
"CAGTGTAAGTCAGGAC-1"	"A"
"CAGTGTAAGTGATAAC-1"	"A"
"CATAACGAGAGGAATG-1"	"A"
"CATAACGAGGTCACTT-1"	"G"
"CATAACGAGTCCGTGC-1"	"G"
"CATAACGCAGTAAGAT-1"	"G"
"CATAACGGTATCTGCA-1"	"A"
"CATAACGGTGTACGCC-1"	"A"
"CATAACGTCGCATAAC-1"	"A"
"CATGCCTAGACTAATG-1"	"G"
"CATGCCTAGTCGAGCA-1"	"G"
"CATGCCTCACTTTGGA-1"	"A"
"CATGTTTAGACGCCAA-1"	"A"
"CATGTTTCATGTCCCT-1"	"G"
"CATGTTTGTAAACCCT-1"	"A"
"CATGTTTGTAAGTGCG-1"	"G"
"CATGTTTGTAGAGAGA-1"	"A"
"CATGTTTGTAGTATCC-1"	"G"
"CATGTTTTCAATCGTG-1"	"A"
"CATGTTTTCCACGAGC-1"	"G"
"CATTCATAGGCAAGGG-1"	"A"
"CATTCATAGGCCTAAG-1"	"G"
"CATTCATAGGGTCCCT-1"	"G"
"CATTCATCACCAAGGA-1"	"G"
"CATTCATTCGTCCCTA-1"	"G"
"CATTCCGGTGCATTCA-1"	"A"
"CATTGGAAGGCACCTC-1"	"G"
"CATTGGACAATGCACT-1"	"G"
"CATTGGATCGACTATG-1"	"A"
"CCAATGAAGTAGTCGG-1"	"A"
"CCAATGACAAGGCTTT-1"	"G"
"CCAATGAGTTACTACG-1"	"A"
"CCAATGAGTTAGGCTT-1"	"G"
"CCAATGATCCGGAAAG-1"	"A"
"CCACAGGAGATCGAGC-1"	"A"
"CCACAGGAGGATTGCG-1"	"G"
"CCACAGGCATGCGCTG-1"	"G"
"CCACAGGCATGGGTGA-1"	"A"
"CCACAGGGTATCAGCT-1"	"A"
"CCACAGGGTCAACTAC-1"	"A"
"CCACAGGGTTGGCTTA-1"	"A"
"CCACAGGTCCTGTAGA-1"	"A"
"CCACAGGTCTGTGTCC-1"	"G"
"CCACGTTAGATATGAC-1"	"G"
"CCACGTTCAAGGAACC-1"	"G"
"CCACGTTTCAGGAATA-1"	"A"
"CCACGTTTCCAAGAGG-1"	"A"
"CCACGTTTCGATATGC-1"	"A"
"CCACGTTTCTAAACGC-1"	"G"
"CCAGAATAGCTGAATA-1"	"G"
"CCAGAATAGGCTGGAT-1"	"G"
"CCAGAATCATGATCGT-1"	"A"
"CCAGAATGTAGGTAAT-1"	"A"
"CCAGAATGTAGTTTGC-1"	"A"
"CCAGAATTCACATTCT-1"	"G"
"CCAGAATTCCGTGCAG-1"	"G"
"CCAGAATTCTGAGTAC-1"	"G"
"CCAGATAGTATTCTTC-1"	"A"
"CCAGATAGTCTCAAAC-1"	"G"
"CCAGATATCACAAGCT-1"	"G"
"CCAGATATCCATCATT-1"	"A"
"CCATACCAGAGGTCCA-1"	"G"
"CCATACCAGCAGGAGG-1"	"G"
"CCATACCCATGCACTA-1"	"G"
"CCATACCGTGCGTGTC-1"	"A"
"CCATACCGTGGCGCTT-1"	"A"
"CCATACCGTTCCAATG-1"	"A"
"CCATACCGTTTGCCCT-1"	"A"
"CCATACCTCGACTGGC-1"	"A"
"CCATACCTCGCATAAC-1"	"A"
"CCCACATAGTGAAACT-1"	"A"
"CCCAGAGAGACACAAT-1"	"G"
"CCCAGAGAGTTGGAAT-1"	"A"
"CCCAGAGCAATGGCAG-1"	"A"
"CCCAGAGCATCCTGGG-1"	"A"
"CCCAGAGGTAGATTAG-1"	"A"
"CCCAGAGTCTGAGTCA-1"	"A"
"CCCGTTAAGTACAGAT-1"	"A"
"CCCGTTACAATTAGGA-1"	"A"
"CCCGTTACACGATATC-1"	"A"
"CCCTAACAGACTAATG-1"	"A"
"CCCTAACCAAAGCTTC-1"	"A"
"CCCTAACCACCATTCC-1"	"A"
"CCCTAACCATTTGGCA-1"	"A"
"CCCTAACGTCATTGGT-1"	"G"
"CCCTAGTAGATTACGA-1"	"G"
"CCCTAGTAGCCGCTGT-1"	"G"
"CCCTAGTAGTAGTGTA-1"	"G"
"CCCTAGTCACCTGGTG-1"	"A"
"CCCTAGTCAGGGTAAC-1"	"A"
"CCCTAGTGTTACCCAA-1"	"A"
"CCCTAGTTCACTCGGG-1"	"A"
"CCCTAGTTCTCATCCG-1"	"G"
"CCCTCTCAGAAATGGG-1"	"A"
"CCCTCTCCAGTCAGCC-1"	"A"
"CCCTCTCGTCAAACAA-1"	"A"
"CCCTCTCGTGCGTAGA-1"	"A"
"CCCTCTCTCTGGAAGG-1"	"G"
"CCCTGATAGAAAGCAG-1"	"G"
"CCCTGATAGGAAACTT-1"	"A"
"CCCTGATCATGCGCTG-1"	"G"
"CCCTGATGTGTCGTCG-1"	"G"
"CCCTGATTCGTGGTAT-1"	"G"
"CCCTGATTCTATATCC-1"	"A"
"CCGAAGCCACAGCCAC-1"	"A"
"CCGAAGCGTATTTGCG-1"	"A"
"CCGAAGCGTCCAAGTT-1"	"A"
"CCGAAGCTCGATATGC-1"	"A"
"CCGAAGCTCTATAGGC-1"	"G"
"CCGAAGCTCTCGGCGA-1"	"G"
"CCGCATTCAGAAAGAG-1"	"A"
"CCGCATTCATCATAGC-1"	"A"
"CCGCATTCATCGAGTT-1"	"G"
"CCGCATTCATTACTCT-1"	"A"
"CCGCATTGTTAACTCG-1"	"A"
"CCGCATTTCGATATGC-1"	"G"
"CCGCATTTCTAAACGC-1"	"A"
"CCGTACTAGCGTGTTT-1"	"G"
"CCGTACTCAACGTCCG-1"	"A"
"CCGTACTCACACATTG-1"	"A"
"CCGTACTCAGGCAAGT-1"	"G"
"CCGTACTGTAGCGGTA-1"	"A"
"CCGTACTTCGGTCGAC-1"	"G"
"CCGTAGGAGCGTATCT-1"	"A"
"CCGTAGGAGTGTTCCA-1"	"G"
"CCGTAGGGTCAGAAAT-1"	"A"
"CCGTAGGGTGCTTACA-1"	"A"
"CCGTAGGTCGCGTTCT-1"	"A"
"CCGTAGGTCTATACCT-1"	"A"
"CCGTAGGTCTTCGTTA-1"	"G"
"CCGTGAGCAAATGTCC-1"	"A"
"CCGTGAGCAGGGTACA-1"	"G"
"CCGTGAGGTCGCTACG-1"	"A"
"CCTAAAGAGAAGGGCG-1"	"A"
"CCTAAAGAGACCCTAT-1"	"A"
"CCTAAAGGTCGAGGTA-1"	"A"
"CCTAAAGGTGGAAAGA-1"	"A"
"CCTAAAGTCACAGGGA-1"	"G"
"CCTATTAAGACGCCCT-1"	"A"
"CCTATTAAGCATGATA-1"	"A"
"CCTATTAAGGTGTTGG-1"	"A"
"CCTATTAGTGGTGGTA-1"	"A"
"CCTATTAGTTGGCTTA-1"	"A"
"CCTATTAGTTTGTGAC-1"	"A"
"CCTATTATCGGGAATG-1"	"A"
"CCTATTATCTGTTGCC-1"	"A"
"CCTCCCTAGACTAGGC-1"	"A"
"CCTCCCTAGCCATGGA-1"	"G"
"CCTCCCTAGGTGTCGA-1"	"A"
"CCTCCCTAGTTAGCGG-1"	"G"
"CCTCCCTCAGTCCTGG-1"	"G"
"CCTCCCTTCACACGTA-1"	"G"
"CCTCCCTTCCTAAAGC-1"	"G"
"CCTGCTAAGTTGTCCA-1"	"G"
"CCTGCTACACTTATGG-1"	"A"
"CCTGCTAGTATGTTCG-1"	"G"
"CCTGCTAGTATTCGCA-1"	"A"
"CCTGGGAAGAGCTGTG-1"	"G"
"CCTGGGAAGTCAACTC-1"	"A"
"CCTGGGACAGCGTAGA-1"	"A"
"CCTGGGACATGTGAGG-1"	"A"
"CCTGGGAGTGCATCAT-1"	"G"
"CCTGGGATCAATTCCT-1"	"G"
"CCTGGGATCGTGCTTC-1"	"G"
"CCTTAATAGAGGTACC-1"	"A"
"CCTTAATGTCACCCGA-1"	"A"
"CCTTAATTCAGTGTGT-1"	"G"
"CCTTAATTCCGTCAAA-1"	"A"
"CCTTGCAAGAACGACC-1"	"A"
"CCTTGCAAGGTAAGCC-1"	"A"
"CCTTGCAGTGCGCTCA-1"	"A"
"CCTTGGTCACCGATCG-1"	"A"
"CCTTGGTTCAGAACGG-1"	"G"
"CGAGTTAAGGCAAGGG-1"	"A"
"CGAGTTAAGGCATGCA-1"	"A"
"CGAGTTAAGGTTAGTA-1"	"A"
"CGAGTTACACTAGCCG-1"	"G"
"CGAGTTACACTTACAG-1"	"G"
"CGAGTTACAGTAAGAT-1"	"A"
"CGATGATCAACTCCCT-1"	"G"
"CGATGATGTGTAGGAC-1"	"A"
"CGATGATTCGCATAAC-1"	"G"
"CGCAATAAGGTCTTTG-1"	"G"
"CGCAATACACTACACA-1"	"A"
"CGCACAGAGTCGCCTG-1"	"G"
"CGCACAGCAAGGATGC-1"	"A"
"CGCACAGCACTCCACT-1"	"G"
"CGCACAGCAGCAATGG-1"	"G"
"CGCACAGGTACGTAGG-1"	"G"
"CGCACAGGTATTCTGG-1"	"G"
"CGCACAGGTCTGGTCG-1"	"G"
"CGCACAGTCCGAGGAA-1"	"A"
"CGCAGGTAGCAATAAC-1"	"A"
"CGCAGGTGTCTGGTTA-1"	"A"
"CGCAGGTGTGAATGGC-1"	"A"
"CGCAGGTTCGATATGC-1"	"A"
"CGCGCAAAGAGCGAAA-1"	"A"
"CGCGCAACAACGGGTA-1"	"G"
"CGCGCAACAAGTAACA-1"	"A"
"CGCGCAACACAGTTCA-1"	"A"
"CGCGCAAGTCCGGTAC-1"	"G"
"CGCGCAAGTGATTCCA-1"	"A"
"CGCGCAATCCGCTATC-1"	"A"
"CGCTAGGAGGACTAGC-1"	"G"
"CGCTAGGCAAGATTAG-1"	"A"
"CGCTATCAGTCATCTG-1"	"G"
"CGCTATCAGTCCTTCC-1"	"A"
"CGCTATCCACAATAAG-1"	"G"
"CGCTATCCATTATGGC-1"	"G"
"CGCTATCGTTAAGTCC-1"	"G"
"CGCTGGAAGATCGCCC-1"	"G"
"CGCTGGAAGTTGTCCA-1"	"A"
"CGCTGGACAGGTAACG-1"	"A"
"CGCTGGACATACAACC-1"	"A"
"CGCTGGAGTGCAAAGC-1"	"A"
"CGCTGGATCAGGTCTA-1"	"A"
"CGCTGGATCGAACCGC-1"	"G"
"CGCTGGATCGTGAACT-1"	"G"
"CGCTGGATCTATCTCA-1"	"A"
"CGGACCAAGCCAGAAC-1"	"G"
"CGGACCAAGTGCACAG-1"	"G"
"CGGACCAGTACTTCAG-1"	"G"
"CGGACCATCGAGTTAC-1"	"A"
"CGGACCATCGGCAATT-1"	"A"
"CGGACTGAGACCCATT-1"	"A"
"CGGACTGAGTCTAGAA-1"	"A"
"CGGACTGCATGCTATG-1"	"A"
"CGGACTGCATTCTTTG-1"	"A"
"CGGACTGGTGCAAAGC-1"	"A"
"CGGTGCACAACGACAG-1"	"A"
"CGGTGCAGTGAAACAT-1"	"G"
"CGGTGCAGTTCAGTTG-1"	"G"
"CGGTGCATCGTGTGCG-1"	"G"
"CGTAAACAGAAAGCAG-1"	"A"
"CGTAAACCATGGCCTG-1"	"G"
"CGTAAACGTACAACGG-1"	"A"
"CGTAAACGTATTGTCG-1"	"G"
"CGTAAACGTTCTGAAC-1"	"G"
"CGTAAACTCACATTCT-1"	"A"
"CGTAAACTCAGCACGC-1"	"A"
"CGTACAAAGACCAATA-1"	"G"
"CGTACAAAGTAGAAGG-1"	"A"
"CGTACAACACAGGAAC-1"	"A"
"CGTACAACATTTGGTG-1"	"A"
"CGTGGCAGTGCCAAGA-1"	"A"
"CGTTCCAAGGATTAAC-1"	"G"
"CGTTCCACAAGACACG-1"	"A"
"CGTTCCACAGTCCTGG-1"	"A"
"CGTTCCACATATAGAG-1"	"A"
"CGTTCCATCCAAACCA-1"	"G"
"CTAACTTAGGGTATCG-1"	"A"
"CTAACTTAGTAATCAG-1"	"A"
"CTAACTTAGTACCACT-1"	"G"
"CTAACTTAGTCCGGAA-1"	"G"
"CTAACTTCAGTGCTCG-1"	"G"
"CTAACTTCATGGCCGT-1"	"A"
"CTAACTTGTGTCCTTC-1"	"A"
"CTAACTTTCCGGGCAT-1"	"A"
"CTAACTTTCGACTGGC-1"	"G"
"CTAACTTTCGCCTTAC-1"	"A"
"CTACAGACAATCCATG-1"	"G"
"CTACAGACACGCGACT-1"	"G"
"CTACAGAGTAACGGAC-1"	"A"
"CTACAGAGTACTAGAA-1"	"A"
"CTACAGAGTCGATAGG-1"	"G"
"CTACAGAGTCTGAGCC-1"	"G"
"CTACAGAGTGGGTAGT-1"	"G"
"CTACAGATCTACTTTG-1"	"G"
"CTACAGATCTCGTAGA-1"	"A"
"CTACAGATCTGCCGAG-1"	"A"
"CTACTTACATAGCCAT-1"	"A"
"CTACTTATCACCCTTG-1"	"G"
"CTACTTATCTTCGTTA-1"	"A"
"CTAGCGGAGCAACGGT-1"	"G"
"CTAGCGGCAAATTCCG-1"	"A"
"CTAGCGGCAGCACATT-1"	"A"
"CTAGCGGCATTGCCTC-1"	"A"
"CTAGCGGGTACGAGAC-1"	"A"
"CTAGCGGGTAGAACGC-1"	"A"
"CTAGCGGGTATATGGA-1"	"A"
"CTAGCGGGTGTCGTCG-1"	"G"
"CTAGCGGGTTTCGTTT-1"	"A"
"CTAGCGGTCCAACCTC-1"	"A"
"CTAGCGGTCGTCTAGA-1"	"A"
"CTAGCGGTCTCTGACC-1"	"A"
"CTAGCGGTCTTAAGCG-1"	"G"
"CTAGGATCAATGGTCT-1"	"G"
"CTAGGATCACGACGAA-1"	"A"
"CTAGGATCAGTTACAC-1"	"G"
"CTAGGATCATCACAAC-1"	"A"
"CTAGGATTCACTACCC-1"	"G"
"CTAGGATTCCCGGGTA-1"	"G"
"CTAGGATTCGCTGATA-1"	"A"
"CTAGGGCAGTACGCGA-1"	"A"
"CTAGGGCAGTGCTAGG-1"	"G"
"CTAGGGCCATCCCAAA-1"	"A"
"CTAGGGCGTTTCCGGG-1"	"A"
"CTAGGGCTCAATTGGC-1"	"A"
"CTAGGGCTCCCAGCAG-1"	"G"
"CTCAACCAGGCACTAG-1"	"A"
"CTCAACCAGGCATGCA-1"	"G"
"CTCAACCCAGGATGTG-1"	"A"
"CTCAACCGTTTGGATC-1"	"A"
"CTCAACCTCATTGCCC-1"	"G"
"CTCAACCTCGTGCTTC-1"	"G"
"CTCACCAAGACGCCAA-1"	"A"
"CTCACCAAGCCATGGA-1"	"A"
"CTCACCAAGGGAAGCG-1"	"A"
"CTCACCAAGTTCCAGT-1"	"A"
"CTCACCAAGTTGCTTG-1"	"A"
"CTCACCACATCACAGT-1"	"G"
"CTCACCAGTATCCTTT-1"	"A"
"CTCACCAGTGCACTTA-1"	"A"
"CTCACCAGTTTCTCTA-1"	"A"
"CTCAGAAAGAGGTCCA-1"	"A"
"CTCAGAAAGCCTCGCA-1"	"G"
"CTCAGAAGTATCCCTC-1"	"A"
"CTCAGAAGTATTGTCG-1"	"A"
"CTCAGAATCAGCACGC-1"	"A"
"CTCAGAATCCGTTTCG-1"	"G"
"CTCAGAATCGCACAAT-1"	"G"
"CTCAGCTAGTCCCTCT-1"	"A"
"CTCAGCTCAATGAAAC-1"	"G"
"CTCAGCTCACAAACGG-1"	"A"
"CTCAGCTTCTGACTTT-1"	"G"
"CTCATGCAGAATGCTA-1"	"A"
"CTCATGCCAGATAAGT-1"	"A"
"CTCATGCGTTACGAAA-1"	"G"
"CTCATGCTCCTTACGC-1"	"G"
"CTCCCAAAGTCTCGAT-1"	"A"
"CTCCCAACAGAACGAC-1"	"A"
"CTCCCAAGTAACGGCA-1"	"A"
"CTCCCAAGTAGCAGCA-1"	"A"
"CTCCCAAGTAGTGATA-1"	"A"
"CTCCCAATCACCGCGA-1"	"G"
"CTCCCAATCCTCTCTT-1"	"G"
"CTCGCTAAGACACTTC-1"	"G"
"CTCGCTACAACGAGGT-1"	"G"
"CTCGCTACACTCGGAC-1"	"G"
"CTCGCTATCCTAAGTG-1"	"G"
"CTCGCTATCTTGTACT-1"	"G"
"CTCTACGCAAGGACCA-1"	"A"
"CTCTACGTCCTTTGAT-1"	"G"
"CTCTACGTCGACTCGG-1"	"G"
"CTCTAGCAGATGGGAA-1"	"A"
"CTCTAGCAGCGTGTTT-1"	"G"
"CTCTAGCCATACTGCA-1"	"G"
"CTCTAGCGTCCTCAGG-1"	"G"
"CTCTAGCGTTAGGCTT-1"	"G"
"CTCTAGCGTTATAGAG-1"	"A"
"CTCTCAGAGAGTGGAA-1"	"A"
"CTCTCAGAGGATTAAC-1"	"A"
"CTCTCAGCAATGGTAA-1"	"A"
"CTCTCAGCAGGCTACC-1"	"G"
"CTCTCAGTCAGTGTAC-1"	"A"
"CTCTCAGTCCCAATAG-1"	"A"
"CTCTCGAAGTCCGTGC-1"	"G"
"CTCTCGACAACACGGA-1"	"A"
"CTCTCGACAGGGAGTT-1"	"G"
"CTCTCGAGTAGTGATA-1"	"A"
"CTGAATGCATGCTATG-1"	"A"
"CTGAATGTCACCCTTG-1"	"G"
"CTGAATGTCAGCACGC-1"	"G"
"CTGCGTTAGGAGGCGA-1"	"G"
"CTGCGTTAGTTATGAG-1"	"G"
"CTGCGTTGTAGCGGTA-1"	"G"
"CTGCGTTTCCTTTGCG-1"	"A"
"CTGCTCAGTAATGCAA-1"	"A"
"CTGCTCAGTTCTGAAC-1"	"G"
"CTGCTCATCCCATAGA-1"	"A"
"CTGCTCATCCCTATTA-1"	"G"
"CTGCTCATCCGAATTG-1"	"G"
"CTGGCAGAGTCGTATC-1"	"A"
"CTGGCAGCATACTGCA-1"	"A"
"CTGGCAGGTACCCACG-1"	"G"
"CTGGCAGGTTAGGCTT-1"	"G"
"CTGGCAGTCCGTGCAG-1"	"G"
"CTGGCAGTCTCGACCT-1"	"G"
"CTGGGACAGAAACGCC-1"	"A"
"CTGGGACAGGCTCAGA-1"	"A"
"CTGGGACGTACGGAGT-1"	"A"
"CTGGGACGTCTCTAAG-1"	"G"
"CTGGGACGTCTGTTGA-1"	"A"
"CTGGGACTCCGTTAGA-1"	"A"
"CTGTATTAGGTTCGAG-1"	"G"
"CTGTATTAGTCCGTGC-1"	"A"
"CTGTATTCAAATGTCC-1"	"A"
"CTGTATTGTAAACGGC-1"	"G"
"CTGTATTGTAGCAGCA-1"	"A"
"CTGTATTTCTATCTCA-1"	"G"
"CTGTTCGCAAGCTTTG-1"	"A"
"CTGTTCGGTACCGGCT-1"	"G"
"CTGTTCGGTGCCCAGT-1"	"A"
"CTGTTCGGTGCTTACA-1"	"G"
"CTGTTCGTCGAACCGC-1"	"G"
"CTGTTCGTCGATAGCT-1"	"A"
"CTTAATCCAAGCGACA-1"	"A"
"CTTAATCCACCAAGGA-1"	"G"
"CTTAATCCACTTATGG-1"	"G"
"CTTAATCCAGTAACGG-1"	"A"
"CTTAATCGTAAGGTCG-1"	"G"
"CTTAATCGTACGACCC-1"	"G"
"CTTAATCGTAGCGTTT-1"	"A"
"CTTAATCGTGAGCTAG-1"	"G"
"CTTAATCGTGTCCCAG-1"	"G"
"CTTAATCTCTCCCTTT-1"	"A"
"CTTCCAGAGAGAGTAG-1"	"A"
"CTTCCAGAGTTGTCCA-1"	"A"
"CTTCCAGCATCCTCGT-1"	"A"
"CTTCCAGTCAATTCCT-1"	"A"
"CTTCCAGTCGAGAAGC-1"	"A"
"CTTCCAGTCGTGGTAT-1"	"G"
"CTTCCAGTCTGGTACA-1"	"A"
"CTTCTAAAGTCAGCCC-1"	"A"
"CTTCTAACAAGTGGCA-1"	"A"
"CTTCTAACAGGCAAGT-1"	"A"
"CTTCTAATCGAGGTAG-1"	"A"
"CTTGAAGAGAGAATTC-1"	"A"
"CTTGAAGAGCAGAATT-1"	"G"
"CTTGAAGCAAGATTAG-1"	"A"
"CTTGAAGCACTGAAGG-1"	"A"
"CTTGCCAAGGGCATTG-1"	"G"
"CTTGCCACAAGGACCA-1"	"G"
"CTTGCCACAATTGTGC-1"	"A"
"CTTGCCAGTAGTTTGC-1"	"G"
"CTTGCCATCCCAATGA-1"	"G"
"CTTGCCATCGCTACCT-1"	"A"
"CTTGCCATCTGTAGAC-1"	"A"
"CTTGCTGAGTATAGTG-1"	"A"
"CTTGCTGAGTTGCTTG-1"	"A"
"CTTGCTGTCCCATAGA-1"	"A"
"CTTGTCGAGGCGTCCT-1"	"G"
"CTTGTCGCATGTATCG-1"	"G"
"CTTGTCGTCAGGATCT-1"	"A"
"CTTGTCGTCGGTTGTA-1"	"A"
"CTTTGCGGTAACGTAA-1"	"G"
"GAAACAACAAGACTTC-1"	"G"
"GAAACAACACAGTAGG-1"	"A"
"GAAACAATCGCTCTAC-1"	"G"
"GAAAGTAAGACTCGGA-1"	"A"
"GAAAGTACACTGTAAC-1"	"G"
"GAAAGTACAGTTGGAG-1"	"G"
"GAAAGTATCACTTACT-1"	"A"
"GAAATGAAGAATACTG-1"	"G"
"GAAATGAAGTCCGATT-1"	"A"
"GAAATGATCCAGTTAG-1"	"A"
"GAAATGATCTGAAAGA-1"	"A"
"GAACCGCCAGCAACAG-1"	"G"
"GAACCGCCAGGACCTC-1"	"G"
"GAACCGCCAGGCAAGT-1"	"A"
"GAACCGCCAGGTAGGT-1"	"G"
"GAACCGCCATGTGAGG-1"	"G"
"GAACCGCTCAGGATCT-1"	"A"
"GAACCGCTCCATCATT-1"	"A"
"GAACCGCTCTGACATG-1"	"A"
"GAACCGCTCTGGACAT-1"	"G"
"GAACCTAAGTAGTGTA-1"	"G"
"GAACCTAAGTGAACCG-1"	"G"
"GAACCTAGTAATGCAA-1"	"A"
"GAACCTAGTACGAGAC-1"	"A"
"GAACCTATCGCCTTAC-1"	"G"
"GAACCTATCGTTTGAG-1"	"G"
"GAACGTTTCCTAAAGC-1"	"A"
"GAACTTGAGTGAGTGC-1"	"G"
"GAACTTGTCGGGCTCA-1"	"G"
"GAAGAGCAGACTAGCG-1"	"A"
"GAAGAGCCAGGTCTGC-1"	"G"
"GAAGAGCGTGAATGGC-1"	"G"
"GAAGAGCGTGGATTCT-1"	"A"
"GAAGAGCGTTACCCAA-1"	"G"
"GAAGAGCTCCTCCATG-1"	"A"
"GAAGTCTAGATGCGAC-1"	"A"
"GAAGTCTAGTGTCGCC-1"	"A"
"GAAGTCTCAGGCTACC-1"	"A"
"GAAGTCTCATCGGCCA-1"	"A"
"GAAGTCTGTGCTGTGC-1"	"A"
"GAAGTCTGTTCACGTA-1"	"A"
"GAAGTCTTCAGGATCT-1"	"G"
"GAAGTCTTCGGGCTCA-1"	"G"
"GAAGTGGCAAACTACC-1"	"A"
"GAAGTGGCAAGATGCG-1"	"G"
"GAAGTGGCATTTCTTG-1"	"A"
"GAAGTGGGTACGCCCA-1"	"A"
"GAAGTGGGTCCAACCG-1"	"G"
"GAAGTGGGTCTGATTG-1"	"A"
"GAAGTGGTCAAACCCA-1"	"A"
"GAAGTGGTCTGAACGT-1"	"A"
"GAATCTGAGAGCCACA-1"	"A"
"GAATCTGAGATATGTG-1"	"A"
"GAATCTGCACCGATCG-1"	"A"
"GAATCTGGTCACCCGA-1"	"A"
"GAATCTGTCTAGCAAC-1"	"G"
"GACCAATAGCGTTGCC-1"	"A"
"GACCAATCATACCCGG-1"	"A"
"GACCAATGTAACGGTG-1"	"A"
"GACCAATGTATCACAC-1"	"G"
"GACCAATGTCAACGGA-1"	"A"
"GACCAATTCCTCCTGA-1"	"A"
"GACCCAGTCAAGAGGC-1"	"A"
"GACCCAGTCCCGGGTA-1"	"G"
"GACCGACAGGAAGAAC-1"	"A"
"GACCGACAGGCCAGTA-1"	"G"
"GACCGACCAAGTTCGT-1"	"A"
"GACCGACGTTACGCTA-1"	"A"
"GACCGACGTTTCCTAT-1"	"A"
"GACCGACTCGCATACA-1"	"G"
"GACCTTCAGAATACTG-1"	"G"
"GACCTTCAGGCCAGTA-1"	"A"
"GACCTTCAGTGATTAG-1"	"G"
"GACCTTCCAAGCCAGA-1"	"A"
"GACCTTCTCGATGAAA-1"	"A"
"GACTAACAGGCCTCTG-1"	"A"
"GACTAACAGTATACGA-1"	"G"
"GACTAACAGTGAGTTA-1"	"G"
"GACTAACCAGGCACAA-1"	"G"
"GACTAACGTGTGAGGT-1"	"A"
"GACTAACTCCAAGAGG-1"	"A"
"GACTAACTCCCGTAGG-1"	"A"
"GACTAACTCGAGGCTC-1"	"A"
"GACTAGTAGAGAGGTA-1"	"A"
"GACTAGTGTGCACCCA-1"	"G"
"GAGAACGAGATATGAC-1"	"A"
"GAGAACGAGATCGAGC-1"	"G"
"GAGAACGAGCTGGAGT-1"	"A"
"GAGAACGCAACTCGAT-1"	"A"
"GAGAACGTCCACGGCA-1"	"G"
"GAGACTTAGAGGCAGG-1"	"A"
"GAGACTTAGCCATCAT-1"	"A"
"GAGACTTCAATGTAAG-1"	"G"
"GAGACTTGTTGTATCG-1"	"G"
"GAGACTTTCCTGTAGA-1"	"A"
"GAGATTCAGACTCTTG-1"	"A"
"GAGATTCGTATCGCGC-1"	"G"
"GAGATTCGTGGACGAT-1"	"A"
"GAGATTCGTTGGCTAT-1"	"G"
"GAGATTCTCACCACAA-1"	"A"
"GAGATTCTCGCAGATT-1"	"A"
"GAGATTCTCGGTTCCT-1"	"A"
"GAGCATTCATAAAGTG-1"	"A"
"GAGCATTCATCAACTG-1"	"G"
"GAGCATTTCGATGTGT-1"	"A"
"GAGCGCTCAAAGCTGG-1"	"A"
"GAGCGCTCAAGCCTTA-1"	"G"
"GAGCGCTGTAGAAAGG-1"	"A"
"GAGCGCTGTTTGCGAT-1"	"G"
"GAGCGCTTCCTTCGAC-1"	"A"
"GAGGATGAGTCCGGAA-1"	"A"
"GAGGATGCACAATAAG-1"	"G"
"GAGGATGCATTAGCCA-1"	"A"
"GAGGCTCAGGAGTAGA-1"	"G"
"GAGGCTCGTAGATTAG-1"	"G"
"GAGGCTCGTCAACGGA-1"	"G"
"GAGGCTCTCAGCACTA-1"	"A"
"GAGGCTCTCTGTAGAC-1"	"A"
"GAGGTCCGTACCGGCT-1"	"A"
"GAGGTCCTCGAAGCCC-1"	"A"
"GAGGTCCTCGTGGCGT-1"	"A"
"GAGTGAGCAGGGCTTC-1"	"G"
"GAGTGAGGTAGTCTGT-1"	"G"
"GAGTGAGTCTTAACGG-1"	"G"
"GATCATGAGGAAACTT-1"	"A"
"GATCATGCAAGGAACC-1"	"G"
"GATCATGGTGTGTGCC-1"	"A"
"GATCGTAAGCATTCCA-1"	"G"
"GATCGTAAGTGATCTC-1"	"A"
"GATCGTAGTCCAAGAG-1"	"G"
"GATCGTAGTGCAAGAC-1"	"G"
"GATCGTAGTTCTGAAC-1"	"G"
"GATCGTATCTTCATAC-1"	"G"
"GATGATCAGGCCTCGT-1"	"A"
"GATGATCCAAGTCTGT-1"	"A"
"GATGATCGTCCTCAGG-1"	"A"
"GATGATCGTTTGCCAA-1"	"G"
"GATGATCTCGACGGAA-1"	"G"
"GATGATCTCTGAGTAC-1"	"G"
"GATGGCCAGAAATCTG-1"	"A"
"GATGGCCAGTCAGCCC-1"	"A"
"GATGGCCCACGATATC-1"	"A"
"GATGGCCCATCCTGGG-1"	"A"
"GATGGCCTCCGAGGAA-1"	"G"
"GATGGCCTCGCTACCT-1"	"A"
"GATTAGCAGCATACCT-1"	"A"
"GATTAGCAGCATTCCA-1"	"G"
"GATTAGCAGTGTCCCG-1"	"G"
"GATTAGCCAACATAAG-1"	"G"
"GATTAGCCATTAGCAC-1"	"G"
"GATTAGCTCTCGGCGA-1"	"A"
"GATTGACAGCGGACAT-1"	"A"
"GATTGACAGCTATCCA-1"	"G"
"GATTGACCAAGGGAGG-1"	"A"
"GATTGACCAAGGTTCT-1"	"G"
"GATTGACCACCTGTGG-1"	"G"
"GATTGACCAGTTGCAT-1"	"A"
"GCAAAGGAGGGCTTCC-1"	"A"
"GCAAAGGAGTATAGTG-1"	"G"
"GCAAAGGCAGCTTACA-1"	"A"
"GCAAAGGGTCTTAGCA-1"	"G"
"GCAAAGGTCAAGTTGC-1"	"G"
"GCAAAGGTCAGGTCTA-1"	"G"
"GCAAAGGTCTATCTTG-1"	"A"
"GCAAAGGTCTGAACGT-1"	"G"
"GCAACCGAGACCAATA-1"	"A"
"GCAACCGAGGTAAGCC-1"	"A"
"GCAACCGCAATTGTGC-1"	"A"
"GCAACCGCACAATAAG-1"	"A"
"GCAACCGTCCGTCAAA-1"	"A"
"GCAACCGTCTGTGTCC-1"	"A"
"GCACCTTTCTACCCGT-1"	"G"
"GCACGCAAGAAGACTT-1"	"G"
"GCACGCAAGCGAGAAA-1"	"G"
"GCACGCACAGAAGTGC-1"	"A"
"GCACGCAGTTTCTACT-1"	"A"
"GCACGGTGTTCAGAAA-1"	"A"
"GCACGGTTCCATATCT-1"	"A"
"GCACGGTTCCATCATT-1"	"A"
"GCAGATTCAACATAAG-1"	"A"
"GCAGATTCAGGTTATC-1"	"A"
"GCAGATTGTAAGGTCG-1"	"A"
"GCAGATTTCCTCCTGA-1"	"G"
"GCAGATTTCGGATCGC-1"	"G"
"GCAGATTTCTCAGATG-1"	"G"
"GCAGCCAAGTGATTAG-1"	"A"
"GCAGCCAAGTGTCGGA-1"	"A"
"GCAGCCAAGTTCAACC-1"	"A"
"GCAGCCACACCGTTGG-1"	"A"
"GCAGCCACACCTCGTT-1"	"A"
"GCAGCCACAGGGCTTC-1"	"G"
"GCAGCCACAGTAGTCT-1"	"G"
"GCAGCCAGTGGTGGTA-1"	"A"
"GCAGCTGAGACTTCCA-1"	"A"
"GCAGCTGAGCTCGGCT-1"	"A"
"GCAGCTGGTAAAGGCC-1"	"A"
"GCAGCTGGTGATAGAT-1"	"G"
"GCAGCTGGTGGACAGT-1"	"A"
"GCAGCTGTCACTAGGT-1"	"G"
"GCAGCTGTCTTAAGCG-1"	"A"
"GCATGATCACTTATGG-1"	"A"
"GCATGATCAGGTAACG-1"	"G"
"GCATGATGTCACAGGA-1"	"G"
"GCATGATTCGATGAAA-1"	"A"
"GCATGATTCTACTGCC-1"	"A"
"GCATTCCAGACAGCTG-1"	"A"
"GCATTCCCACATTGCA-1"	"A"
"GCATTCCCACCACCAG-1"	"A"
"GCATTCCCACGCTAAT-1"	"A"
"GCATTCCGTAGAATAC-1"	"G"
"GCATTCCGTATCCTTT-1"	"G"
"GCATTCCTCATCGCCT-1"	"A"
"GCATTCCTCCGGGCAT-1"	"G"
"GCATTGACATATTGGC-1"	"A"
"GCATTGACATGGTAAA-1"	"A"
"GCATTGAGTTCTTATC-1"	"A"
"GCATTGAGTTTGTGAC-1"	"G"
"GCATTGATCAGGCGCT-1"	"A"
"GCATTGATCCCACTTG-1"	"G"
"GCATTGATCTTAATCC-1"	"A"
"GCCAGACAGTCTCCAA-1"	"A"
"GCCAGACGTGTACGCC-1"	"G"
"GCCAGACTCGTTGTTT-1"	"A"
"GCCAGCAGTAAGCCGA-1"	"G"
"GCCAGCAGTGCCCTAG-1"	"G"
"GCCAGCATCAAGGCAG-1"	"A"
"GCCAGCATCCTCCATG-1"	"A"
"GCCAGCATCGAGTTAC-1"	"A"
"GCCATAACACATAAAG-1"	"A"
"GCCATAACATCTGCAA-1"	"A"
"GCCATAACATGGCCTG-1"	"A"
"GCCATAACATGTGAGG-1"	"A"
"GCCATAAGTAGTCTGT-1"	"G"
"GCCATAAGTGCAAGAC-1"	"A"
"GCCATAATCGACGGAA-1"	"G"
"GCCATAATCGCTTGAA-1"	"G"
"GCCCAGAAGGTCTTGT-1"	"A"
"GCCCAGACACCTACCT-1"	"G"
"GCCCAGAGTAGCGTTT-1"	"G"
"GCCCGAAAGAACTCCT-1"	"G"
"GCCCGAAAGTCACGCC-1"	"G"
"GCCCGAATCCACGGCA-1"	"G"
"GCCCGAATCCTGGAAT-1"	"A"
"GCCCGAATCGTCAACA-1"	"A"
"GCCTACTAGATCGAGC-1"	"G"
"GCCTACTAGCCTCGCA-1"	"A"
"GCCTACTCATCCATAG-1"	"G"
"GCCTACTCATCCTCGT-1"	"G"
"GCCTACTGTCGAGGTA-1"	"A"
"GCCTAGGCAAACGTTC-1"	"A"
"GCCTAGGCAAGGACCA-1"	"G"
"GCCTAGGCAGTAACGG-1"	"A"
"GCCTAGGGTACAAGCG-1"	"G"
"GCCTAGGGTATTCTCT-1"	"G"
"GCGAGAAAGCATACCT-1"	"A"
"GCGAGAAAGTACAGTA-1"	"A"
"GCGAGAAAGTAGGTCG-1"	"A"
"GCGAGAAGTAGTATCC-1"	"G"
"GCGAGAAGTCCGAGCT-1"	"A"
"GCGAGAATCCCGGGTA-1"	"A"
"GCGAGTCAGAGTGGAA-1"	"A"
"GCGAGTCAGCCAGAAC-1"	"A"
"GCGAGTCGTTTGACCA-1"	"G"
"GCGAGTCTCCAACGCG-1"	"A"
"GCGAGTCTCTCTATCA-1"	"A"
"GCGATCGCAAGGAGGG-1"	"A"
"GCGATCGCACCACCAG-1"	"A"
"GCGATCGGTTCAGTTG-1"	"G"
"GCGATCGTCAAACCAC-1"	"A"
"GCGATTAAGTAGCAAT-1"	"A"
"GCGATTAAGTTCAGGG-1"	"G"
"GCGATTACAAACGTTC-1"	"A"
"GCGATTAGTGCCCGAT-1"	"G"
"GCGATTAGTGTGAGGT-1"	"A"
"GCGATTATCATGCTTT-1"	"A"
"GCGCATGAGCAATAAC-1"	"A"
"GCGCATGAGTTGCCGC-1"	"G"
"GCGCATGCAGCAACGA-1"	"G"
"GCGCATGCAGGGCTTC-1"	"A"
"GCGCATGGTCGGCTGT-1"	"A"
"GCGCATGGTCTAACCA-1"	"G"
"GCGCATGTCTTAACGG-1"	"A"
"GCGCATGTCTTCACTA-1"	"G"
"GCGCCAAAGATCCGAG-1"	"G"
"GCGCCAACAACTCGTA-1"	"A"
"GCGCCAACATCCCAAA-1"	"G"
"GCGCCAAGTGACAAGC-1"	"G"
"GCGGAAAAGGAGTCTG-1"	"A"
"GCGGAAATCGCACAAT-1"	"A"
"GCGGGTTCAACCTCCT-1"	"G"
"GCGGGTTGTAACGGCA-1"	"A"
"GCGGTGTAGAGCAGCT-1"	"A"
"GCGGTGTCAGGACTGA-1"	"G"
"GCGGTGTGTTTCCGGG-1"	"G"
"GCGGTGTTCCACACCT-1"	"A"
"GCGTAGCGTTGTGACT-1"	"A"
"GCGTTGGAGTGGTGTG-1"	"A"
"GCGTTGGGTCGAGGAT-1"	"G"
"GCGTTGGTCGCCTTAC-1"	"A"
"GCTCACTAGTTCAAGA-1"	"G"
"GCTCACTCATAGTCCA-1"	"A"
"GCTCACTGTAAGTGCG-1"	"A"
"GCTCACTGTAGCCATT-1"	"A"
"GCTCACTGTATGGGTG-1"	"G"
"GCTCACTGTCATCGTA-1"	"A"
"GCTCACTTCCAGGTCG-1"	"A"
"GCTCACTTCCCAGCGA-1"	"A"
"GCTCACTTCGCTACCT-1"	"G"
"GCTCACTTCGGTCAGC-1"	"G"
"GCTCAGGCACAGGTAG-1"	"A"
"GCTCAGGGTAGGGTTG-1"	"G"
"GCTCAGGGTTCAGTAC-1"	"A"
"GCTCAGGTCTGTTTAC-1"	"A"
"GCTCGAGAGCAGAAAG-1"	"A"
"GCTCGAGGTCATAGCT-1"	"A"
"GCTCGAGTCGGTCTAA-1"	"A"
"GCTCGAGTCTTCTCTC-1"	"G"
"GCTGAGCCAGAGAGAA-1"	"G"
"GCTGAGCCATAGACGG-1"	"G"
"GCTGAGCGTATGGTTC-1"	"A"
"GCTGCGAAGAGGTGGG-1"	"G"
"GCTGTTCAGGCGACTA-1"	"G"
"GCTGTTCTCCGTCAAA-1"	"A"
"GCTGTTCTCGCAAGCC-1"	"G"
"GCTTAAGAGAGTTCGG-1"	"G"
"GCTTAAGAGCGAGCTA-1"	"G"
"GCTTAAGCAAGAGATT-1"	"A"
"GCTTAAGCATTCACCC-1"	"A"
"GCTTGCTAGTACCTCA-1"	"A"
"GCTTGCTTCCGATGCG-1"	"A"
"GCTTGCTTCTGTTTAC-1"	"G"
"GCTTTCGCAAGCACTT-1"	"A"
"GCTTTCGGTATTCGCA-1"	"A"
"GCTTTCGGTCTAAGAA-1"	"G"
"GCTTTCGGTCTGATTG-1"	"G"
"GCTTTCGGTTGGACGA-1"	"A"
"GCTTTCGTCACTCGGG-1"	"G"
"GCTTTCGTCCGGAAAG-1"	"G"
"GCTTTCGTCGTGCTGG-1"	"A"
"GGAACCCAGAAACGCC-1"	"A"
"GGAACCCAGAAGCCGT-1"	"A"
"GGAACCCAGAGGAAGT-1"	"G"
"GGAACCCAGCGAATAT-1"	"A"
"GGAACCCCAAGCAATA-1"	"A"
"GGAACCCGTCCAAGTT-1"	"A"
"GGAACCCTCTATGAGC-1"	"A"
"GGAACTTAGGCGATTG-1"	"A"
"GGAACTTGTAACGGCA-1"	"G"
"GGAACTTGTAGACACG-1"	"G"
"GGAACTTGTTCCATCC-1"	"A"
"GGAACTTTCGACTTAG-1"	"G"
"GGAACTTTCTGCTACC-1"	"G"
"GGAATCTAGGGCGAAG-1"	"A"
"GGAATCTAGTCTAGAA-1"	"G"
"GGAATCTTCGGATAAA-1"	"G"
"GGAATCTTCTACTTTG-1"	"G"
"GGACACCAGGCAGATC-1"	"A"
"GGACACCCAAGACACG-1"	"A"
"GGACACCCAGGTCTGC-1"	"G"
"GGACACCGTCAAACAA-1"	"A"
"GGACACCGTCAGGCTC-1"	"G"
"GGAGAACAGGCCTCGT-1"	"G"
"GGAGAACAGTTGCTTG-1"	"A"
"GGAGAACCAAGTTGCT-1"	"A"
"GGAGAACGTAGACACG-1"	"G"
"GGAGAACTCCTGAAAC-1"	"A"
"GGAGAACTCCTGTAGA-1"	"G"
"GGAGGATCAAGGCGTA-1"	"G"
"GGAGGATCAAGGTTCT-1"	"G"
"GGAGGATCAGCCGAAA-1"	"A"
"GGAGGATTCCTCAAGA-1"	"A"
"GGAGGATTCGGATAAA-1"	"A"
"GGAGTAGCAGGTAACG-1"	"G"
"GGAGTAGCATCGTACA-1"	"A"
"GGAGTAGGTAGTAACA-1"	"A"
"GGAGTAGGTTCCCAAA-1"	"G"
"GGATAGGGTGTCCCAG-1"	"A"
"GGATAGGTCCGGAAAG-1"	"G"
"GGATAGGTCGATTACG-1"	"G"
"GGATGAGAGGTCGGTA-1"	"G"
"GGATGAGCATCTGCAA-1"	"A"
"GGATGAGCATGGAGGT-1"	"G"
"GGATGAGCATTACTCT-1"	"G"
"GGCACGTAGAGCTACG-1"	"A"
"GGCACGTAGCGTGTTT-1"	"A"
"GGCACGTCAAGCCCTG-1"	"G"
"GGCACGTGTATCAGCT-1"	"G"
"GGCACGTTCTTGCGCT-1"	"A"
"GGCATTAAGGTACACG-1"	"A"
"GGCATTACACAGTTCA-1"	"G"
"GGCATTAGTCATAGAA-1"	"A"
"GGCATTAGTGGCGCTT-1"	"G"
"GGCATTAGTGTCCAGC-1"	"A"
"GGCATTAGTTAGCTCA-1"	"G"
"GGCGAAAAGAGTTCGG-1"	"A"
"GGCGAAACAAGAGATT-1"	"A"
"GGCGAAACACAAACAA-1"	"G"
"GGCGAAACACAGTAGG-1"	"G"
"GGCGAAACACGTTACA-1"	"A"
"GGCGAAACAGTCAGCC-1"	"A"
"GGCGAAAGTGGACAGT-1"	"G"
"GGCGAAATCCAGGTAT-1"	"G"
"GGCGTTGAGACAGCTG-1"	"G"
"GGCGTTGCACCGTCTT-1"	"G"
"GGCGTTGGTCATCGTA-1"	"G"
"GGCGTTGTCGAGGCTC-1"	"A"
"GGGAACAAGCTGCTCG-1"	"A"
"GGGAACAAGGGTAATT-1"	"G"
"GGGAACAAGTTACCAC-1"	"A"
"GGGAACACAAGTTGCT-1"	"G"
"GGGAACACACGTGAAG-1"	"G"
"GGGAACAGTGCATTGT-1"	"A"
"GGGACCTCATATTGGC-1"	"A"
"GGGACCTGTCAGACGA-1"	"A"
"GGGACCTGTCAGCAAG-1"	"A"
"GGGACCTTCAACTTGG-1"	"G"
"GGGACCTTCCAACCTC-1"	"A"
"GGGACCTTCCGGACTG-1"	"G"
"GGGACCTTCGCAACTA-1"	"A"
"GGGCCATAGGCCTCGT-1"	"G"
"GGGCCATGTTACTACG-1"	"A"
"GGGTCTGAGATTCCGT-1"	"A"
"GGGTCTGTCATCGCCT-1"	"G"
"GGGTCTGTCGGATGTT-1"	"G"
"GGGTGTCAGGAGGCGA-1"	"A"
"GGGTGTCCACAACGGA-1"	"A"
"GGGTGTCCATCGACGC-1"	"G"
"GGGTGTCGTTGTCGGC-1"	"G"
"GGGTGTCTCAGATACC-1"	"A"
"GGGTGTCTCTGCTACC-1"	"G"
"GGGTTATAGGTTACAA-1"	"A"
"GGTACCGAGACTAGCG-1"	"G"
"GGTACCGAGCAGAGCT-1"	"A"
"GGTACCGAGGTTGTTC-1"	"G"
"GGTACCGAGTCTGTGT-1"	"G"
"GGTACCGCAAGCTTTG-1"	"A"
"GGTACCGCACCACCAG-1"	"A"
"GGTACCGGTAGTTTGC-1"	"A"
"GGTACCGGTATGCTAC-1"	"G"
"GGTACCGTCTCGTGAA-1"	"A"
"GGTAGGAAGAGGCGGA-1"	"A"
"GGTAGGAAGGAAACTT-1"	"A"
"GGTAGGAAGGTAAGTT-1"	"G"
"GGTAGGACACGATTAC-1"	"A"
"GGTAGGAGTAGCAGGT-1"	"A"
"GGTAGGATCCCGAAGC-1"	"G"
"GGTCATAAGATATGAC-1"	"A"
"GGTCATACAATTCAGC-1"	"A"
"GGTCATACACGTTACA-1"	"G"
"GGTCATAGTGCCAAGA-1"	"A"
"GGTCATAGTTCCGGCA-1"	"G"
"GGTCATATCAGAACGG-1"	"A"
"GGTCATATCCCGCAAG-1"	"G"
"GGTCATATCCGAATTG-1"	"A"
"GGTCATATCCTGTGGG-1"	"G"
"GGTGAAGAGGTCCTCG-1"	"A"
"GGTGAAGCACATTGCA-1"	"A"
"GGTGAAGGTGCAACAG-1"	"A"
"GGTGAAGTCGAACACT-1"	"G"
"GGTGAAGTCGGAAAGC-1"	"A"
"GGTGCTGCACTGTTAG-1"	"G"
"GGTGCTGCAGATTAAG-1"	"G"
"GGTGCTGGTCTCTGGG-1"	"A"
"GGTGCTGGTTTCAGCA-1"	"A"
"GGTGCTGTCGGTTGTA-1"	"A"
"GGTGTCGAGGAAGGTA-1"	"G"
"GGTGTCGAGTCCCTCT-1"	"G"
"GGTGTCGCAGAGAGAA-1"	"G"
"GGTGTCGCAGGTAACG-1"	"A"
"GGTGTCGCATAGATAG-1"	"G"
"GGTGTCGGTACATGGG-1"	"G"
"GGTGTCGGTCACATTG-1"	"A"
"GGTGTCGGTGACCAGA-1"	"A"
"GGTGTCGGTTGGCTAT-1"	"G"
"GGTTGCGAGATTCCGT-1"	"G"
"GGTTGCGCAATTGTGC-1"	"A"
"GGTTGCGGTGGTAAGC-1"	"G"
"GGTTGCGTCTGATCTT-1"	"A"
"GGTTGCGTCTTTATCG-1"	"A"
"GTAATCGAGTGATTAG-1"	"G"
"GTAATCGCAAACTACC-1"	"G"
"GTAATCGCACGGCCAT-1"	"A"
"GTAATCGGTAATGCAA-1"	"A"
"GTAATCGTCGGTCGAC-1"	"A"
"GTACTTTAGAGCGGTT-1"	"G"
"GTACTTTAGTTCGACT-1"	"A"
"GTACTTTAGTTTGGAA-1"	"A"
"GTACTTTCAGTCAGAG-1"	"A"
"GTACTTTGTGATGCGA-1"	"G"
"GTACTTTTCCTTACGC-1"	"G"
"GTACTTTTCGAACACT-1"	"G"
"GTACTTTTCGCACAAT-1"	"G"
"GTAGACTAGAACGTCG-1"	"G"
"GTAGACTAGTAGCAAT-1"	"A"
"GTAGACTGTATGGTTC-1"	"G"
"GTAGACTTCACATCCC-1"	"G"
"GTAGGAGAGTCACGCC-1"	"A"
"GTAGGAGCACCAAGGA-1"	"G"
"GTAGGAGCAGGCTACC-1"	"G"
"GTAGTACAGCTCGTTA-1"	"A"
"GTAGTACCAACGGGTA-1"	"G"
"GTAGTACCATTAGCCA-1"	"G"
"GTAGTACTCACTGATG-1"	"G"
"GTCACAAAGTCTCGAT-1"	"A"
"GTCACAATCCCTACGT-1"	"G"
"GTCACCTAGGATATCA-1"	"A"
"GTCACCTGTCCAGACC-1"	"A"
"GTCACCTGTTTGAAGA-1"	"A"
"GTCACGGAGGATTTGA-1"	"G"
"GTCACGGAGGGCTTCC-1"	"G"
"GTCACGGGTCCTTATT-1"	"A"
"GTCACGGTCGACTATG-1"	"A"
"GTCACTCAGAGCCTGA-1"	"A"
"GTCACTCAGGCACTAG-1"	"G"
"GTCACTCCAACGTAGG-1"	"G"
"GTCACTCCACCACGAC-1"	"A"
"GTCACTCGTTGCAGCC-1"	"G"
"GTCACTCTCCCGAAGC-1"	"A"
"GTCACTCTCGCTCGGA-1"	"G"
"GTCCATCAGACGCCCT-1"	"G"
"GTCCATCAGCATACCT-1"	"A"
"GTCCATCCAAACGACG-1"	"A"
"GTCCATCTCAATTGGC-1"	"A"
"GTCCATCTCAGGTCTA-1"	"G"
"GTCCATCTCCAGAGAG-1"	"A"
"GTCGTAACAACACGGA-1"	"G"
"GTCGTAAGTCATCAAC-1"	"G"
"GTCGTAATCCATCATT-1"	"A"
"GTCGTAATCGGTCCGA-1"	"A"
"GTCTACCCAGGTGTCC-1"	"G"
"GTCTACCCATGTGAGG-1"	"A"
"GTCTACCGTTGGCGAA-1"	"A"
"GTGACATAGACCGCAA-1"	"A"
"GTGACATAGTCGAGCA-1"	"G"
"GTGACATCAATCCATG-1"	"G"
"GTGACATCATTACTCT-1"	"G"
"GTGACATTCCATACCC-1"	"A"
"GTGACATTCCATACGA-1"	"A"
"GTGACATTCGGTCTCT-1"	"A"
"GTGATCAAGACTCGGA-1"	"A"
"GTGATCAAGGCGTCCT-1"	"G"
"GTGATCAGTCTCTAAG-1"	"G"
"GTGATCAGTGACGCAA-1"	"A"
"GTGATCATCAGTCAAC-1"	"A"
"GTGATCATCCGTTTCG-1"	"G"
"GTGATCATCTCAGATG-1"	"A"
"GTGCACGCACGTTGTA-1"	"G"
"GTGCACGGTCTGTGTA-1"	"G"
"GTGCACGTCGGTTGTA-1"	"G"
"GTGCACGTCGTGGAAG-1"	"G"
"GTGCCAGAGCATTCCA-1"	"A"
"GTGCCAGAGTCGTATC-1"	"A"
"GTGCCAGAGTGAGTGC-1"	"A"
"GTGCCAGCAACGTACT-1"	"G"
"GTGCCAGCACTGCTCT-1"	"G"
"GTGCCAGCAGATAAGT-1"	"G"
"GTGCCAGGTGCCCGAT-1"	"A"
"GTGCCAGTCATGCTTT-1"	"G"
"GTGCTGGGTACTTCAG-1"	"A"
"GTGCTGGGTGGACTGA-1"	"A"
"GTGGATTAGGCCAATG-1"	"A"
"GTGGATTCAGTTAAAG-1"	"G"
"GTGGATTCATGTGGGA-1"	"A"
"GTGGATTGTAGGGTTG-1"	"A"
"GTGGATTGTGAATGGC-1"	"G"
"GTGGATTTCCCTATTA-1"	"A"
"GTGGCGTAGACGTCAG-1"	"A"
"GTGGCGTAGGAAGGTA-1"	"A"
"GTGGCGTAGGCTTTAC-1"	"G"
"GTGGCGTAGTTGTCCA-1"	"G"
"GTGGCGTGTCGAGGTA-1"	"G"
"GTGGCGTGTGGAGTGT-1"	"A"
"GTGGCGTGTGGTGGTA-1"	"A"
"GTGGCGTTCCGCTCTA-1"	"G"
"GTGGCGTTCGTGCTTC-1"	"A"
"GTGGCGTTCTGCTACC-1"	"G"
"GTGTCAAGTCCAACCG-1"	"A"
"GTGTCAAGTTTAGGAA-1"	"A"
"GTGTCAATCTAGTCGA-1"	"A"
"GTGTCCTAGGATTGCG-1"	"A"
"GTGTCCTAGGTACACG-1"	"A"
"GTGTCCTAGTAGTCGG-1"	"A"
"GTGTCCTGTACAAATG-1"	"G"
"GTGTCCTGTTACGAAA-1"	"A"
"GTGTCCTTCTGAGTCA-1"	"G"
"GTGTGATAGTCGGGAT-1"	"G"
"GTGTGATAGTTCAACC-1"	"A"
"GTGTGATCAGCAGGTA-1"	"A"
"GTGTGATGTCCAAGAG-1"	"G"
"GTGTGATTCAGCCGGT-1"	"A"
"GTTACGACACTTATGG-1"	"G"
"GTTACTTCACACACCG-1"	"G"
"GTTACTTTCAAGGCCC-1"	"A"
"GTTACTTTCCTAGAGT-1"	"A"
"GTTACTTTCGGCAATT-1"	"A"
"GTTACTTTCTACTGCC-1"	"G"
"GTTACTTTCTATGAGC-1"	"A"
"GTTACTTTCTCCTTGG-1"	"G"
"GTTATGGAGGAGTAGA-1"	"A"
"GTTATGGAGTACGCGA-1"	"G"
"GTTATGGGTCGCTAGC-1"	"A"
"GTTATGGTCCGCGATG-1"	"A"
"GTTATGGTCCTGTAGA-1"	"G"
"GTTATTCAGATCTCAC-1"	"A"
"GTTATTCCAAATGCTC-1"	"A"
"GTTATTCCAATCATCG-1"	"A"
"GTTATTCCACTCCTCA-1"	"A"
"GTTATTCCATCACAGT-1"	"A"
"GTTATTCTCCAAACCA-1"	"G"
"GTTATTCTCTAGCAGT-1"	"A"
"GTTATTCTCTATCCTA-1"	"G"
"GTTATTCTCTCTGAGA-1"	"A"
"GTTATTCTCTGAAAGA-1"	"A"
"GTTATTCTCTGGGCGT-1"	"G"
"GTTCAAGGTCTGTGTA-1"	"G"
"GTTCAAGGTGAGCTAG-1"	"G"
"GTTCAAGGTGTAGGAC-1"	"A"
"GTTCAAGGTTTGCATG-1"	"G"
"GTTCAAGTCCTGTAGA-1"	"A"
"GTTGGGCAGAGCTCCC-1"	"G"
"GTTGGGCAGGCTGGAT-1"	"G"
"GTTGGGCCAAGTAATG-1"	"G"
"GTTGGGCCAGGCTACC-1"	"A"
"GTTGGGCCATCCTCGT-1"	"A"
"GTTGGTACAACGAGGT-1"	"A"
"GTTGGTACATTCACGA-1"	"A"
"GTTGGTAGTGCTTACA-1"	"A"
"GTTGGTATCAATGCAC-1"	"G"
"GTTGGTATCCATATCT-1"	"A"
"GTTGGTATCCTAAGTG-1"	"A"
"TAAACCGAGCATGATA-1"	"A"
"TAAACCGAGCTAACAA-1"	"A"
"TAAACCGAGTCGGGAT-1"	"G"
"TAAACCGGTGGAAGCT-1"	"G"
"TAAACCGTCCAGGCCA-1"	"G"
"TAACAGCAGTTCGCGC-1"	"A"
"TAACAGCCAAGATTAG-1"	"A"
"TAACAGCCAAGCGGTA-1"	"G"
"TAACAGCGTCCGAGCT-1"	"A"
"TAACAGCGTGCGCATC-1"	"A"
"TAACAGCTCCAGTACA-1"	"A"
"TAACGGTAGCGTTAGG-1"	"G"
"TAACGGTAGTCTGCTA-1"	"A"
"TAACGGTCACTGATAC-1"	"G"
"TAACGGTCAGGTCTGC-1"	"A"
"TAACGGTCATTCGTCC-1"	"A"
"TAACGGTGTTTGCGAT-1"	"A"
"TAACGGTTCGGGACAA-1"	"A"
"TAACTTCAGCACGTAG-1"	"A"
"TAACTTCAGCGTATCT-1"	"A"
"TAACTTCAGTGTAATG-1"	"G"
"TAACTTCCAAGCAATA-1"	"A"
"TAACTTCCAGTAAGAT-1"	"A"
"TAACTTCTCACAAGCT-1"	"A"
"TAACTTCTCGACCCGA-1"	"G"
"TAACTTCTCGACTTAG-1"	"G"
"TAAGCCACAAGCGGTA-1"	"A"
"TAAGCCACACTGCTCT-1"	"A"
"TAAGCCACATCCGTAA-1"	"A"
"TAAGCCACATCCGTGG-1"	"A"
"TAAGCCAGTAGACACG-1"	"A"
"TAAGTGCAGATGCGAC-1"	"G"
"TAAGTGCCACATATCG-1"	"G"
"TAAGTGCGTGACCAGA-1"	"A"
"TAAGTGCGTGATAGAT-1"	"A"
"TAAGTGCTCAATCGTG-1"	"A"
"TAAGTGCTCGAGGCTC-1"	"A"
"TAATCGGAGAGCCTGA-1"	"G"
"TAATCGGAGATCGCCC-1"	"G"
"TAATCGGAGTGAGCTG-1"	"A"
"TAATCGGCAAGTCCTA-1"	"A"
"TAATCGGGTCATTGCA-1"	"A"
"TAATTCCAGACCTATC-1"	"G"
"TAATTCCAGCATGATA-1"	"A"
"TAATTCCCACAGGTAG-1"	"G"
"TAATTCCCATTAGCAC-1"	"G"
"TAATTCCGTTTAAGCC-1"	"A"
"TAATTCCTCTCTGAGA-1"	"A"
"TAATTCCTCTTAACGG-1"	"G"
"TACAGCAAGGCCTCTG-1"	"G"
"TACAGCAAGTCGCGTC-1"	"G"
"TACAGCAAGTCTCCAA-1"	"G"
"TACAGCACATGCCCTT-1"	"G"
"TACAGCAGTACGGTTT-1"	"A"
"TACAGCATCATCGCAA-1"	"A"
"TACAGCATCGCCCTTA-1"	"A"
"TACATGGCAGGTCTGC-1"	"G"
"TACATGGCATAGCCGC-1"	"G"
"TACATGGGTACGCAAG-1"	"G"
"TACATGGGTGCCCGAT-1"	"A"
"TACATTCGTATGTCCA-1"	"G"
"TACATTCGTCAACGGA-1"	"G"
"TACATTCGTCCGTAGC-1"	"G"
"TACATTCGTTCTACGA-1"	"A"
"TACATTCGTTTAAGGA-1"	"G"
"TACATTCTCAGGAATA-1"	"A"
"TACCCTGAGAGTTCGG-1"	"G"
"TACCCTGGTAGAAAGG-1"	"A"
"TACCCTGGTAGATTAG-1"	"G"
"TACCCTGGTCGAGAAC-1"	"G"
"TACCCTGGTGCATTCA-1"	"A"
"TACCCTGGTTTGACCA-1"	"G"
"TACCCTGTCGGGATCC-1"	"G"
"TACCTATCACGTTGTA-1"	"A"
"TACCTATGTCCATTGA-1"	"G"
"TACCTATGTCCGAGCT-1"	"A"
"TACCTATTCCAATAGC-1"	"A"
"TACCTCGAGAATATCG-1"	"G"
"TACCTCGAGCCCATTA-1"	"A"
"TACCTCGCACGCTCAG-1"	"A"
"TACCTCGCATGGTATC-1"	"A"
"TACCTCGGTAATGTAG-1"	"G"
"TACCTCGGTATTCTCT-1"	"A"
"TACCTCGGTCCTTATT-1"	"G"
"TACCTCGGTGCTAGTT-1"	"A"
"TACCTCGTCACCCGGA-1"	"A"
"TACCTCGTCGAGTGTT-1"	"A"
"TACGCAAAGCTACGCC-1"	"G"
"TACGCAAAGGTTAACA-1"	"A"
"TACGCAACATTATGGC-1"	"A"
"TACGCAATCTGTGTCC-1"	"G"
"TACGCCTAGACACAAT-1"	"A"
"TACGCCTAGGGTATCG-1"	"A"
"TACGCCTGTCCTATTT-1"	"G"
"TACGCCTGTCTGGTCG-1"	"A"
"TACGCCTTCGCCAGAC-1"	"A"
"TACGCCTTCTACTGCC-1"	"G"
"TACGGATAGGAAACTT-1"	"A"
"TACGGATAGGTAAGTT-1"	"G"
"TACGGATCACTCAAGT-1"	"A"
"TACGGATGTACTTCAG-1"	"G"
"TACGGATGTAGCAGGT-1"	"G"
"TACGGATTCAGGGTTT-1"	"G"
"TACTAGGCACACACAT-1"	"G"
"TACTAGGCATAAAGTG-1"	"G"
"TACTAGGGTTCTTATC-1"	"G"
"TACTAGGGTTGTGAGG-1"	"G"
"TACTAGGTCTTTATCG-1"	"G"
"TACTCGCAGAACGACC-1"	"A"
"TACTCGCAGACACGGT-1"	"G"
"TACTCGCCACGTTAGT-1"	"A"
"TACTCGCCATCTCACC-1"	"A"
"TACTCGCTCACACGTA-1"	"A"
"TACTCGCTCAGGCGCT-1"	"A"
"TACTCGCTCCAGTTAG-1"	"A"
"TACTGCCCAGGGAGTT-1"	"G"
"TACTGCCCATGGTAAA-1"	"G"
"TACTGCCGTCAAATCC-1"	"G"
"TACTGCCGTTCTGAGT-1"	"A"
"TACTGCCGTTGAATAG-1"	"A"
"TACTGCCTCGGGTCCA-1"	"A"
"TACTGCCTCTCGGCGA-1"	"A"
"TAGACTGAGCACGTAG-1"	"A"
"TAGACTGAGTAGGTCG-1"	"A"
"TAGACTGGTAGCGTTT-1"	"A"
"TAGACTGGTCAACTAC-1"	"A"
"TAGACTGGTCCAAGTT-1"	"A"
"TAGACTGGTGCGACCT-1"	"A"
"TAGACTGGTTCTCGAA-1"	"A"
"TAGACTGTCCCGTAGG-1"	"G"
"TAGACTGTCGCTCGGA-1"	"A"
"TAGACTGTCTCTTCTC-1"	"G"
"TAGACTGTCTTGTCAT-1"	"G"
"TAGCACAAGATCGAGC-1"	"A"
"TAGCACAAGGGTCTGA-1"	"A"
"TAGCACAAGGTTGTTC-1"	"A"
"TAGCACAAGTGGTGTG-1"	"A"
"TAGCACACAATGCATC-1"	"A"
"TAGCACACACCGAATT-1"	"A"
"TAGCACACAGGGTAAC-1"	"A"
"TAGCACAGTCCACCAG-1"	"A"
"TAGCACATCAAAGTAG-1"	"A"
"TAGCACATCACCCGGA-1"	"A"
"TAGCACATCGGTCTAA-1"	"G"
"TAGCATGAGCCATGGA-1"	"A"
"TAGCATGAGGCTTTAC-1"	"G"
"TAGCATGAGGTTAACA-1"	"A"
"TAGCATGCAAACGTTC-1"	"G"
"TAGCATGCACGCGATC-1"	"A"
"TAGCATGTCCCGAAGC-1"	"G"
"TAGCATGTCTCCTTAA-1"	"G"
"TAGCCCTAGCTACGCC-1"	"A"
"TAGCCCTAGGAAGAAC-1"	"G"
"TAGCCCTGTTTGCATG-1"	"A"
"TAGCCCTTCGGCATAT-1"	"A"
"TAGCCCTTCTCTATTG-1"	"A"
"TAGCCGGAGTTCTCCC-1"	"G"
"TAGCCGGCATTCGTCC-1"	"G"
"TAGCCGGGTAACTCCA-1"	"G"
"TAGCCGGGTCGTAGTT-1"	"A"
"TAGCGGCCAATTCAGC-1"	"G"
"TAGCGGCGTAGTATCC-1"	"G"
"TAGCGGCGTCCAAGAG-1"	"A"
"TAGCGGCTCTGTGTCC-1"	"G"
"TAGCTTTAGATCACCT-1"	"G"
"TAGCTTTAGGTTAACA-1"	"A"
"TAGCTTTCAACTCGTA-1"	"G"
"TAGCTTTGTGCCCAGT-1"	"G"
"TAGCTTTTCCATACGA-1"	"A"
"TAGGAGGAGATTGACA-1"	"A"
"TAGGAGGAGCAGTAGC-1"	"G"
"TAGGAGGAGCTATCCA-1"	"A"
"TAGGAGGAGGCCAGTA-1"	"G"
"TAGGAGGCAGGCAGAT-1"	"G"
"TAGGAGGGTCGACTGC-1"	"A"
"TAGGAGGTCTCTGCGT-1"	"A"
"TAGGTCAAGATTACGA-1"	"G"
"TAGGTCAAGCTGAGGT-1"	"G"
"TAGGTCAAGTGCTGAG-1"	"G"
"TAGGTCACACTGCTCT-1"	"A"
"TAGGTCACAGCGTCGT-1"	"G"
"TAGGTCATCCATAACG-1"	"G"
"TAGGTGTTCCAGGTCG-1"	"G"
"TAGGTGTTCCGAGGAA-1"	"G"
"TAGGTGTTCCGTACGG-1"	"A"
"TAGTCCCAGCAACGGT-1"	"A"
"TAGTCCCAGGTAGGCT-1"	"G"
"TAGTCCCCAATGTAAG-1"	"G"
"TAGTCCCCACGCGATC-1"	"G"
"TAGTCCCCAGTTGCAT-1"	"G"
"TAGTCCCGTACCTATG-1"	"A"
"TAGTCCCGTCGTAATC-1"	"A"
"TAGTCCCTCCCAGTAA-1"	"A"
"TATCGAGAGCTTTCCC-1"	"G"
"TATCGAGAGGGAAGCG-1"	"G"
"TATCGAGAGTAGTCGG-1"	"G"
"TATCGAGGTCAATCCA-1"	"G"
"TATCTGTGTGGTGGTA-1"	"G"
"TATCTGTTCATGAACC-1"	"G"
"TATCTGTTCTTATCAC-1"	"A"
"TATGTGGAGTCGAGCA-1"	"A"
"TATGTGGCAAGTAATG-1"	"G"
"TATGTTCAGGCAGTGT-1"	"A"
"TATGTTCAGGCCTCTG-1"	"A"
"TATGTTCCAAATTGAG-1"	"G"
"TATGTTCTCCCATAGA-1"	"A"
"TATGTTCTCGAGTTAC-1"	"A"
"TATTGCTAGCAATAAC-1"	"A"
"TATTGCTCACGTTACA-1"	"G"
"TATTGCTCATCACAAC-1"	"G"
"TATTGCTGTCCGTCGA-1"	"A"
"TATTGCTGTTCCCAAA-1"	"A"
"TATTGCTGTTGGCTAT-1"	"G"
"TCAAAGCAGCGCGTTC-1"	"A"
"TCAAAGCAGCTACGTT-1"	"G"
"TCAAAGCCAAGGTTCT-1"	"A"
"TCAAAGCTCCATGTTT-1"	"G"
"TCAAGACAGTCTAGAA-1"	"G"
"TCAAGACAGTGTGTAA-1"	"G"
"TCAAGACCAGCGCGTT-1"	"A"
"TCAAGACCATGGTTTG-1"	"G"
"TCAAGACGTAGGTAAT-1"	"A"
"TCAAGACGTATGTCCA-1"	"A"
"TCAAGACGTCCAGACC-1"	"A"
"TCAAGACGTGGAGTGT-1"	"G"
"TCAAGACGTTAGGCTT-1"	"G"
"TCAAGACGTTTGACCA-1"	"A"
"TCAAGCAAGAGAGTTT-1"	"A"
"TCAAGCACAAGGTTCT-1"	"A"
"TCAAGCACACACATGT-1"	"A"
"TCAAGCATCTTCGTTA-1"	"G"
"TCAAGGTAGGGAGTTC-1"	"G"
"TCAAGGTAGTCATACC-1"	"G"
"TCAAGGTCAAAGCATA-1"	"G"
"TCAAGGTCAATACTGC-1"	"G"
"TCAAGGTTCGATGTGT-1"	"A"
"TCAATTCAGGATTGAT-1"	"A"
"TCAATTCAGGGCTCTC-1"	"G"
"TCAATTCGTAGGTGAC-1"	"A"
"TCAATTCTCGGTAGGA-1"	"G"
"TCACAAGGTATGGATA-1"	"A"
"TCACAAGTCACTAGCA-1"	"A"
"TCACAAGTCCATTGTT-1"	"G"
"TCACAGAAGAGGTGGG-1"	"A"
"TCACAGAGTCAGGCTC-1"	"A"
"TCACAGAGTTCTGAAC-1"	"G"
"TCACAGATCACCGCGA-1"	"A"
"TCACCACAGCACACCC-1"	"G"
"TCACCACAGTCAGCCC-1"	"A"
"TCACCACGTAGGTCTT-1"	"G"
"TCACCACGTCCGGTAC-1"	"A"
"TCACCACGTCCTCAGG-1"	"A"
"TCACCACTCTCATCCG-1"	"G"
"TCACCTGAGCTCCATA-1"	"G"
"TCACCTGCAACTCCCT-1"	"G"
"TCACCTGGTACTAGAA-1"	"A"
"TCACCTGGTGTCCCAG-1"	"G"
"TCACCTGGTTAGAGAT-1"	"A"
"TCACCTGTCACTCGGG-1"	"A"
"TCACCTGTCATACTTC-1"	"A"
"TCACCTGTCGACTCGG-1"	"A"
"TCACTCGAGAGGTCCA-1"	"G"
"TCACTCGCATAGTCCA-1"	"G"
"TCACTCGGTGCAACAG-1"	"A"
"TCACTCGTCAAATGGA-1"	"A"
"TCACTCGTCCGTCAAA-1"	"A"
"TCACTCGTCGCTATAG-1"	"A"
"TCAGCTCAGAGAGTTT-1"	"G"
"TCAGCTCCAAGACACG-1"	"A"
"TCAGCTCCAGCGTGAA-1"	"A"
"TCAGCTCCATGGGACA-1"	"G"
"TCAGCTCGTAGTTTGC-1"	"G"
"TCAGCTCGTATCCTTT-1"	"G"
"TCAGCTCTCGCGTGAC-1"	"A"
"TCAGGGCCATCAACTG-1"	"G"
"TCAGGGCGTGGACTGA-1"	"A"
"TCAGGGCTCGTGGCGT-1"	"G"
"TCAGGTAAGTACGACG-1"	"A"
"TCAGGTAAGTAGGAAG-1"	"A"
"TCAGGTACAGGAGCAT-1"	"G"
"TCAGGTAGTGTCGTGC-1"	"G"
"TCAGGTAGTTCCATCC-1"	"G"
"TCAGGTATCGCTTCAC-1"	"A"
"TCAGGTATCGGATCGC-1"	"A"
"TCAGTCCAGCGGACAT-1"	"A"
"TCAGTCCAGGCTCCTG-1"	"A"
"TCAGTCCCACCTGAAT-1"	"G"
"TCAGTCCCACTGATTG-1"	"G"
"TCAGTTTAGAAATTCG-1"	"G"
"TCAGTTTGTCATTGCA-1"	"G"
"TCAGTTTGTGGAAAGA-1"	"G"
"TCAGTTTTCCTGTAGA-1"	"A"
"TCAGTTTTCGGTCTAA-1"	"A"
"TCCAGAACAGTTAAAG-1"	"G"
"TCCAGAACATTACTTC-1"	"G"
"TCCAGAAGTAATGTAG-1"	"A"
"TCCAGAATCCGCGATG-1"	"G"
"TCCATCGAGGTCTTTG-1"	"G"
"TCCATCGAGTCGTACT-1"	"G"
"TCCATCGGTACCCACG-1"	"G"
"TCCATCGGTGCTTACA-1"	"G"
"TCCATCGTCCAGTTAG-1"	"G"
"TCCATCGTCCATATCT-1"	"A"
"TCCCACAAGAGCCTGA-1"	"A"
"TCCCACAAGAGCGGTT-1"	"A"
"TCCCACACAAGTCTGT-1"	"A"
"TCCCACACATTGAACC-1"	"G"
"TCCCACAGTATGGTTC-1"	"A"
"TCCCACAGTCCATTGA-1"	"A"
"TCCCACAGTTTGTGAC-1"	"A"
"TCCCACATCTAGCAAC-1"	"G"
"TCCCACATCTATACCT-1"	"G"
"TCCGACTAGAAATCTG-1"	"G"
"TCCGACTAGGCAAGCT-1"	"G"
"TCCGACTAGGCGTCCT-1"	"A"
"TCCGACTCAACTCAAC-1"	"A"
"TCCGACTCACTCCCAT-1"	"A"
"TCCGACTGTCCGGTAC-1"	"G"
"TCCGACTGTCTGGATT-1"	"A"
"TCCGACTTCGTCCCTA-1"	"G"
"TCGAGCGAGAGAGTTT-1"	"A"
"TCGAGCGGTAGGGTCA-1"	"A"
"TCGAGCGGTTCCCAAA-1"	"A"
"TCGAGCGTCCCGCAAG-1"	"G"
"TCGAGCGTCCTGTAGA-1"	"A"
"TCGAGCGTCTAGCAAC-1"	"G"
"TCGATTTAGAGCGAAA-1"	"A"
"TCGATTTAGCTCCATA-1"	"A"
"TCGATTTAGGATCCTT-1"	"A"
"TCGATTTCAAATGTCC-1"	"A"
"TCGATTTCAGGGAGTT-1"	"A"
"TCGATTTCATTCGTCC-1"	"G"
"TCGATTTGTAACAATG-1"	"A"
"TCGATTTGTCTAACCA-1"	"A"
"TCGATTTGTGAGCTAG-1"	"G"
"TCGATTTGTGGTACTT-1"	"A"
"TCGCAGGAGCCATTCA-1"	"G"
"TCGCAGGTCTGTGTCC-1"	"A"
"TCGCCTACAGTAGGCA-1"	"G"
"TCGCCTAGTTCTTTCA-1"	"A"
"TCGCCTATCATCGCTC-1"	"A"
"TCGGGACCAATTGTGC-1"	"A"
"TCGTTCGAGCCTTTGA-1"	"A"
"TCGTTCGAGGCGATTG-1"	"A"
"TCGTTCGAGTCGTACT-1"	"A"
"TCGTTCGCAAGAGATT-1"	"A"
"TCGTTCGCACAGATGG-1"	"G"
"TCGTTCGGTGCCAAGA-1"	"A"
"TCGTTCGGTGGACCAA-1"	"A"
"TCTAGTTAGAAATTCG-1"	"G"
"TCTAGTTAGAGACTCG-1"	"A"
"TCTAGTTAGGGTATCG-1"	"G"
"TCTAGTTCAGTAGTTC-1"	"G"
"TCTAGTTGTAGAAAGG-1"	"A"
"TCTAGTTGTCAAACAA-1"	"A"
"TCTAGTTGTGCCGGTT-1"	"G"
"TCTAGTTTCAAGTTGC-1"	"G"
"TCTAGTTTCCATGACA-1"	"G"
"TCTATTGCACAGATGG-1"	"A"
"TCTATTGTCGGATAGG-1"	"G"
"TCTCAGCAGAGGAAGT-1"	"A"
"TCTCAGCAGGAAGAAC-1"	"A"
"TCTCAGCAGGGAAATG-1"	"A"
"TCTCAGCAGTCGTACT-1"	"G"
"TCTCAGCCAGACTAAA-1"	"G"
"TCTCAGCCAGAGAGAA-1"	"A"
"TCTCAGCGTCAAATCC-1"	"G"
"TCTCAGCGTGCTTGAT-1"	"A"
"TCTCAGCTCGCACCTT-1"	"A"
"TCTCAGCTCGGTAGGA-1"	"G"
"TCTCTGGAGACAGCTG-1"	"A"
"TCTCTGGAGACCAATA-1"	"G"
"TCTCTGGCACTGTCAA-1"	"G"
"TCTCTGGCAGGTGTGA-1"	"G"
"TCTCTGGGTCCTCAGG-1"	"G"
"TCTCTGGGTCTCAAAC-1"	"G"
"TCTCTGGTCCCATAGA-1"	"A"
"TCTCTGGTCTCCCTTT-1"	"A"
"TGAATCGCAAACGTTC-1"	"A"
"TGAATCGCAAGATGCG-1"	"A"
"TGAATCGCAGATTTGC-1"	"A"
"TGAATCGTCGACCCGA-1"	"A"
"TGAATCGTCGTGCTGG-1"	"G"
"TGACAACAGCAGTAGC-1"	"G"
"TGACAACCAAGTAATG-1"	"A"
"TGACAACCAGCAACGA-1"	"A"
"TGACAACGTACGTAAA-1"	"A"
"TGACAACGTAGAGAGA-1"	"A"
"TGACAACGTTGGAGGT-1"	"G"
"TGACAACTCAAAGTAG-1"	"G"
"TGACAACTCTGACTTT-1"	"A"
"TGACAACTCTGGCACG-1"	"A"
"TGACTCCCAAGGACCA-1"	"G"
"TGACTCCCACGGCCAT-1"	"G"
"TGACTCCCAGCAACAG-1"	"G"
"TGACTCCGTGAGGGTT-1"	"G"
"TGACTCCTCCAGGGAA-1"	"A"
"TGACTCCTCTCGCGTT-1"	"A"
"TGAGCCGCACGCTAAT-1"	"G"
"TGAGCCGGTTCTGAGT-1"	"G"
"TGAGCCGTCCCACTAC-1"	"G"
"TGAGTCAAGCACACCC-1"	"A"
"TGAGTCAAGGGTATCG-1"	"A"
"TGAGTCAGTAGCGTTT-1"	"G"
"TGAGTCAGTGTCTCGG-1"	"G"
"TGATCAGGTCAGAAGC-1"	"A"
"TGATCAGGTTAGCTCA-1"	"G"
"TGATCAGTCAATTGGC-1"	"A"
"TGATGCAGTAGTAACA-1"	"G"
"TGATGCAGTCGCTACG-1"	"A"
"TGATGCATCAGAGTGG-1"	"A"
"TGATTTCCACATGATC-1"	"G"
"TGATTTCGTGTCCAGC-1"	"G"
"TGATTTCTCATGTTCT-1"	"A"
"TGCACCTAGAAAGCAG-1"	"A"
"TGCACCTAGCAATAAC-1"	"G"
"TGCACCTAGGTTCGTT-1"	"A"
"TGCACCTCAGACTAAA-1"	"G"
"TGCACCTGTAGCGGTA-1"	"A"
"TGCACCTGTCCCGTGA-1"	"A"
"TGCACCTTCACCCGGA-1"	"A"
"TGCACCTTCGGATAGG-1"	"A"
"TGCATGAAGCAATAAC-1"	"A"
"TGCATGAAGTCCGTGC-1"	"G"
"TGCATGAGTGGCGCTT-1"	"G"
"TGCATGATCCAACCTC-1"	"A"
"TGCATTTAGAGCTCCC-1"	"G"
"TGCATTTAGTACTCTG-1"	"A"
"TGCATTTGTATACGCT-1"	"A"
"TGCATTTTCGTGATAC-1"	"A"
"TGCCTCAAGACCTATC-1"	"A"
"TGCCTCAAGCCAGAAC-1"	"G"
"TGCCTCAAGGATTGAT-1"	"G"
"TGCCTCATCGTAGCGC-1"	"A"
"TGCCTGTCAACAACTC-1"	"A"
"TGCCTGTGTGATGCGA-1"	"G"
"TGCCTGTGTTGCCTGG-1"	"G"
"TGCGTAAAGGCGTAGT-1"	"G"
"TGCGTAAAGTGGACGT-1"	"G"
"TGCGTAACAAACGACG-1"	"A"
"TGCGTAACAGGTCCTG-1"	"A"
"TGCGTAAGTGAGGTCA-1"	"A"
"TGCGTAAGTTCCAGTA-1"	"A"
"TGCGTAATCCTGGGAC-1"	"A"
"TGCTATTGTGGTGGTA-1"	"A"
"TGCTCACAGTCTGGGA-1"	"A"
"TGCTCACTCGGTCTCT-1"	"A"
"TGCTCGTAGAAATCTG-1"	"G"
"TGCTCGTAGCTGAGGT-1"	"G"
"TGCTCGTCAATAGCGG-1"	"G"
"TGCTCGTCACACACAT-1"	"G"
"TGCTCGTCATCAGAAA-1"	"A"
"TGCTCGTGTAACAATG-1"	"G"
"TGCTCGTGTACATGGG-1"	"A"
"TGCTCGTGTGAATCAA-1"	"A"
"TGCTCGTTCCAGTACA-1"	"A"
"TGCTCGTTCGGACGAA-1"	"A"
"TGCTCGTTCTGATCCC-1"	"G"
"TGCTTCGAGTCAACTC-1"	"A"
"TGCTTCGCAAATTCCG-1"	"G"
"TGCTTCGGTGGACGAT-1"	"A"
"TGCTTCGTCGAGAACG-1"	"G"
"TGCTTCGTCGGGACAA-1"	"A"
"TGCTTCGTCGTTCTAT-1"	"A"
"TGCTTCGTCTGGACAT-1"	"A"
"TGCTTTAAGCTAGCAG-1"	"G"
"TGCTTTACACGTTAGT-1"	"A"
"TGCTTTATCAACTTGG-1"	"G"
"TGCTTTATCCGATGCG-1"	"A"
"TGGAAGGAGGATTAAC-1"	"G"
"TGGAAGGCAAACCGAG-1"	"A"
"TGGAAGGCAGGTAACG-1"	"A"
"TGGAAGGGTTTCGACA-1"	"A"
"TGGACATCATCTCTCG-1"	"G"
"TGGACATGTCAGGTGA-1"	"A"
"TGGACATGTTTCCACC-1"	"G"
"TGGACATTCCGTTAGA-1"	"G"
"TGGCAATAGGCTTTAC-1"	"A"
"TGGCAATCATATACGC-1"	"A"
"TGGCAATGTACTTCGA-1"	"G"
"TGGCAATTCCATCATT-1"	"G"
"TGGCAATTCGTGGCGT-1"	"G"
"TGGCAATTCTAGTCGA-1"	"G"
"TGGCCTTAGTACAGTA-1"	"A"
"TGGCCTTCAAACCCTA-1"	"G"
"TGGCCTTCAATGTGCT-1"	"G"
"TGGCCTTCATTGTGAC-1"	"A"
"TGGCCTTGTGATAACA-1"	"A"
"TGGCGCAAGATTAGAC-1"	"A"
"TGGCGCAAGCACGTAG-1"	"A"
"TGGCGCACATCTCTCG-1"	"G"
"TGGCGCAGTAGAAGCC-1"	"A"
"TGGCGCATCGAGGCTC-1"	"A"
"TGGGTGCAGAAATCTG-1"	"A"
"TGGGTGCCACTGTCAA-1"	"A"
"TGGGTGCCAGGATGTG-1"	"A"
"TGGGTGCGTCAGACGA-1"	"A"
"TGGGTTAAGGTACACG-1"	"A"
"TGGGTTACACGCTGTG-1"	"A"
"TGGGTTAGTTGGAGGT-1"	"A"
"TGGGTTAGTTTCTACT-1"	"A"
"TGGGTTATCGGTCCGA-1"	"A"
"TGGTCAACATCATCGA-1"	"G"
"TGGTCAAGTATATGGA-1"	"A"
"TGGTCAAGTTCCAATG-1"	"G"
"TGGTCAATCTGTTTAC-1"	"G"
"TGGTCCTCAAGGAGGG-1"	"A"
"TGGTCCTGTGCGCATC-1"	"G"
"TGGTCCTTCGCACCTT-1"	"A"
"TGGTCCTTCGTCGCAG-1"	"G"
"TGTAAGCAGCTTACCA-1"	"A"
"TGTAAGCAGTGAATAC-1"	"G"
"TGTAAGCCACTCCACT-1"	"A"
"TGTAAGCCAGAAGTGC-1"	"A"
"TGTAAGCCAGGCAAGT-1"	"G"
"TGTAAGCGTATCTGCA-1"	"A"
"TGTAAGCGTCGAGGAT-1"	"G"
"TGTAAGCGTTCGGGAA-1"	"A"
"TGTACAGAGATCACCT-1"	"G"
"TGTACAGAGATGGGAA-1"	"G"
"TGTACAGAGTAGAAGG-1"	"A"
"TGTACAGCAACGCACC-1"	"G"
"TGTACAGGTTACGCTA-1"	"A"
"TGTACAGGTTCTGATG-1"	"A"
"TGTACAGTCGGGTCCA-1"	"G"
"TGTACGAAGAGAATTC-1"	"A"
"TGTACGAAGGTCGGTA-1"	"A"
"TGTACGACAACTCGTA-1"	"A"
"TGTACGACAATGTAAG-1"	"G"
"TGTACGACAGCAACAG-1"	"A"
"TGTACGAGTCCGTCGA-1"	"G"
"TGTACGATCTGTTGCC-1"	"G"
"TGTAGCAAGGTCTTGT-1"	"A"
"TGTAGCAGTGAGCTAG-1"	"G"
"TGTAGCATCGCGTTCT-1"	"A"
"TGTGACAGTCATGAGG-1"	"A"
"TGTGGCGAGTACCTCA-1"	"G"
"TGTGGCGCACAGTTAC-1"	"G"
"TGTGGCGGTAGTACAA-1"	"G"
"TGTGGCGGTCACAGTT-1"	"G"
"TGTGGCGTCCAGGTAT-1"	"A"
"TGTGTCCAGAGGAAGT-1"	"G"
"TGTGTCCCAACGACAG-1"	"G"
"TGTGTCCGTCTCGGGT-1"	"A"
"TGTGTCCTCGCGGCAT-1"	"G"
"TGTTAGGCATTGCGAT-1"	"A"
"TGTTAGGGTAGTAACA-1"	"G"
"TGTTAGGGTTACGGAG-1"	"G"
"TGTTAGGGTTTGCATG-1"	"G"
"TGTTAGGTCCATAGGT-1"	"G"
"TGTTAGGTCGTGGTAT-1"	"G"
"TTAACGGAGTTGTCCA-1"	"A"
"TTAACGGCACCTGAAT-1"	"G"
"TTAACGGCACTGCTTC-1"	"G"
"TTAACGGGTCCTTCAC-1"	"A"
"TTAACGGTCACTTACT-1"	"A"
"TTAACGGTCTTACCTA-1"	"G"
"TTACCCGAGCAATAAC-1"	"G"
"TTACCCGCAAGGTCGA-1"	"A"
"TTACCCGCACCGATCG-1"	"G"
"TTACCCGCAGAAAGAG-1"	"A"
"TTACCCGCATAGAATG-1"	"G"
"TTACCCGCATGACTGT-1"	"G"
"TTACCCGGTGAGTAAT-1"	"G"
"TTACCCGTCTGCTACC-1"	"G"
"TTACCGCAGAACGTCG-1"	"G"
"TTACCGCAGAATCAGT-1"	"A"
"TTACCGCCAGAAGTGC-1"	"A"
"TTACCGCGTAGTACAA-1"	"G"
"TTACCGCGTATGTTCG-1"	"A"
"TTACCGCGTCTGAGCC-1"	"A"
"TTACGGAAGACGAAAG-1"	"G"
"TTACGGACAAACGACG-1"	"A"
"TTACGGACACAACGGA-1"	"G"
"TTACGGACATTTGGCA-1"	"G"
"TTACGGAGTGTCCCAG-1"	"A"
"TTACGGATCGCGCTGA-1"	"G"
"TTACGTTCACCACGAC-1"	"G"
"TTACGTTGTTCTTATC-1"	"G"
"TTACTCAAGGTGTCGA-1"	"A"
"TTACTCAAGTCGATAA-1"	"A"
"TTACTCACAACGACAG-1"	"G"
"TTACTCAGTGATAACA-1"	"A"
"TTACTCATCCGATTGA-1"	"G"
"TTACTTGCATTCACGA-1"	"A"
"TTACTTGGTGCAAAGC-1"	"A"
"TTACTTGGTGTTGTTG-1"	"A"
"TTACTTGTCACTAGCA-1"	"A"
"TTACTTGTCTATCTTG-1"	"A"
"TTACTTGTCTCTATTG-1"	"A"
"TTAGCGAAGGGTCTGA-1"	"A"
"TTAGCGAAGTGCTAGG-1"	"G"
"TTAGCGACAGATTAAG-1"	"A"
"TTAGCGACATCCCAAA-1"	"A"
"TTAGCGAGTACCCACG-1"	"A"
"TTAGCGATCCCAATGA-1"	"G"
"TTAGCTTCAAGGTTCT-1"	"A"
"TTAGCTTCAGAGCCAA-1"	"A"
"TTAGCTTCAGCAGGTA-1"	"A"
"TTAGCTTGTCAGTGTT-1"	"A"
"TTAGGTGAGATCTCAC-1"	"G"
"TTAGGTGCATCCGTGG-1"	"A"
"TTAGGTGGTGTTTCTT-1"	"G"
"TTAGGTGTCTAGCTGA-1"	"G"
"TTATGTCAGAGGTCCA-1"	"A"
"TTATGTCAGCGTAGCA-1"	"A"
"TTATGTCCACGTTACA-1"	"G"
"TTATGTCGTAGATTAG-1"	"G"
"TTATGTCTCCTCTCTT-1"	"A"
"TTCAACTAGCTATCCA-1"	"G"
"TTCAACTAGGATGCCA-1"	"A"
"TTCAACTCAATGGTCT-1"	"A"
"TTCAACTCACGCGACT-1"	"A"
"TTCAACTCACGTTGTA-1"	"A"
"TTCAACTCACTTACAG-1"	"A"
"TTCAACTGTCAGACGA-1"	"A"
"TTCAACTGTGCTTGAT-1"	"G"
"TTCAACTTCACGTGTA-1"	"A"
"TTCAACTTCGGGCTCA-1"	"G"
"TTCATCAAGTACCACT-1"	"A"
"TTCATCACAGGTGGTA-1"	"A"
"TTCATCACATCTCTCG-1"	"A"
"TTCATCATCAGTACAC-1"	"A"
"TTCATTGGTAGCAGGT-1"	"A"
"TTCGATTGTCCATTGA-1"	"A"
"TTCGATTGTCCCTTTG-1"	"A"
"TTCGATTGTTCGGGAA-1"	"G"
"TTCGCGTAGAACGACC-1"	"G"
"TTCGCGTAGGTCTTGT-1"	"A"
"TTCGCGTCAATGGCAG-1"	"G"
"TTCGCGTCATTACTCT-1"	"A"
"TTCGCGTGTAGCTGTT-1"	"G"
"TTCGCGTGTGCTGAAG-1"	"A"
"TTCGCGTTCTGAGTCA-1"	"A"
"TTCGGTCAGCGCAATG-1"	"A"
"TTCGGTCAGCTCCGGT-1"	"G"
"TTCGGTCCAGATGGCA-1"	"A"
"TTCGGTCGTAGGGTTG-1"	"G"
"TTCGGTCTCTAGCTGA-1"	"A"
"TTCGTTACAATAGCGG-1"	"A"
"TTCGTTAGTAAGGTCG-1"	"A"
"TTCTAACAGGAATGGA-1"	"A"
"TTCTAACCATCGGCTG-1"	"G"
"TTCTAACGTACCAAGG-1"	"A"
"TTCTAACGTATTCGAC-1"	"G"
"TTCTAACGTCGCGCTA-1"	"A"
"TTCTGTAAGGTCCTCG-1"	"G"
"TTCTGTACATAGAATG-1"	"G"
"TTCTGTAGTCAAATCC-1"	"A"
"TTCTGTAGTGATAGAT-1"	"G"
"TTCTGTAGTTTGTGAC-1"	"G"
"TTCTGTATCTCTTCCT-1"	"A"
"TTGACGAAGATCGATA-1"	"A"
"TTGACGACAGCAACAG-1"	"G"
"TTGACGAGTTACGAAA-1"	"A"
"TTGACGATCATTCGGA-1"	"A"
"TTGAGCACATCAGCTA-1"	"G"
"TTGAGTGAGGTTGACG-1"	"A"
"TTGAGTGGTATGAAGT-1"	"A"
"TTGAGTGTCCTCAAGA-1"	"A"
"TTGCACCAGACTCGGA-1"	"A"
"TTGCACCAGCTAGCAG-1"	"G"
"TTGCACCAGGTTGTGG-1"	"A"
"TTGCACCAGTACAGTA-1"	"A"
"TTGCACCCAGGACTGA-1"	"G"
"TTGCACCCATCGACCG-1"	"G"
"TTGCACCCATTATGGC-1"	"A"
"TTGCACCGTGCCCAGT-1"	"A"
"TTGCACCTCCGCTATC-1"	"G"
"TTGCACCTCGCTTGAA-1"	"A"
"TTGCACCTCGTCTTAT-1"	"G"
"TTGCAGATCCATCTAT-1"	"A"
"TTGCCCAAGAACCCGA-1"	"A"
"TTGCCCAAGGGTGTTG-1"	"G"
"TTGCCCAGTGCATTGT-1"	"A"
"TTGCCCAGTTTGTACG-1"	"A"
"TTGCCCATCGTTCTAT-1"	"G"
"TTGCCCATCTTCTCTC-1"	"A"
"TTGCGAAAGCTGATTC-1"	"A"
"TTGCGAAAGTGTGTAA-1"	"A"
"TTGCGAAAGTTGCCGC-1"	"A"
"TTGCGAAGTGAATGGC-1"	"A"
"TTGCGAATCGTTGTTT-1"	"G"
"TTGCGAATCTAGCAGT-1"	"G"
"TTGCGGGAGAGGTACC-1"	"G"
"TTGCGGGAGCATTCCA-1"	"A"
"TTGCGGGAGTCGGGAT-1"	"G"
"TTGCGGGCAACGTAGG-1"	"A"
"TTGCGGGCAATGAAAC-1"	"G"
"TTGCGGGCAATGACTC-1"	"G"
"TTGCGGGCATGCGCTG-1"	"G"
"TTGCGGGCATTACTCT-1"	"A"
"TTGCGGGGTCAGGCTC-1"	"A"
"TTGCTATAGATCCGAG-1"	"A"
"TTGCTATCACGTACAT-1"	"G"
"TTGCTATGTCAACAGG-1"	"A"
"TTGCTATGTCTGCGCA-1"	"A"
"TTGCTATGTTCCCTTG-1"	"A"
"TTGCTATTCAAGAGAT-1"	"A"
"TTGCTATTCATTCTTG-1"	"G"
"TTGCTATTCTGAAAGA-1"	"A"
"TTGCTTACATGCTATG-1"	"G"
"TTGCTTAGTGAGTCGA-1"	"A"
"TTGGTCCAGATTCCGT-1"	"A"
"TTGGTCCCAAGCAACG-1"	"A"
"TTGGTCCTCCACCTAC-1"	"A"
"TTGGTCCTCCAGCACG-1"	"A"
"TTGGTCCTCCGTCAAA-1"	"G"
"TTGGTCCTCTTCGTTA-1"	"G"
"TTGTCTAAGAATCAGT-1"	"G"
"TTGTCTAAGCTGGAGT-1"	"A"
"TTGTCTACAGCTATAC-1"	"G"
"TTGTCTATCGGATAGG-1"	"G"
"TTGTTCACACGCTAAT-1"	"A"
"TTGTTCAGTAAGTCTC-1"	"G"
"TTGTTCAGTATTCACG-1"	"A"
"TTGTTCAGTCCTCAGG-1"	"G"
"TTGTTCATCCGATGCG-1"	"A"
"TTGTTCATCGCTAGTA-1"	"A"
"TTGTTCATCGGGATCC-1"	"A"
"TTGTTCATCGTTGTAG-1"	"G"
"TTGTTGTAGGCTCCTG-1"	"A"
"TTGTTGTAGGGAAGCG-1"	"A"
"TTGTTGTAGTCCGGAA-1"	"G"
"TTGTTGTCAACAACTC-1"	"A"
"TTGTTGTGTCCGGTAC-1"	"A"
"TTGTTGTTCAGGGTTT-1"	"G"
"TTGTTGTTCCGGGCAT-1"	"A"
"TTGTTGTTCGCCTTAC-1"	"A"
"TTGTTGTTCTCTGACC-1"	"A"
"TTTACGTAGACCAATA-1"	"A"
"TTTACGTAGGCTCCTG-1"	"G"
"TTTACGTTCCCACGGA-1"	"G"
"TTTGAGGCACCTATTT-1"	"A"
"TTTGAGGCACTTATGG-1"	"A"
"TTTGAGGGTGGACCAA-1"	"G"
"TTTGAGGGTTTGCATG-1"	"A"
"TTTGAGGTCCTCTCTT-1"	"A"
"TTTGAGGTCTGATCTT-1"	"G"
"TTTGCGCAGTTAGCGG-1"	"A"
"TTTGCGCCACGGTTAT-1"	"A"
"TTTGCGCCATAGCAGG-1"	"G"
"TTTGCGCTCGGGAATG-1"	"A"
"TTTGCGCTCTGACTTT-1"	"G"
"TTTGGCCAGGAGTAGA-1"	"A"
"TTTGGCCCAGGTAGCA-1"	"A"
"TTTGGCCGTATTCGCA-1"	"A"
"TTTGGCCGTGCTGTGC-1"	"A"
"TTTGGTTAGGCAGTAC-1"	"A"
"TTTGGTTCAGCTATAC-1"	"A"
"TTTGGTTGTTAACCGT-1"	"G"
"TTTGGTTGTTCACGTA-1"	"A"
"TTTGGTTTCGCCAGAC-1"	"A"
"TTTGTGTCAATTGTGC-1"	"G"
"TTTGTGTCATTCTTTG-1"	"A"
"TTTGTGTGTCGTCGCA-1"	"A"
"TTTGTGTGTCTTAGCA-1"	"G"
"TTTGTGTGTTAAGGGC-1"	"G"
"TTTGTGTTCTTGTGCC-1"	"A"
